"Filename","X","LineOWN","LineMinor","LineMajor","LineNumDev"
"java/build/org/apache/derbyBuild/ClassSizeCrawler.java",0,0.933333333333333,2,1,3
"java/build/org/apache/derbyBuild/JiraConnector.java",0,0.909836065573771,0,2,2
"java/build/org/apache/derbyBuild/MessageBuilder.java",0,0.946428571428571,0,2,2
"java/build/org/apache/derbyBuild/MessageBundleTest.java",0,0.793991416309013,0,2,2
"java/build/org/apache/derbyBuild/ODBCMetadataGenerator.java",0,0.914331465172138,2,2,4
"java/build/org/apache/derbyBuild/ReleaseNoteReader.java",0,1,0,1,1
"java/build/org/apache/derbyBuild/ReleaseNotesGenerator.java",0,0.99873417721519,1,1,2
"java/build/org/apache/derbyBuild/classlister.java",0,0.975708502024291,2,1,3
"java/build/org/apache/derbyBuild/eclipse/DerbyEclipsePlugin.java",0,0.967741935483871,1,1,2
"java/build/org/apache/derbyBuild/javadoc/DiskLayoutTaglet.java",0,0.956204379562044,1,1,2
"java/build/org/apache/derbyBuild/javadoc/EndFormatTaglet.java",0,0.955223880597015,1,1,2
"java/build/org/apache/derbyBuild/javadoc/FormatIdTaglet.java",0,0.956521739130435,1,1,2
"java/build/org/apache/derbyBuild/javadoc/PurposeTaglet.java",0,0.956204379562044,1,1,2
"java/build/org/apache/derbyBuild/javadoc/UpgradeTaglet.java",0,0.956204379562044,1,1,2
"java/build/org/apache/derbyBuild/maintversion2props.java",0,0.9,0,2,2
"java/build/org/apache/derbyBuild/propertyconfig.java",0,0.979827089337176,2,1,3
"java/build/org/apache/derbyBuild/splitmessages.java",0,0.626506024096386,3,2,5
"java/build/org/apache/derbyPreBuild/PropertySetter.java",0,0.946144430844553,0,2,2
"java/client/org/apache/derby/client/ClientDataSourceFactory.java",0,0.36969696969697,1,4,5
"java/client/org/apache/derby/client/ClientPooledConnection.java",0,0.318087318087318,3,6,9
"java/client/org/apache/derby/client/ClientPooledConnection40.java",0,0.609929078014184,4,2,6
"java/client/org/apache/derby/client/ClientXAConnection.java",0,0.592592592592593,3,3,6
"java/client/org/apache/derby/client/ClientXAConnection40.java",0,0.53030303030303,1,2,3
"java/client/org/apache/derby/client/ClientXid.java",0,0.878640776699029,1,2,3
"java/client/org/apache/derby/client/am/Agent.java",0,0.888086642599278,3,2,5
"java/client/org/apache/derby/client/am/AsciiStream.java",0,0.385964912280702,0,4,4
"java/client/org/apache/derby/client/am/BatchUpdateException.java",0,0.363636363636364,0,5,5
"java/client/org/apache/derby/client/am/Blob.java",0,0.414765100671141,6,4,10
"java/client/org/apache/derby/client/am/BlobLocatorInputStream.java",0,0.923076923076923,5,1,6
"java/client/org/apache/derby/client/am/BlobLocatorOutputStream.java",0,0.945205479452055,0,2,2
"java/client/org/apache/derby/client/am/BlobOutputStream.java",0,0.310810810810811,1,5,6
"java/client/org/apache/derby/client/am/ByteArrayCombinerStream.java",0,1,0,1,1
"java/client/org/apache/derby/client/am/CachingLogicalConnection.java",0,1,0,1,1
"java/client/org/apache/derby/client/am/CachingLogicalConnection40.java",0,1,0,1,1
"java/client/org/apache/derby/client/am/CallableLocatorProcedures.java",0,0.793900184842883,0,3,3
"java/client/org/apache/derby/client/am/CallableStatement.java",0,0.493670886075949,7,2,9
"java/client/org/apache/derby/client/am/CallableStatement40.java",0,0.356037151702786,1,4,5
"java/client/org/apache/derby/client/am/ClientJDBCObjectFactory.java",0,0.571808510638298,4,3,7
"java/client/org/apache/derby/client/am/ClientMessageId.java",0,0.85,0,2,2
"java/client/org/apache/derby/client/am/Clob.java",0,0.277566539923954,5,6,11
"java/client/org/apache/derby/client/am/ClobLocatorInputStream.java",0,0.717073170731707,2,2,4
"java/client/org/apache/derby/client/am/ClobLocatorOutputStream.java",0,0.972222222222222,1,1,2
"java/client/org/apache/derby/client/am/ClobLocatorReader.java",0,0.886075949367089,2,2,4
"java/client/org/apache/derby/client/am/ClobLocatorWriter.java",0,0.976878612716763,1,1,2
"java/client/org/apache/derby/client/am/ClobOutputStream.java",0,0.333333333333333,2,5,7
"java/client/org/apache/derby/client/am/ClobWriter.java",0,0.468085106382979,1,5,6
"java/client/org/apache/derby/client/am/CloseFilterInputStream.java",0,0.871794871794872,0,3,3
"java/client/org/apache/derby/client/am/ColumnMetaData.java",0,0.533261802575107,5,2,7
"java/client/org/apache/derby/client/am/ColumnMetaData40.java",0,0.909090909090909,1,2,3
"java/client/org/apache/derby/client/am/Configuration.java",0,0.587155963302752,3,3,6
"java/client/org/apache/derby/client/am/Connection.java",0,0.403259506895111,8,5,13
"java/client/org/apache/derby/client/am/ConnectionCallbackInterface.java",0,0.360655737704918,0,5,5
"java/client/org/apache/derby/client/am/CrossConverters.java",0,0.870967741935484,4,2,6
"java/client/org/apache/derby/client/am/Cursor.java",0,0.592727272727273,7,4,11
"java/client/org/apache/derby/client/am/DatabaseMetaData.java",0,0.580036297640653,5,4,9
"java/client/org/apache/derby/client/am/DateTime.java",0,0.506602641056423,3,3,6
"java/client/org/apache/derby/client/am/Decimal.java",0,0.848547717842324,2,2,4
"java/client/org/apache/derby/client/am/Diagnosable.java",0,0.642857142857143,0,3,3
"java/client/org/apache/derby/client/am/DisconnectException.java",0,0.666666666666667,1,3,4
"java/client/org/apache/derby/client/am/EncryptionManager.java",0,0.542691751085383,2,3,5
"java/client/org/apache/derby/client/am/ErrorKey.java",0,0.48936170212766,0,3,3
"java/client/org/apache/derby/client/am/ExceptionFormatter.java",0,0.43010752688172,2,3,5
"java/client/org/apache/derby/client/am/FailedProperties40.java",0,0.947368421052632,0,2,2
"java/client/org/apache/derby/client/am/FloatingPoint.java",0,0.78448275862069,0,3,3
"java/client/org/apache/derby/client/am/GetFileInputStreamAction.java",0,0.490196078431373,0,3,3
"java/client/org/apache/derby/client/am/GetResourceBundleAction.java",0,0.463414634146341,0,3,3
"java/client/org/apache/derby/client/am/GetResourceInputStreamAction.java",0,0.67741935483871,0,3,3
"java/client/org/apache/derby/client/am/GetSystemPropertiesAction.java",0,0.490909090909091,0,3,3
"java/client/org/apache/derby/client/am/LOBStateTracker.java",0,0.964705882352941,1,1,2
"java/client/org/apache/derby/client/am/Lob.java",0,0.427518427518428,3,7,10
"java/client/org/apache/derby/client/am/LogWriter.java",0,0.893915756630265,7,1,8
"java/client/org/apache/derby/client/am/LogicalCallableStatement.java",0,1,0,1,1
"java/client/org/apache/derby/client/am/LogicalCallableStatement40.java",0,1,0,1,1
"java/client/org/apache/derby/client/am/LogicalConnection.java",0,0.427118644067797,4,4,8
"java/client/org/apache/derby/client/am/LogicalConnection40.java",0,0.483974358974359,3,2,5
"java/client/org/apache/derby/client/am/LogicalDatabaseMetaData.java",0,1,0,1,1
"java/client/org/apache/derby/client/am/LogicalDatabaseMetaData40.java",0,1,0,1,1
"java/client/org/apache/derby/client/am/LogicalPreparedStatement.java",0,1,0,1,1
"java/client/org/apache/derby/client/am/LogicalPreparedStatement40.java",0,1,0,1,1
"java/client/org/apache/derby/client/am/LogicalStatementEntity.java",0,1,0,1,1
"java/client/org/apache/derby/client/am/MaterialPreparedStatement.java",0,0.60655737704918,0,3,3
"java/client/org/apache/derby/client/am/MaterialStatement.java",0,0.619718309859155,1,3,4
"java/client/org/apache/derby/client/am/ParameterMetaData.java",0,0.372340425531915,0,4,4
"java/client/org/apache/derby/client/am/ParameterMetaData40.java",0,0.901408450704225,1,2,3
"java/client/org/apache/derby/client/am/PreparedStatement.java",0,0.329656476520643,9,5,14
"java/client/org/apache/derby/client/am/PreparedStatement40.java",0,0.417177914110429,2,4,6
"java/client/org/apache/derby/client/am/PreparedStatementCallbackInterface.java",0,0.710526315789474,0,3,3
"java/client/org/apache/derby/client/am/ProductLevel.java",0,0.6875,0,3,3
"java/client/org/apache/derby/client/am/ResultSet.java",0,0.384935231089077,7,5,12
"java/client/org/apache/derby/client/am/ResultSetCallbackInterface.java",0,0.609756097560976,1,3,4
"java/client/org/apache/derby/client/am/SQLExceptionFactory.java",0,0.673469387755102,0,3,3
"java/client/org/apache/derby/client/am/SQLExceptionFactory40.java",0,0.63,2,3,5
"java/client/org/apache/derby/client/am/Savepoint.java",0,0.5,0,4,4
"java/client/org/apache/derby/client/am/Section.java",0,0.832214765100671,2,2,4
"java/client/org/apache/derby/client/am/SectionManager.java",0,0.756756756756757,5,2,7
"java/client/org/apache/derby/client/am/SetAccessibleAction.java",0,0.489795918367347,0,3,3
"java/client/org/apache/derby/client/am/SignedBinary.java",0,0.788990825688073,0,3,3
"java/client/org/apache/derby/client/am/SqlCode.java",0,0.516666666666667,2,4,6
"java/client/org/apache/derby/client/am/SqlException.java",0,0.630111524163569,3,4,7
"java/client/org/apache/derby/client/am/SqlState.java",0,0.476190476190476,0,3,3
"java/client/org/apache/derby/client/am/SqlWarning.java",0,0.75,2,3,5
"java/client/org/apache/derby/client/am/Sqlca.java",0,0.561521252796421,4,3,7
"java/client/org/apache/derby/client/am/Statement.java",0,0.530458590006845,8,4,12
"java/client/org/apache/derby/client/am/Statement40.java",0,0.835294117647059,3,2,5
"java/client/org/apache/derby/client/am/StatementCacheInteractor.java",0,0.928571428571429,0,2,2
"java/client/org/apache/derby/client/am/StatementCallbackInterface.java",0,0.557377049180328,1,3,4
"java/client/org/apache/derby/client/am/Types.java",0,0.5,1,5,6
"java/client/org/apache/derby/client/am/UnitOfWorkListener.java",0,0.666666666666667,0,3,3
"java/client/org/apache/derby/client/am/UpdateSensitiveBlobLocatorInputStream.java",0,1,0,1,1
"java/client/org/apache/derby/client/am/UpdateSensitiveClobLocatorInputStream.java",0,1,0,1,1
"java/client/org/apache/derby/client/am/UpdateSensitiveClobLocatorReader.java",0,1,0,1,1
"java/client/org/apache/derby/client/am/UpdateSensitiveLOBLocatorInputStream.java",0,0.968325791855204,1,1,2
"java/client/org/apache/derby/client/am/Utils.java",0,0.81981981981982,1,3,4
"java/client/org/apache/derby/client/am/Version.java",0,0.793103448275862,3,2,5
"java/client/org/apache/derby/client/am/XaException.java",0,0.631578947368421,1,3,4
"java/client/org/apache/derby/client/am/stmtcache/JDBCStatementCache.java",0,1,0,1,1
"java/client/org/apache/derby/client/am/stmtcache/StatementKey.java",0,1,0,1,1
"java/client/org/apache/derby/client/am/stmtcache/StatementKeyFactory.java",0,1,0,1,1
"java/client/org/apache/derby/client/net/CcsidManager.java",0,0.643564356435644,0,4,4
"java/client/org/apache/derby/client/net/ClientJDBCObjectFactoryImpl.java",0,0.567695961995249,4,3,7
"java/client/org/apache/derby/client/net/ClientJDBCObjectFactoryImpl40.java",0,0.598574821852732,4,3,7
"java/client/org/apache/derby/client/net/CodePoint.java",0,0.618543046357616,4,2,6
"java/client/org/apache/derby/client/net/CodePointNameTable.java",0,0.645833333333333,2,3,5
"java/client/org/apache/derby/client/net/ConnectionReply.java",0,0.575757575757576,0,3,3
"java/client/org/apache/derby/client/net/ConnectionReplyInterface.java",0,0.538461538461538,0,3,3
"java/client/org/apache/derby/client/net/ConnectionRequestInterface.java",0,0.536585365853659,0,3,3
"java/client/org/apache/derby/client/net/DssConstants.java",0,0.478260869565217,0,3,3
"java/client/org/apache/derby/client/net/EbcdicCcsidManager.java",0,0.742268041237113,3,2,5
"java/client/org/apache/derby/client/net/EncodedInputStream.java",0,1,0,1,1
"java/client/org/apache/derby/client/net/FdocaConstants.java",0,0.708791208791209,1,2,3
"java/client/org/apache/derby/client/net/FdocaSimpleDataArray.java",0,0.788135593220339,0,3,3
"java/client/org/apache/derby/client/net/NaiveTrustManager.java",0,1,0,1,1
"java/client/org/apache/derby/client/net/NetAgent.java",0,0.678846153846154,3,4,7
"java/client/org/apache/derby/client/net/NetCallableStatement.java",0,0.692307692307692,2,3,5
"java/client/org/apache/derby/client/net/NetConfiguration.java",0,0.624434389140271,3,2,5
"java/client/org/apache/derby/client/net/NetConnection.java",0,0.669376693766938,10,3,13
"java/client/org/apache/derby/client/net/NetConnection40.java",0,0.55050505050505,3,3,6
"java/client/org/apache/derby/client/net/NetConnectionReply.java",0,0.925859491778774,6,1,7
"java/client/org/apache/derby/client/net/NetConnectionRequest.java",0,0.859677419354839,4,2,6
"java/client/org/apache/derby/client/net/NetCursor.java",0,0.630637079455977,7,3,10
"java/client/org/apache/derby/client/net/NetDatabaseMetaData.java",0,0.308333333333333,0,6,6
"java/client/org/apache/derby/client/net/NetDatabaseMetaData40.java",0,0.310679611650485,1,4,5
"java/client/org/apache/derby/client/net/NetIndoubtTransaction.java",0,0.571428571428571,0,3,3
"java/client/org/apache/derby/client/net/NetLogWriter.java",0,0.897058823529412,1,2,3
"java/client/org/apache/derby/client/net/NetPackageReply.java",0,0.827102803738318,2,2,4
"java/client/org/apache/derby/client/net/NetPackageRequest.java",0,0.84,2,2,4
"java/client/org/apache/derby/client/net/NetPreparedStatement.java",0,0.533632286995516,3,3,6
"java/client/org/apache/derby/client/net/NetResultSet.java",0,0.661596958174905,1,3,4
"java/client/org/apache/derby/client/net/NetResultSet40.java",0,0.338709677419355,2,4,6
"java/client/org/apache/derby/client/net/NetResultSetReply.java",0,0.802816901408451,4,2,6
"java/client/org/apache/derby/client/net/NetResultSetRequest.java",0,0.851063829787234,4,2,6
"java/client/org/apache/derby/client/net/NetSqlca.java",0,0.375,0,4,4
"java/client/org/apache/derby/client/net/NetSqldta.java",0,0.721518987341772,2,2,4
"java/client/org/apache/derby/client/net/NetStatement.java",0,0.807291666666667,4,2,6
"java/client/org/apache/derby/client/net/NetStatementReply.java",0,0.897834082550061,8,1,9
"java/client/org/apache/derby/client/net/NetStatementRequest.java",0,0.470005503577325,8,4,12
"java/client/org/apache/derby/client/net/NetXACallInfo.java",0,0.593333333333333,4,2,6
"java/client/org/apache/derby/client/net/NetXAConnection.java",0,0.334558823529412,4,4,8
"java/client/org/apache/derby/client/net/NetXAConnectionReply.java",0,0.77491961414791,3,2,5
"java/client/org/apache/derby/client/net/NetXAConnectionRequest.java",0,0.681114551083591,2,2,4
"java/client/org/apache/derby/client/net/NetXAResource.java",0,0.720081135902637,4,4,8
"java/client/org/apache/derby/client/net/OpenSocketAction.java",0,0.528571428571429,0,4,4
"java/client/org/apache/derby/client/net/Reply.java",0,0.863478863478863,3,2,5
"java/client/org/apache/derby/client/net/Request.java",0,0.605780346820809,5,3,8
"java/client/org/apache/derby/client/net/ResultSetReply.java",0,0.540983606557377,0,3,3
"java/client/org/apache/derby/client/net/ResultSetReplyInterface.java",0,0.676470588235294,0,3,3
"java/client/org/apache/derby/client/net/ResultSetRequestInterface.java",0,0.549019607843137,0,3,3
"java/client/org/apache/derby/client/net/StatementReply.java",0,0.678571428571429,0,3,3
"java/client/org/apache/derby/client/net/StatementReplyInterface.java",0,0.5,0,3,3
"java/client/org/apache/derby/client/net/StatementRequestInterface.java",0,0.66304347826087,1,3,4
"java/client/org/apache/derby/client/net/Typdef.java",0,0.881547139403707,4,2,6
"java/client/org/apache/derby/jdbc/ClientBaseDataSource.java",0,0.488311688311688,8,5,13
"java/client/org/apache/derby/jdbc/ClientConnectionPoolDataSource.java",0,0.46031746031746,1,5,6
"java/client/org/apache/derby/jdbc/ClientConnectionPoolDataSource40.java",0,0.924050632911392,0,2,2
"java/client/org/apache/derby/jdbc/ClientDataSource.java",0,0.464646464646465,4,3,7
"java/client/org/apache/derby/jdbc/ClientDataSource40.java",0,0.767605633802817,2,2,4
"java/client/org/apache/derby/jdbc/ClientDriver.java",0,0.381294964028777,4,5,9
"java/client/org/apache/derby/jdbc/ClientXADataSource.java",0,0.252747252747253,1,6,7
"java/client/org/apache/derby/jdbc/ClientXADataSource40.java",0,0.931034482758621,0,2,2
"java/demo/localcal/src/AddEventRequest.java",0,1,0,1,1
"java/demo/localcal/src/CalEvent.java",0,1,0,1,1
"java/demo/localcal/src/CalendarController.java",0,1,0,1,1
"java/demo/localcal/src/DatabaseManager.java",0,1,0,1,1
"java/demo/localcal/src/DeleteEventRequest.java",0,1,0,1,1
"java/demo/localcal/src/EventManager.java",0,1,0,1,1
"java/demo/localcal/src/GCalendar.java",0,1,0,1,1
"java/demo/localcal/src/GCalendarRequest.java",0,1,0,1,1
"java/demo/localcal/src/NetworkDownException.java",0,1,0,1,1
"java/demo/localcal/src/RequestManager.java",0,1,0,1,1
"java/demo/localcal/src/UpdateEventRequest.java",0,1,0,1,1
"java/demo/nserverdemo/NetworkServerUtil.java",0,1,0,1,1
"java/demo/nserverdemo/NsSample.java",0,1,0,1,1
"java/demo/nserverdemo/NsSampleClientThread.java",0,1,0,1,1
"java/demo/nserverdemo/SimpleNetworkClientSample.java",0,0.966360856269113,1,1,2
"java/demo/nserverdemo/SimpleNetworkServerSample.java",0,1,0,1,1
"java/demo/scores/java/client/org/apache/derbyDemo/scores/app/Scores.java",0,1,0,1,1
"java/demo/scores/java/client/org/apache/derbyDemo/scores/data/Data.java",0,1,0,1,1
"java/demo/scores/java/client/org/apache/derbyDemo/scores/data/Database.java",0,1,0,1,1
"java/demo/scores/java/common/org/apache/derbyDemo/scores/util/Logger.java",0,1,0,1,1
"java/demo/scores/java/common/org/apache/derbyDemo/scores/util/Utils.java",0,1,0,1,1
"java/demo/scores/java/server/org/apache/derbyDemo/scores/proc/Functions.java",0,1,0,1,1
"java/demo/scores/java/server/org/apache/derbyDemo/scores/proc/Procedures.java",0,1,0,1,1
"java/demo/simple/SimpleApp.java",0,0.721774193548387,1,2,3
"java/demo/simplemobile/SimpleMobileApp.java",0,1,0,1,1
"java/demo/toursdb/insertMaps.java",0,0.528455284552846,0,2,2
"java/demo/vtis/java/org/apache/derbyDemo/vtis/core/FlatFileVTI.java",0,1,0,1,1
"java/demo/vtis/java/org/apache/derbyDemo/vtis/core/QueryRow.java",0,1,0,1,1
"java/demo/vtis/java/org/apache/derbyDemo/vtis/core/QueryVTIHelper.java",0,1,0,1,1
"java/demo/vtis/java/org/apache/derbyDemo/vtis/core/StringColumnVTI.java",0,1,0,1,1
"java/demo/vtis/java/org/apache/derbyDemo/vtis/core/VTIHelper.java",0,1,0,1,1
"java/demo/vtis/java/org/apache/derbyDemo/vtis/core/VTITemplate.java",0,1,0,1,1
"java/demo/vtis/java/org/apache/derbyDemo/vtis/core/XMLRow.java",0,1,0,1,1
"java/demo/vtis/java/org/apache/derbyDemo/vtis/core/XmlVTI.java",0,0.991780821917808,1,1,2
"java/demo/vtis/java/org/apache/derbyDemo/vtis/example/ApacheServerLogVTI.java",0,1,0,1,1
"java/demo/vtis/java/org/apache/derbyDemo/vtis/example/DerbyJiraReportVTI.java",0,1,0,1,1
"java/demo/vtis/java/org/apache/derbyDemo/vtis/example/LineListVTI.java",0,1,0,1,1
"java/demo/vtis/java/org/apache/derbyDemo/vtis/example/PropertyFileVTI.java",0,1,0,1,1
"java/demo/vtis/java/org/apache/derbyDemo/vtis/example/SubversionLogVTI.java",0,1,0,1,1
"java/demo/vtis/java/org/apache/derbyDemo/vtis/example/VTIs.java",0,0.986206896551724,1,1,2
"java/demo/vtis/java/org/apache/derbyDemo/vtis/example/WorldDBSnapshot.java",0,1,0,1,1
"java/demo/vtis/java/org/apache/derbyDemo/vtis/snapshot/SnapshotQuery.java",0,1,0,1,1
"java/demo/vtis/java/org/apache/derbyDemo/vtis/snapshot/Subscription.java",0,1,0,1,1
"java/demo/vtis/java/org/apache/derbyDemo/vtis/snapshot/SubscriptionSignature.java",0,1,0,1,1
"java/demo/workingwithderby/WwdClientExample.java",0,0.988235294117647,1,1,2
"java/demo/workingwithderby/WwdEmbedded.java",0,0.982758620689655,1,1,2
"java/demo/workingwithderby/WwdUtils.java",0,1,0,1,1
"java/drda/org/apache/derby/drda/NetServlet.java",0,0.92797783933518,4,1,5
"java/drda/org/apache/derby/drda/NetworkServerControl.java",0,0.6,4,2,6
"java/drda/org/apache/derby/impl/drda/AppRequester.java",0,0.830564784053156,6,1,7
"java/drda/org/apache/derby/impl/drda/CcsidManager.java",0,0.783783783783784,0,3,3
"java/drda/org/apache/derby/impl/drda/CharacterEncodings.java",0,0.984455958549223,1,1,2
"java/drda/org/apache/derby/impl/drda/ClientThread.java",0,0.601307189542484,2,3,5
"java/drda/org/apache/derby/impl/drda/CodePoint.java",0,0.874310915104741,5,2,7
"java/drda/org/apache/derby/impl/drda/CodePointNameTable.java",0,0.917647058823529,4,1,5
"java/drda/org/apache/derby/impl/drda/ConsistencyToken.java",0,0.803921568627451,1,3,4
"java/drda/org/apache/derby/impl/drda/DDMReader.java",0,0.830576441102757,6,2,8
"java/drda/org/apache/derby/impl/drda/DDMWriter.java",0,0.816781731279873,7,2,9
"java/drda/org/apache/derby/impl/drda/DRDAConnThread.java",0,0.82404181184669,15,1,16
"java/drda/org/apache/derby/impl/drda/DRDAProtocolException.java",0,0.865853658536585,3,3,6
"java/drda/org/apache/derby/impl/drda/DRDAProtocolExceptionInfo.java",0,0.738095238095238,0,3,3
"java/drda/org/apache/derby/impl/drda/DRDAResultSet.java",0,0.75812274368231,5,2,7
"java/drda/org/apache/derby/impl/drda/DRDAStatement.java",0,0.674705882352941,4,3,7
"java/drda/org/apache/derby/impl/drda/DRDAString.java",0,0.950704225352113,2,1,3
"java/drda/org/apache/derby/impl/drda/DRDAXAProtocol.java",0,0.818300653594771,3,2,5
"java/drda/org/apache/derby/impl/drda/DRDAXid.java",0,0.951612903225806,1,1,2
"java/drda/org/apache/derby/impl/drda/Database.java",0,0.54786150712831,3,4,7
"java/drda/org/apache/derby/impl/drda/DecryptionManager.java",0,0.759109311740891,1,2,3
"java/drda/org/apache/derby/impl/drda/DssConstants.java",0,0.890243902439024,1,2,3
"java/drda/org/apache/derby/impl/drda/DssTrace.java",0,0.84394250513347,2,2,4
"java/drda/org/apache/derby/impl/drda/EXTDTAInputStream.java",0,0.622895622895623,3,2,5
"java/drda/org/apache/derby/impl/drda/EXTDTAReaderInputStream.java",0,0.96969696969697,1,1,2
"java/drda/org/apache/derby/impl/drda/EbcdicCcsidManager.java",0,0.919075144508671,2,1,3
"java/drda/org/apache/derby/impl/drda/FdocaConstants.java",0,0.958847736625514,3,1,4
"java/drda/org/apache/derby/impl/drda/LayerBStreamedEXTDTAReaderInputStream.java",0,1,0,1,1
"java/drda/org/apache/derby/impl/drda/NaiveTrustManager.java",0,1,0,1,1
"java/drda/org/apache/derby/impl/drda/NetworkServerControlImpl.java",0,0.747337131533317,10,3,13
"java/drda/org/apache/derby/impl/drda/NetworkServerMBeanImpl.java",0,0.876857749469214,1,2,3
"java/drda/org/apache/derby/impl/drda/PiggyBackedSessionData.java",0,1,0,1,1
"java/drda/org/apache/derby/impl/drda/Pkgnamcsn.java",0,0.964646464646465,2,1,3
"java/drda/org/apache/derby/impl/drda/ReEncodedInputStream.java",0,0.965714285714286,1,1,2
"java/drda/org/apache/derby/impl/drda/SQLTypes.java",0,0.962264150943396,2,1,3
"java/drda/org/apache/derby/impl/drda/Session.java",0,0.713310580204778,1,3,4
"java/drda/org/apache/derby/impl/drda/SignedBinary.java",0,0.96551724137931,1,1,2
"java/drda/org/apache/derby/impl/drda/StandardEXTDTAReaderInputStream.java",0,1,0,1,1
"java/drda/org/apache/derby/impl/drda/TestFile.java",0,0.864406779661017,0,2,2
"java/drda/org/apache/derby/impl/drda/TestProto.java",0,0.884504331087584,4,2,6
"java/drda/org/apache/derby/impl/drda/XADatabase.java",0,0.7578125,2,3,5
"java/drda/org/apache/derby/impl/drda/memCheck.java",0,0.927710843373494,0,2,2
"java/drda/org/apache/derby/mbeans/drda/NetworkServerMBean.java",0,0.738775510204082,2,2,4
"java/engine/org/apache/derby/authentication/SystemPrincipal.java",0,0.993464052287582,1,1,2
"java/engine/org/apache/derby/authentication/UserAuthenticator.java",0,0.547169811320755,0,3,3
"java/engine/org/apache/derby/catalog/AliasInfo.java",0,0.75,0,4,4
"java/engine/org/apache/derby/catalog/DefaultInfo.java",0,0.411764705882353,0,4,4
"java/engine/org/apache/derby/catalog/Dependable.java",0,0.929203539823009,1,2,3
"java/engine/org/apache/derby/catalog/DependableFinder.java",0,0.91304347826087,0,2,2
"java/engine/org/apache/derby/catalog/GetProcedureColumns.java",0,0.735119047619048,3,2,5
"java/engine/org/apache/derby/catalog/IndexDescriptor.java",0,0.870967741935484,1,2,3
"java/engine/org/apache/derby/catalog/ReferencedColumns.java",0,0.857142857142857,0,2,2
"java/engine/org/apache/derby/catalog/Statistics.java",0,0.825,0,2,2
"java/engine/org/apache/derby/catalog/SystemProcedures.java",0,0.603065539112051,6,4,10
"java/engine/org/apache/derby/catalog/TriggerNewTransitionRows.java",0,0.817307692307692,0,3,3
"java/engine/org/apache/derby/catalog/TriggerOldTransitionRows.java",0,0.808080808080808,0,3,3
"java/engine/org/apache/derby/catalog/TypeDescriptor.java",0,0.826086956521739,3,3,6
"java/engine/org/apache/derby/catalog/UUID.java",0,0.9,0,2,2
"java/engine/org/apache/derby/catalog/types/BaseTypeIdImpl.java",0,0.962466487935657,3,1,4
"java/engine/org/apache/derby/catalog/types/DecimalTypeIdImpl.java",0,0.930232558139535,0,2,2
"java/engine/org/apache/derby/catalog/types/DefaultInfoImpl.java",0,0.568548387096774,2,3,5
"java/engine/org/apache/derby/catalog/types/IndexDescriptorImpl.java",0,0.804945054945055,2,2,4
"java/engine/org/apache/derby/catalog/types/MethodAliasInfo.java",0,0.937007874015748,2,1,3
"java/engine/org/apache/derby/catalog/types/OldRoutineType.java",0,1,0,1,1
"java/engine/org/apache/derby/catalog/types/ReferencedColumnsDescriptorImpl.java",0,0.953846153846154,1,1,2
"java/engine/org/apache/derby/catalog/types/RoutineAliasInfo.java",0,0.775700934579439,3,3,6
"java/engine/org/apache/derby/catalog/types/RowMultiSetImpl.java",0,0.972350230414747,1,1,2
"java/engine/org/apache/derby/catalog/types/StatisticsImpl.java",0,0.951219512195122,1,1,2
"java/engine/org/apache/derby/catalog/types/SynonymAliasInfo.java",0,0.927272727272727,1,2,3
"java/engine/org/apache/derby/catalog/types/TypeDescriptorImpl.java",0,0.547169811320755,3,3,6
"java/engine/org/apache/derby/catalog/types/TypesImplInstanceGetter.java",0,0.885245901639344,1,2,3
"java/engine/org/apache/derby/catalog/types/UserDefinedTypeIdImpl.java",0,0.949152542372881,0,2,2
"java/engine/org/apache/derby/database/Database.java",0,0.628205128205128,0,3,3
"java/engine/org/apache/derby/diag/ContainedRoles.java",0,1,0,1,1
"java/engine/org/apache/derby/diag/ErrorLogReader.java",0,0.973451327433628,2,1,3
"java/engine/org/apache/derby/diag/ErrorMessages.java",0,0.941176470588235,3,1,4
"java/engine/org/apache/derby/diag/LockTable.java",0,0.965217391304348,3,1,4
"java/engine/org/apache/derby/diag/SpaceTable.java",0,0.984084880636605,1,1,2
"java/engine/org/apache/derby/diag/StatementCache.java",0,0.922222222222222,3,1,4
"java/engine/org/apache/derby/diag/StatementDuration.java",0,0.973837209302326,2,1,3
"java/engine/org/apache/derby/diag/TransactionTable.java",0,0.953781512605042,2,1,3
"java/engine/org/apache/derby/iapi/db/ConnectionInfo.java",0,0.939393939393939,0,2,2
"java/engine/org/apache/derby/iapi/db/ConsistencyChecker.java",0,0.986486486486487,1,1,2
"java/engine/org/apache/derby/iapi/db/Database.java",0,0.651933701657459,3,2,5
"java/engine/org/apache/derby/iapi/db/DatabaseContext.java",0,0.818181818181818,0,2,2
"java/engine/org/apache/derby/iapi/db/Factory.java",0,0.924731182795699,1,2,3
"java/engine/org/apache/derby/iapi/db/OptimizerTrace.java",0,0.950704225352113,2,1,3
"java/engine/org/apache/derby/iapi/db/PropertyInfo.java",0,0.958762886597938,2,1,3
"java/engine/org/apache/derby/iapi/db/TriggerExecutionContext.java",0,0.96875,1,1,2
"java/engine/org/apache/derby/iapi/error/DerbySQLException.java",0,1,0,1,1
"java/engine/org/apache/derby/iapi/error/ErrorStringBuilder.java",0,0.897637795275591,3,1,4
"java/engine/org/apache/derby/iapi/error/ExceptionSeverity.java",0,0.676470588235294,0,2,2
"java/engine/org/apache/derby/iapi/error/PassThroughException.java",0,0.51219512195122,0,3,3
"java/engine/org/apache/derby/iapi/error/PublicAPI.java",0,0.875,0,2,2
"java/engine/org/apache/derby/iapi/error/SQLWarningFactory.java",0,0.945205479452055,0,2,2
"java/engine/org/apache/derby/iapi/error/ShutdownException.java",0,0.823529411764706,0,2,2
"java/engine/org/apache/derby/iapi/error/StandardException.java",0,0.867847411444142,3,2,5
"java/engine/org/apache/derby/iapi/jdbc/AuthenticationService.java",0,0.88,0,2,2
"java/engine/org/apache/derby/iapi/jdbc/BrokeredCallableStatement.java",0,0.964143426294821,3,1,4
"java/engine/org/apache/derby/iapi/jdbc/BrokeredCallableStatement30.java",0,0.964601769911504,2,1,3
"java/engine/org/apache/derby/iapi/jdbc/BrokeredCallableStatement40.java",0,0.560810810810811,1,3,4
"java/engine/org/apache/derby/iapi/jdbc/BrokeredConnection.java",0,0.774774774774775,7,2,9
"java/engine/org/apache/derby/iapi/jdbc/BrokeredConnection30.java",0,0.95959595959596,2,1,3
"java/engine/org/apache/derby/iapi/jdbc/BrokeredConnection40.java",0,0.684971098265896,2,3,5
"java/engine/org/apache/derby/iapi/jdbc/BrokeredConnectionControl.java",0,0.769230769230769,0,3,3
"java/engine/org/apache/derby/iapi/jdbc/BrokeredPreparedStatement.java",0,0.936014625228519,5,1,6
"java/engine/org/apache/derby/iapi/jdbc/BrokeredPreparedStatement30.java",0,0.89041095890411,1,2,3
"java/engine/org/apache/derby/iapi/jdbc/BrokeredPreparedStatement40.java",0,0.565217391304348,2,3,5
"java/engine/org/apache/derby/iapi/jdbc/BrokeredStatement.java",0,0.899488926746167,2,2,4
"java/engine/org/apache/derby/iapi/jdbc/BrokeredStatement40.java",0,0.695652173913043,1,2,3
"java/engine/org/apache/derby/iapi/jdbc/BrokeredStatementControl.java",0,0.904761904761905,0,2,2
"java/engine/org/apache/derby/iapi/jdbc/CharacterStreamDescriptor.java",0,1,0,1,1
"java/engine/org/apache/derby/iapi/jdbc/ConnectionContext.java",0,0.926829268292683,0,2,2
"java/engine/org/apache/derby/iapi/jdbc/DRDAServerStarter.java",0,0.897959183673469,5,1,6
"java/engine/org/apache/derby/iapi/jdbc/EngineConnection.java",0,0.672566371681416,0,5,5
"java/engine/org/apache/derby/iapi/jdbc/EngineLOB.java",0,1,0,1,1
"java/engine/org/apache/derby/iapi/jdbc/EngineParameterMetaData.java",0,0.953125,1,1,2
"java/engine/org/apache/derby/iapi/jdbc/EnginePreparedStatement.java",0,0.69047619047619,0,3,3
"java/engine/org/apache/derby/iapi/jdbc/EngineResultSet.java",0,0.426470588235294,0,4,4
"java/engine/org/apache/derby/iapi/jdbc/EngineStatement.java",0,0.877551020408163,0,2,2
"java/engine/org/apache/derby/iapi/jdbc/FailedProperties40.java",0,1,0,1,1
"java/engine/org/apache/derby/iapi/jdbc/JDBCBoot.java",0,0.91304347826087,1,2,3
"java/engine/org/apache/derby/iapi/jdbc/ResourceAdapter.java",0,0.957547169811321,3,1,4
"java/engine/org/apache/derby/iapi/reference/Attribute.java",0,0.571875,4,5,9
"java/engine/org/apache/derby/iapi/reference/ClassName.java",0,0.944,2,1,3
"java/engine/org/apache/derby/iapi/reference/ContextId.java",0,0.8,0,2,2
"java/engine/org/apache/derby/iapi/reference/DRDAConstants.java",0,0.953488372093023,2,1,3
"java/engine/org/apache/derby/iapi/reference/EngineType.java",0,0.892857142857143,0,2,2
"java/engine/org/apache/derby/iapi/reference/JDBC20Translation.java",0,1,0,1,1
"java/engine/org/apache/derby/iapi/reference/JDBC30Translation.java",0,1,0,1,1
"java/engine/org/apache/derby/iapi/reference/JDBC40Translation.java",0,0.6,0,2,2
"java/engine/org/apache/derby/iapi/reference/Limits.java",0,0.798076923076923,0,3,3
"java/engine/org/apache/derby/iapi/reference/MessageId.java",0,0.655172413793103,0,2,2
"java/engine/org/apache/derby/iapi/reference/Module.java",0,0.810810810810811,1,2,3
"java/engine/org/apache/derby/iapi/reference/Property.java",0,0.489517819706499,8,3,11
"java/engine/org/apache/derby/iapi/reference/SQLState.java",0,1,0,1,1
"java/engine/org/apache/derby/iapi/security/SecurityUtil.java",0,1,0,1,1
"java/engine/org/apache/derby/iapi/services/cache/CacheFactory.java",0,0.86046511627907,0,2,2
"java/engine/org/apache/derby/iapi/services/cache/CacheManager.java",0,0.8125,3,2,5
"java/engine/org/apache/derby/iapi/services/cache/Cacheable.java",0,0.930232558139535,3,1,4
"java/engine/org/apache/derby/iapi/services/cache/CacheableFactory.java",0,0.901639344262295,0,2,2
"java/engine/org/apache/derby/iapi/services/cache/ClassSize.java",0,0.764383561643836,2,2,4
"java/engine/org/apache/derby/iapi/services/cache/SizedCacheable.java",0,0.863636363636364,0,2,2
"java/engine/org/apache/derby/iapi/services/classfile/AttributeEntry.java",0,0.907692307692308,0,2,2
"java/engine/org/apache/derby/iapi/services/classfile/Attributes.java",0,0.888888888888889,0,2,2
"java/engine/org/apache/derby/iapi/services/classfile/CONSTANT_Double_info.java",0,0.904761904761905,0,2,2
"java/engine/org/apache/derby/iapi/services/classfile/CONSTANT_Float_info.java",0,0.903225806451613,0,2,2
"java/engine/org/apache/derby/iapi/services/classfile/CONSTANT_Index_info.java",0,0.934782608695652,0,2,2
"java/engine/org/apache/derby/iapi/services/classfile/CONSTANT_Integer_info.java",0,0.901639344262295,0,2,2
"java/engine/org/apache/derby/iapi/services/classfile/CONSTANT_Long_info.java",0,0.903225806451613,0,2,2
"java/engine/org/apache/derby/iapi/services/classfile/CONSTANT_Utf8_info.java",0,0.944444444444444,0,2,2
"java/engine/org/apache/derby/iapi/services/classfile/ClassEnumeration.java",0,0.970149253731343,1,1,2
"java/engine/org/apache/derby/iapi/services/classfile/ClassFormatOutput.java",0,0.941747572815534,0,2,2
"java/engine/org/apache/derby/iapi/services/classfile/ClassHolder.java",0,0.985961123110151,2,1,3
"java/engine/org/apache/derby/iapi/services/classfile/ClassInput.java",0,0.88,0,2,2
"java/engine/org/apache/derby/iapi/services/classfile/ClassInvestigator.java",0,0.98974358974359,1,1,2
"java/engine/org/apache/derby/iapi/services/classfile/ClassMember.java",0,0.934782608695652,0,2,2
"java/engine/org/apache/derby/iapi/services/classfile/ConstantPoolEntry.java",0,0.948275862068966,0,2,2
"java/engine/org/apache/derby/iapi/services/classfile/MemberTable.java",0,0.961290322580645,1,1,2
"java/engine/org/apache/derby/iapi/services/classfile/VMDescriptor.java",0,0.924050632911392,0,2,2
"java/engine/org/apache/derby/iapi/services/classfile/VMOpcode.java",0,0.977611940298508,1,1,2
"java/engine/org/apache/derby/iapi/services/compiler/ClassBuilder.java",0,0.942708333333333,3,1,4
"java/engine/org/apache/derby/iapi/services/compiler/JavaFactory.java",0,0.952,1,1,2
"java/engine/org/apache/derby/iapi/services/compiler/LocalField.java",0,0.846153846153846,0,2,2
"java/engine/org/apache/derby/iapi/services/compiler/MethodBuilder.java",0,0.989228007181329,1,1,2
"java/engine/org/apache/derby/iapi/services/context/Context.java",0,0.958041958041958,1,1,2
"java/engine/org/apache/derby/iapi/services/context/ContextImpl.java",0,0.936842105263158,0,2,2
"java/engine/org/apache/derby/iapi/services/context/ContextManager.java",0,0.975221238938053,2,1,3
"java/engine/org/apache/derby/iapi/services/context/ContextService.java",0,0.909556313993174,3,2,5
"java/engine/org/apache/derby/iapi/services/context/SystemContext.java",0,0.926829268292683,0,2,2
"java/engine/org/apache/derby/iapi/services/crypto/CipherFactory.java",0,0.855670103092783,2,3,5
"java/engine/org/apache/derby/iapi/services/crypto/CipherFactoryBuilder.java",0,0.882352941176471,0,2,2
"java/engine/org/apache/derby/iapi/services/crypto/CipherProvider.java",0,0.92,1,2,3
"java/engine/org/apache/derby/iapi/services/daemon/DaemonFactory.java",0,0.892307692307692,1,2,3
"java/engine/org/apache/derby/iapi/services/daemon/DaemonService.java",0,0.782051282051282,1,2,3
"java/engine/org/apache/derby/iapi/services/daemon/Serviceable.java",0,0.939130434782609,1,2,3
"java/engine/org/apache/derby/iapi/services/diag/DiagnosticUtil.java",0,0.954838709677419,2,1,3
"java/engine/org/apache/derby/iapi/services/diag/Diagnosticable.java",0,0.91304347826087,1,2,3
"java/engine/org/apache/derby/iapi/services/diag/DiagnosticableGeneric.java",0,0.933333333333333,0,2,2
"java/engine/org/apache/derby/iapi/services/diag/Performance.java",0,0.806451612903226,0,2,2
"java/engine/org/apache/derby/iapi/services/i18n/BundleFinder.java",0,0.842105263157895,0,2,2
"java/engine/org/apache/derby/iapi/services/i18n/LocaleFinder.java",0,0.916666666666667,0,2,2
"java/engine/org/apache/derby/iapi/services/i18n/MessageService.java",0,0.968481375358166,4,1,5
"java/engine/org/apache/derby/iapi/services/info/JVMInfo.java",0,0.804597701149425,3,2,5
"java/engine/org/apache/derby/iapi/services/info/ProductGenusNames.java",0,0.646153846153846,0,4,4
"java/engine/org/apache/derby/iapi/services/info/ProductVersionHolder.java",0,0.987364620938628,2,1,3
"java/engine/org/apache/derby/iapi/services/info/PropertyNames.java",0,0.863636363636364,0,2,2
"java/engine/org/apache/derby/iapi/services/info/Version.java",0,1,0,1,1
"java/engine/org/apache/derby/iapi/services/io/AccessibleByteArrayOutputStream.java",0,0.945945945945946,0,2,2
"java/engine/org/apache/derby/iapi/services/io/ApplicationObjectInputStream.java",0,0.916666666666667,0,2,2
"java/engine/org/apache/derby/iapi/services/io/ArrayInputStream.java",0,0.903532608695652,3,2,5
"java/engine/org/apache/derby/iapi/services/io/ArrayOutputStream.java",0,0.95,0,2,2
"java/engine/org/apache/derby/iapi/services/io/ArrayUtil.java",0,0.929347826086957,1,2,3
"java/engine/org/apache/derby/iapi/services/io/CompressedNumber.java",0,0.987951807228916,1,1,2
"java/engine/org/apache/derby/iapi/services/io/CounterOutputStream.java",0,0.956204379562044,1,1,2
"java/engine/org/apache/derby/iapi/services/io/DebugByteTeeOutputStream.java",0,0.672727272727273,0,3,3
"java/engine/org/apache/derby/iapi/services/io/DerbyIOException.java",0,1,0,1,1
"java/engine/org/apache/derby/iapi/services/io/DynamicByteArrayOutputStream.java",0,0.975903614457831,1,1,2
"java/engine/org/apache/derby/iapi/services/io/ErrorInfo.java",0,0.8125,0,2,2
"java/engine/org/apache/derby/iapi/services/io/ErrorObjectInput.java",0,0.842105263157895,0,2,2
"java/engine/org/apache/derby/iapi/services/io/FileUtil.java",0,0.863554757630162,2,2,4
"java/engine/org/apache/derby/iapi/services/io/FormatIdInputStream.java",0,0.97489539748954,1,1,2
"java/engine/org/apache/derby/iapi/services/io/FormatIdOutputStream.java",0,0.975609756097561,1,1,2
"java/engine/org/apache/derby/iapi/services/io/FormatIdUtil.java",0,0.901234567901235,0,2,2
"java/engine/org/apache/derby/iapi/services/io/Formatable.java",0,0.815789473684211,1,2,3
"java/engine/org/apache/derby/iapi/services/io/FormatableArrayHolder.java",0,0.955801104972376,2,1,3
"java/engine/org/apache/derby/iapi/services/io/FormatableBitSet.java",0,0.682012847965739,2,2,4
"java/engine/org/apache/derby/iapi/services/io/FormatableHashtable.java",0,0.96875,1,1,2
"java/engine/org/apache/derby/iapi/services/io/FormatableInstanceGetter.java",0,0.901639344262295,0,2,2
"java/engine/org/apache/derby/iapi/services/io/FormatableIntHolder.java",0,0.962025316455696,1,1,2
"java/engine/org/apache/derby/iapi/services/io/FormatableLongHolder.java",0,0.937931034482759,2,1,3
"java/engine/org/apache/derby/iapi/services/io/FormatableProperties.java",0,0.958333333333333,1,1,2
"java/engine/org/apache/derby/iapi/services/io/InputStreamUtil.java",0,0.513661202185792,1,2,3
"java/engine/org/apache/derby/iapi/services/io/Limit.java",0,0.896551724137931,0,2,2
"java/engine/org/apache/derby/iapi/services/io/LimitInputStream.java",0,0.959183673469388,1,1,2
"java/engine/org/apache/derby/iapi/services/io/LimitObjectInput.java",0,0.823529411764706,0,2,2
"java/engine/org/apache/derby/iapi/services/io/LimitReader.java",0,0.905405405405405,1,2,3
"java/engine/org/apache/derby/iapi/services/io/NewByteArrayInputStream.java",0,0.920353982300885,1,2,3
"java/engine/org/apache/derby/iapi/services/io/NullOutputStream.java",0,0.898305084745763,0,2,2
"java/engine/org/apache/derby/iapi/services/io/RegisteredFormatIds.java",0,0.931098696461825,6,1,7
"java/engine/org/apache/derby/iapi/services/io/SQLExceptionWrapper.java",0,0.918918918918919,0,2,2
"java/engine/org/apache/derby/iapi/services/io/Storable.java",0,0.872340425531915,0,2,2
"java/engine/org/apache/derby/iapi/services/io/StoredFormatIds.java",0,0.836039811419591,5,2,7
"java/engine/org/apache/derby/iapi/services/io/StreamStorable.java",0,0.898305084745763,0,2,2
"java/engine/org/apache/derby/iapi/services/io/TypedFormat.java",0,0.847826086956522,1,2,3
"java/engine/org/apache/derby/iapi/services/jmx/ManagementService.java",0,1,0,1,1
"java/engine/org/apache/derby/iapi/services/loader/ClassFactory.java",0,0.918367346938776,1,2,3
"java/engine/org/apache/derby/iapi/services/loader/ClassFactoryContext.java",0,0.905882352941176,1,2,3
"java/engine/org/apache/derby/iapi/services/loader/ClassInfo.java",0,0.94,0,2,2
"java/engine/org/apache/derby/iapi/services/loader/ClassInspector.java",0,0.927655677655678,3,1,4
"java/engine/org/apache/derby/iapi/services/loader/GeneratedByteCode.java",0,0.885714285714286,1,2,3
"java/engine/org/apache/derby/iapi/services/loader/GeneratedClass.java",0,0.876923076923077,1,2,3
"java/engine/org/apache/derby/iapi/services/loader/GeneratedMethod.java",0,0.847826086956522,1,2,3
"java/engine/org/apache/derby/iapi/services/loader/InstanceGetter.java",0,0.842105263157895,0,2,2
"java/engine/org/apache/derby/iapi/services/loader/JarReader.java",0,0.846153846153846,0,2,2
"java/engine/org/apache/derby/iapi/services/locks/C_LockFactory.java",0,0.869565217391304,0,2,2
"java/engine/org/apache/derby/iapi/services/locks/CompatibilitySpace.java",0,1,0,1,1
"java/engine/org/apache/derby/iapi/services/locks/Latch.java",0,0.822222222222222,1,2,3
"java/engine/org/apache/derby/iapi/services/locks/Limit.java",0,0.807692307692308,1,3,4
"java/engine/org/apache/derby/iapi/services/locks/LockFactory.java",0,0.73542600896861,2,2,4
"java/engine/org/apache/derby/iapi/services/locks/LockOwner.java",0,1,0,1,1
"java/engine/org/apache/derby/iapi/services/locks/Lockable.java",0,0.960264900662252,1,1,2
"java/engine/org/apache/derby/iapi/services/locks/ShExLockable.java",0,0.946902654867257,0,2,2
"java/engine/org/apache/derby/iapi/services/locks/ShExQual.java",0,0.901639344262295,0,2,2
"java/engine/org/apache/derby/iapi/services/locks/VirtualLockTable.java",0,0.92,0,2,2
"java/engine/org/apache/derby/iapi/services/memory/LowMemory.java",0,0.956521739130435,1,1,2
"java/engine/org/apache/derby/iapi/services/monitor/ModuleControl.java",0,0.93,1,2,3
"java/engine/org/apache/derby/iapi/services/monitor/ModuleFactory.java",0,0.977124183006536,2,1,3
"java/engine/org/apache/derby/iapi/services/monitor/ModuleSupportable.java",0,0.892857142857143,0,2,2
"java/engine/org/apache/derby/iapi/services/monitor/Monitor.java",0,0.982630272952854,3,1,4
"java/engine/org/apache/derby/iapi/services/monitor/PersistentService.java",0,0.961165048543689,2,1,3
"java/engine/org/apache/derby/iapi/services/property/PersistentSet.java",0,0.962962962962963,1,1,2
"java/engine/org/apache/derby/iapi/services/property/PropertyFactory.java",0,0.948275862068966,0,2,2
"java/engine/org/apache/derby/iapi/services/property/PropertySetCallback.java",0,0.934782608695652,0,2,2
"java/engine/org/apache/derby/iapi/services/property/PropertyUtil.java",0,0.781150159744409,4,2,6
"java/engine/org/apache/derby/iapi/services/property/PropertyValidation.java",0,0.962025316455696,1,1,2
"java/engine/org/apache/derby/iapi/services/sanity/AssertFailure.java",0,0.682926829268293,0,3,3
"java/engine/org/apache/derby/iapi/services/sanity/SanityManager.java",0,0.666666666666667,0,3,3
"java/engine/org/apache/derby/iapi/services/stream/HeaderPrintWriter.java",0,0.877777777777778,0,3,3
"java/engine/org/apache/derby/iapi/services/stream/InfoStreams.java",0,0.866666666666667,0,2,2
"java/engine/org/apache/derby/iapi/services/stream/PrintWriterGetHeader.java",0,0.863636363636364,0,2,2
"java/engine/org/apache/derby/iapi/services/timer/TimerFactory.java",0,0.846153846153846,0,2,2
"java/engine/org/apache/derby/iapi/services/uuid/UUIDFactory.java",0,0.921052631578947,0,2,2
"java/engine/org/apache/derby/iapi/sql/Activation.java",0,0.926634768740032,2,2,4
"java/engine/org/apache/derby/iapi/sql/LanguageFactory.java",0,0.914285714285714,0,2,2
"java/engine/org/apache/derby/iapi/sql/LanguageProperties.java",0,0.877551020408163,0,2,2
"java/engine/org/apache/derby/iapi/sql/ParameterValueSet.java",0,0.965217391304348,3,1,4
"java/engine/org/apache/derby/iapi/sql/PreparedStatement.java",0,0.794871794871795,2,2,4
"java/engine/org/apache/derby/iapi/sql/ResultColumnDescriptor.java",0,0.905172413793103,1,2,3
"java/engine/org/apache/derby/iapi/sql/ResultDescription.java",0,0.924528301886792,2,2,4
"java/engine/org/apache/derby/iapi/sql/ResultSet.java",0,0.94578313253012,2,1,3
"java/engine/org/apache/derby/iapi/sql/Row.java",0,0.903225806451613,0,2,2
"java/engine/org/apache/derby/iapi/sql/Statement.java",0,0.775700934579439,0,3,3
"java/engine/org/apache/derby/iapi/sql/StatementType.java",0,0.868852459016393,1,2,3
"java/engine/org/apache/derby/iapi/sql/StatementUtil.java",0,0.91304347826087,0,2,2
"java/engine/org/apache/derby/iapi/sql/StorablePreparedStatement.java",0,0.863636363636364,0,2,2
"java/engine/org/apache/derby/iapi/sql/compile/AccessPath.java",0,0.956204379562044,1,1,2
"java/engine/org/apache/derby/iapi/sql/compile/C_NodeTypes.java",0,0.813765182186235,5,3,8
"java/engine/org/apache/derby/iapi/sql/compile/CodeGeneration.java",0,0.806451612903226,0,2,2
"java/engine/org/apache/derby/iapi/sql/compile/CompilerContext.java",0,0.833910034602076,4,2,6
"java/engine/org/apache/derby/iapi/sql/compile/CostEstimate.java",0,0.946428571428571,0,2,2
"java/engine/org/apache/derby/iapi/sql/compile/ExpressionClassBuilderInterface.java",0,0.8125,0,2,2
"java/engine/org/apache/derby/iapi/sql/compile/JoinStrategy.java",0,0.903654485049834,4,1,5
"java/engine/org/apache/derby/iapi/sql/compile/NodeFactory.java",0,0.9872,2,1,3
"java/engine/org/apache/derby/iapi/sql/compile/Optimizable.java",0,0.867549668874172,2,2,4
"java/engine/org/apache/derby/iapi/sql/compile/OptimizableList.java",0,0.944444444444444,0,2,2
"java/engine/org/apache/derby/iapi/sql/compile/OptimizablePredicate.java",0,0.946308724832215,2,1,3
"java/engine/org/apache/derby/iapi/sql/compile/OptimizablePredicateList.java",0,0.957831325301205,2,1,3
"java/engine/org/apache/derby/iapi/sql/compile/Optimizer.java",0,0.890140845070423,2,2,4
"java/engine/org/apache/derby/iapi/sql/compile/OptimizerFactory.java",0,0.927083333333333,0,2,2
"java/engine/org/apache/derby/iapi/sql/compile/Parser.java",0,0.906666666666667,0,2,2
"java/engine/org/apache/derby/iapi/sql/compile/RequiredRowOrdering.java",0,0.944954128440367,0,2,2
"java/engine/org/apache/derby/iapi/sql/compile/RowOrdering.java",0,0.966480446927374,1,1,2
"java/engine/org/apache/derby/iapi/sql/compile/TypeCompiler.java",0,0.883177570093458,2,2,4
"java/engine/org/apache/derby/iapi/sql/compile/TypeCompilerFactory.java",0,0.863636363636364,0,2,2
"java/engine/org/apache/derby/iapi/sql/compile/Visitable.java",0,0.86046511627907,0,2,2
"java/engine/org/apache/derby/iapi/sql/compile/Visitor.java",0,0.936170212765957,0,2,2
"java/engine/org/apache/derby/iapi/sql/conn/Authorizer.java",0,0.594202898550725,3,2,5
"java/engine/org/apache/derby/iapi/sql/conn/ConnectionUtil.java",0,0.894736842105263,0,2,2
"java/engine/org/apache/derby/iapi/sql/conn/LanguageConnectionContext.java",0,0.802161263507897,6,2,8
"java/engine/org/apache/derby/iapi/sql/conn/LanguageConnectionFactory.java",0,0.932098765432099,2,1,3
"java/engine/org/apache/derby/iapi/sql/conn/SQLSessionContext.java",0,1,0,1,1
"java/engine/org/apache/derby/iapi/sql/conn/StatementContext.java",0,0.835714285714286,2,2,4
"java/engine/org/apache/derby/iapi/sql/depend/Dependency.java",0,0.892857142857143,0,2,2
"java/engine/org/apache/derby/iapi/sql/depend/DependencyManager.java",0,0.87027027027027,4,2,6
"java/engine/org/apache/derby/iapi/sql/depend/Dependent.java",0,0.917808219178082,0,2,2
"java/engine/org/apache/derby/iapi/sql/depend/Provider.java",0,0.85,0,2,2
"java/engine/org/apache/derby/iapi/sql/depend/ProviderInfo.java",0,0.882352941176471,0,2,2
"java/engine/org/apache/derby/iapi/sql/depend/ProviderList.java",0,0.857142857142857,0,2,2
"java/engine/org/apache/derby/iapi/sql/dictionary/AliasDescriptor.java",0,0.925187032418953,3,1,4
"java/engine/org/apache/derby/iapi/sql/dictionary/CatalogRowFactory.java",0,0.979228486646884,1,1,2
"java/engine/org/apache/derby/iapi/sql/dictionary/CheckConstraintDescriptor.java",0,0.957446808510638,1,1,2
"java/engine/org/apache/derby/iapi/sql/dictionary/ColPermsDescriptor.java",0,0.511627906976744,1,2,3
"java/engine/org/apache/derby/iapi/sql/dictionary/ColumnDescriptor.java",0,0.728370221327968,4,3,7
"java/engine/org/apache/derby/iapi/sql/dictionary/ColumnDescriptorList.java",0,0.931506849315068,0,2,2
"java/engine/org/apache/derby/iapi/sql/dictionary/ConglomerateDescriptor.java",0,0.572755417956656,2,2,4
"java/engine/org/apache/derby/iapi/sql/dictionary/ConglomerateDescriptorList.java",0,0.966386554621849,1,1,2
"java/engine/org/apache/derby/iapi/sql/dictionary/ConsInfo.java",0,0.936842105263158,0,2,2
"java/engine/org/apache/derby/iapi/sql/dictionary/ConstraintDescriptor.java",0,0.915006640106242,3,1,4
"java/engine/org/apache/derby/iapi/sql/dictionary/ConstraintDescriptorList.java",0,0.978181818181818,1,1,2
"java/engine/org/apache/derby/iapi/sql/dictionary/DDUtils.java",0,0.992349726775956,2,1,3
"java/engine/org/apache/derby/iapi/sql/dictionary/DataDescriptorGenerator.java",0,0.797297297297297,1,3,4
"java/engine/org/apache/derby/iapi/sql/dictionary/DataDictionary.java",0,0.762361251261352,10,3,13
"java/engine/org/apache/derby/iapi/sql/dictionary/DefaultDescriptor.java",0,0.975708502024291,1,1,2
"java/engine/org/apache/derby/iapi/sql/dictionary/DependencyDescriptor.java",0,0.955223880597015,1,1,2
"java/engine/org/apache/derby/iapi/sql/dictionary/FileInfoDescriptor.java",0,0.963855421686747,1,1,2
"java/engine/org/apache/derby/iapi/sql/dictionary/ForeignKeyConstraintDescriptor.java",0,0.976666666666667,1,1,2
"java/engine/org/apache/derby/iapi/sql/dictionary/GenericDescriptorList.java",0,0.935483870967742,0,2,2
"java/engine/org/apache/derby/iapi/sql/dictionary/IndexLister.java",0,0.976,1,1,2
"java/engine/org/apache/derby/iapi/sql/dictionary/IndexRowGenerator.java",0,0.734234234234234,1,3,4
"java/engine/org/apache/derby/iapi/sql/dictionary/KeyConstraintDescriptor.java",0,0.962962962962963,1,1,2
"java/engine/org/apache/derby/iapi/sql/dictionary/PermissionsDescriptor.java",0,0.503448275862069,2,2,4
"java/engine/org/apache/derby/iapi/sql/dictionary/ReferencedKeyConstraintDescriptor.java",0,0.980281690140845,1,1,2
"java/engine/org/apache/derby/iapi/sql/dictionary/RoleClosureIterator.java",0,1,0,1,1
"java/engine/org/apache/derby/iapi/sql/dictionary/RoleGrantDescriptor.java",0,1,0,1,1
"java/engine/org/apache/derby/iapi/sql/dictionary/RoutinePermsDescriptor.java",0,0.535714285714286,1,2,3
"java/engine/org/apache/derby/iapi/sql/dictionary/SPSDescriptor.java",0,0.939526730937774,6,1,7
"java/engine/org/apache/derby/iapi/sql/dictionary/SchemaDescriptor.java",0,0.875283446712018,5,1,6
"java/engine/org/apache/derby/iapi/sql/dictionary/StatementColumnPermission.java",0,0.51981351981352,1,3,4
"java/engine/org/apache/derby/iapi/sql/dictionary/StatementPermission.java",0,0.448717948717949,1,4,5
"java/engine/org/apache/derby/iapi/sql/dictionary/StatementRolePermission.java",0,1,0,1,1
"java/engine/org/apache/derby/iapi/sql/dictionary/StatementRoutinePermission.java",0,0.614973262032086,1,3,4
"java/engine/org/apache/derby/iapi/sql/dictionary/StatementSchemaPermission.java",0,0.347826086956522,1,4,5
"java/engine/org/apache/derby/iapi/sql/dictionary/StatementTablePermission.java",0,0.56687898089172,2,3,5
"java/engine/org/apache/derby/iapi/sql/dictionary/StatisticsDescriptor.java",0,0.934782608695652,0,2,2
"java/engine/org/apache/derby/iapi/sql/dictionary/SubCheckConstraintDescriptor.java",0,0.939655172413793,0,2,2
"java/engine/org/apache/derby/iapi/sql/dictionary/SubConstraintDescriptor.java",0,0.947761194029851,0,2,2
"java/engine/org/apache/derby/iapi/sql/dictionary/SubKeyConstraintDescriptor.java",0,0.949152542372881,0,2,2
"java/engine/org/apache/derby/iapi/sql/dictionary/SystemColumn.java",0,0.877551020408163,0,2,2
"java/engine/org/apache/derby/iapi/sql/dictionary/TableDescriptor.java",0,0.882778581765557,5,1,6
"java/engine/org/apache/derby/iapi/sql/dictionary/TablePermsDescriptor.java",0,0.553191489361702,1,2,3
"java/engine/org/apache/derby/iapi/sql/dictionary/TriggerDescriptor.java",0,0.963594994311718,4,1,5
"java/engine/org/apache/derby/iapi/sql/dictionary/TupleDescriptor.java",0,0.952755905511811,1,1,2
"java/engine/org/apache/derby/iapi/sql/dictionary/UniqueSQLObjectDescriptor.java",0,0.898305084745763,0,2,2
"java/engine/org/apache/derby/iapi/sql/dictionary/UniqueTupleDescriptor.java",0,0.846153846153846,0,2,2
"java/engine/org/apache/derby/iapi/sql/dictionary/ViewDescriptor.java",0,0.873051224944321,5,1,6
"java/engine/org/apache/derby/iapi/sql/execute/ConstantAction.java",0,0.886792452830189,0,2,2
"java/engine/org/apache/derby/iapi/sql/execute/CursorActivation.java",0,0.869565217391304,0,2,2
"java/engine/org/apache/derby/iapi/sql/execute/CursorResultSet.java",0,0.903225806451613,0,2,2
"java/engine/org/apache/derby/iapi/sql/execute/ExecAggregator.java",0,0.950819672131147,1,1,2
"java/engine/org/apache/derby/iapi/sql/execute/ExecCursorTableReference.java",0,0.894736842105263,0,2,2
"java/engine/org/apache/derby/iapi/sql/execute/ExecIndexRow.java",0,0.90625,0,2,2
"java/engine/org/apache/derby/iapi/sql/execute/ExecPreparedStatement.java",0,0.91358024691358,2,1,3
"java/engine/org/apache/derby/iapi/sql/execute/ExecRow.java",0,0.854166666666667,0,3,3
"java/engine/org/apache/derby/iapi/sql/execute/ExecutionContext.java",0,0.926829268292683,0,2,2
"java/engine/org/apache/derby/iapi/sql/execute/ExecutionFactory.java",0,0.969924812030075,1,1,2
"java/engine/org/apache/derby/iapi/sql/execute/ExecutionStmtValidator.java",0,0.884615384615385,0,2,2
"java/engine/org/apache/derby/iapi/sql/execute/NoPutResultSet.java",0,0.785714285714286,1,2,3
"java/engine/org/apache/derby/iapi/sql/execute/ResultSetFactory.java",0,0.880560633759902,7,1,8
"java/engine/org/apache/derby/iapi/sql/execute/ResultSetStatisticsFactory.java",0,0.921052631578947,0,2,2
"java/engine/org/apache/derby/iapi/sql/execute/RowChanger.java",0,0.871951219512195,1,2,3
"java/engine/org/apache/derby/iapi/sql/execute/RunTimeStatistics.java",0,0.970873786407767,1,1,2
"java/engine/org/apache/derby/iapi/sql/execute/ScanQualifier.java",0,0.875,0,2,2
"java/engine/org/apache/derby/iapi/sql/execute/TargetResultSet.java",0,0.90625,0,2,2
"java/engine/org/apache/derby/iapi/sql/execute/TemporaryRowHolder.java",0,0.906666666666667,0,2,2
"java/engine/org/apache/derby/iapi/sql/execute/TupleFilter.java",0,0.872727272727273,0,2,2
"java/engine/org/apache/derby/iapi/store/access/AccessFactory.java",0,0.743440233236152,1,3,4
"java/engine/org/apache/derby/iapi/store/access/AccessFactoryGlobals.java",0,0.908045977011494,1,2,3
"java/engine/org/apache/derby/iapi/store/access/BackingStoreHashtable.java",0,0.608531994981179,2,4,6
"java/engine/org/apache/derby/iapi/store/access/BinaryOrderable.java",0,0.942307692307692,0,2,2
"java/engine/org/apache/derby/iapi/store/access/ColumnOrdering.java",0,0.686274509803922,0,3,3
"java/engine/org/apache/derby/iapi/store/access/ConglomPropertyQueryable.java",0,0.940594059405941,0,2,2
"java/engine/org/apache/derby/iapi/store/access/ConglomerateController.java",0,0.958785249457701,2,1,3
"java/engine/org/apache/derby/iapi/store/access/DatabaseInstant.java",0,0.945454545454545,0,2,2
"java/engine/org/apache/derby/iapi/store/access/DiskHashtable.java",0,0.551440329218107,3,2,5
"java/engine/org/apache/derby/iapi/store/access/DynamicCompiledOpenConglomInfo.java",0,0.888888888888889,0,2,2
"java/engine/org/apache/derby/iapi/store/access/FileResource.java",0,0.899159663865546,0,3,3
"java/engine/org/apache/derby/iapi/store/access/GenericScanController.java",0,0.959276018099548,2,1,3
"java/engine/org/apache/derby/iapi/store/access/GlobalXact.java",0,0.877697841726619,2,2,4
"java/engine/org/apache/derby/iapi/store/access/GroupFetchScanController.java",0,0.925925925925926,2,1,3
"java/engine/org/apache/derby/iapi/store/access/KeyHasher.java",0,0.953125,1,1,2
"java/engine/org/apache/derby/iapi/store/access/Qualifier.java",0,0.819230769230769,2,2,4
"java/engine/org/apache/derby/iapi/store/access/RowCountable.java",0,0.928571428571429,0,2,2
"java/engine/org/apache/derby/iapi/store/access/RowLocationRetRowSource.java",0,0.933333333333333,0,2,2
"java/engine/org/apache/derby/iapi/store/access/RowSource.java",0,0.93859649122807,1,2,3
"java/engine/org/apache/derby/iapi/store/access/RowUtil.java",0,0.942028985507246,3,1,4
"java/engine/org/apache/derby/iapi/store/access/ScanController.java",0,0.85632183908046,3,2,5
"java/engine/org/apache/derby/iapi/store/access/ScanInfo.java",0,0.934065934065934,0,2,2
"java/engine/org/apache/derby/iapi/store/access/SortController.java",0,0.925,0,2,2
"java/engine/org/apache/derby/iapi/store/access/SortCostController.java",0,0.953125,1,1,2
"java/engine/org/apache/derby/iapi/store/access/SortInfo.java",0,0.929411764705882,0,2,2
"java/engine/org/apache/derby/iapi/store/access/SortObserver.java",0,0.954198473282443,1,1,2
"java/engine/org/apache/derby/iapi/store/access/SpaceInfo.java",0,0.890909090909091,0,2,2
"java/engine/org/apache/derby/iapi/store/access/StaticCompiledOpenConglomInfo.java",0,0.896551724137931,0,2,2
"java/engine/org/apache/derby/iapi/store/access/StoreCostController.java",0,0.979695431472081,2,1,3
"java/engine/org/apache/derby/iapi/store/access/StoreCostResult.java",0,0.888888888888889,0,2,2
"java/engine/org/apache/derby/iapi/store/access/TransactionController.java",0,0.914567901234568,4,2,6
"java/engine/org/apache/derby/iapi/store/access/TransactionInfo.java",0,0.823529411764706,0,2,2
"java/engine/org/apache/derby/iapi/store/access/XATransactionController.java",0,0.948275862068966,0,2,2
"java/engine/org/apache/derby/iapi/store/access/conglomerate/Conglomerate.java",0,0.837905236907731,2,2,4
"java/engine/org/apache/derby/iapi/store/access/conglomerate/ConglomerateFactory.java",0,0.933333333333333,1,2,3
"java/engine/org/apache/derby/iapi/store/access/conglomerate/LogicalUndo.java",0,0.947761194029851,2,1,3
"java/engine/org/apache/derby/iapi/store/access/conglomerate/MethodFactory.java",0,0.922077922077922,0,2,2
"java/engine/org/apache/derby/iapi/store/access/conglomerate/ScanControllerRowSource.java",0,0.837837837837838,0,2,2
"java/engine/org/apache/derby/iapi/store/access/conglomerate/ScanManager.java",0,0.965317919075145,1,1,2
"java/engine/org/apache/derby/iapi/store/access/conglomerate/Sort.java",0,0.931818181818182,0,2,2
"java/engine/org/apache/derby/iapi/store/access/conglomerate/SortFactory.java",0,0.927710843373494,0,2,2
"java/engine/org/apache/derby/iapi/store/access/conglomerate/TransactionManager.java",0,0.831395348837209,1,2,3
"java/engine/org/apache/derby/iapi/store/access/xa/XAResourceManager.java",0,0.963414634146341,1,1,2
"java/engine/org/apache/derby/iapi/store/access/xa/XAXactId.java",0,0.975778546712803,2,1,3
"java/engine/org/apache/derby/iapi/store/raw/AuxObject.java",0,0.857142857142857,0,2,2
"java/engine/org/apache/derby/iapi/store/raw/Compensation.java",0,0.863636363636364,0,2,2
"java/engine/org/apache/derby/iapi/store/raw/ContainerHandle.java",0,0.915702479338843,4,1,5
"java/engine/org/apache/derby/iapi/store/raw/ContainerKey.java",0,0.968085106382979,1,1,2
"java/engine/org/apache/derby/iapi/store/raw/ContainerLock.java",0,0.62962962962963,0,3,3
"java/engine/org/apache/derby/iapi/store/raw/Corruptable.java",0,0.828571428571429,0,2,2
"java/engine/org/apache/derby/iapi/store/raw/D_ContainerKey.java",0,0.91304347826087,0,2,2
"java/engine/org/apache/derby/iapi/store/raw/D_ContainerLock.java",0,0.87719298245614,1,2,3
"java/engine/org/apache/derby/iapi/store/raw/D_RowLock.java",0,0.87037037037037,1,2,3
"java/engine/org/apache/derby/iapi/store/raw/FetchDescriptor.java",0,0.976284584980237,1,1,2
"java/engine/org/apache/derby/iapi/store/raw/GlobalTransactionId.java",0,0.904761904761905,0,2,2
"java/engine/org/apache/derby/iapi/store/raw/LockingPolicy.java",0,0.941747572815534,3,1,4
"java/engine/org/apache/derby/iapi/store/raw/Loggable.java",0,0.912790697674419,3,1,4
"java/engine/org/apache/derby/iapi/store/raw/LogicalUndoable.java",0,0.909090909090909,1,2,3
"java/engine/org/apache/derby/iapi/store/raw/Page.java",0,0.856271777003484,3,2,5
"java/engine/org/apache/derby/iapi/store/raw/PageKey.java",0,0.895238095238095,1,2,3
"java/engine/org/apache/derby/iapi/store/raw/PageTimeStamp.java",0,0.837837837837838,0,2,2
"java/engine/org/apache/derby/iapi/store/raw/RawStoreFactory.java",0,0.754146341463415,5,3,8
"java/engine/org/apache/derby/iapi/store/raw/RePreparable.java",0,0.875,0,2,2
"java/engine/org/apache/derby/iapi/store/raw/RecordHandle.java",0,0.915254237288136,1,2,3
"java/engine/org/apache/derby/iapi/store/raw/RowLock.java",0,0.682170542635659,1,2,3
"java/engine/org/apache/derby/iapi/store/raw/ScanHandle.java",0,0.917808219178082,0,2,2
"java/engine/org/apache/derby/iapi/store/raw/ScannedTransactionHandle.java",0,0.869565217391304,0,2,2
"java/engine/org/apache/derby/iapi/store/raw/StreamContainerHandle.java",0,0.927927927927928,1,2,3
"java/engine/org/apache/derby/iapi/store/raw/Transaction.java",0,0.908227848101266,4,1,5
"java/engine/org/apache/derby/iapi/store/raw/Undoable.java",0,0.934579439252336,1,2,3
"java/engine/org/apache/derby/iapi/store/raw/data/DataFactory.java",0,0.797900262467192,7,1,8
"java/engine/org/apache/derby/iapi/store/raw/data/RawContainerHandle.java",0,0.766917293233083,1,4,5
"java/engine/org/apache/derby/iapi/store/raw/log/LogFactory.java",0,0.593516209476309,5,4,9
"java/engine/org/apache/derby/iapi/store/raw/log/LogInstant.java",0,0.828571428571429,0,2,2
"java/engine/org/apache/derby/iapi/store/raw/log/LogScan.java",0,0.823529411764706,0,2,2
"java/engine/org/apache/derby/iapi/store/raw/log/Logger.java",0,0.941558441558442,2,1,3
"java/engine/org/apache/derby/iapi/store/raw/xact/RawTransaction.java",0,0.857938718662953,5,2,7
"java/engine/org/apache/derby/iapi/store/raw/xact/TransactionFactory.java",0,0.82934131736527,4,2,6
"java/engine/org/apache/derby/iapi/store/raw/xact/TransactionId.java",0,0.88,0,2,2
"java/engine/org/apache/derby/iapi/store/replication/master/MasterFactory.java",0,1,0,1,1
"java/engine/org/apache/derby/iapi/store/replication/slave/SlaveFactory.java",0,1,0,1,1
"java/engine/org/apache/derby/iapi/transaction/TransactionControl.java",0,1,0,1,1
"java/engine/org/apache/derby/iapi/transaction/TransactionListener.java",0,1,0,1,1
"java/engine/org/apache/derby/iapi/types/BigIntegerDecimal.java",0,0.98886827458256,1,1,2
"java/engine/org/apache/derby/iapi/types/BinaryDecimal.java",0,0.969187675070028,4,1,5
"java/engine/org/apache/derby/iapi/types/BitDataValue.java",0,0.770491803278688,0,2,2
"java/engine/org/apache/derby/iapi/types/BooleanDataValue.java",0,0.955223880597015,1,1,2
"java/engine/org/apache/derby/iapi/types/CDCDataValueFactory.java",0,0.923076923076923,0,2,2
"java/engine/org/apache/derby/iapi/types/CharStreamHeaderGenerator.java",0,1,0,1,1
"java/engine/org/apache/derby/iapi/types/ClobStreamHeaderGenerator.java",0,1,0,1,1
"java/engine/org/apache/derby/iapi/types/CloneableObject.java",0,0.857142857142857,0,2,2
"java/engine/org/apache/derby/iapi/types/CollationElementsInterface.java",0,0.980769230769231,1,1,2
"java/engine/org/apache/derby/iapi/types/CollatorSQLChar.java",0,0.857142857142857,0,3,3
"java/engine/org/apache/derby/iapi/types/CollatorSQLClob.java",0,0.853080568720379,0,3,3
"java/engine/org/apache/derby/iapi/types/CollatorSQLLongvarchar.java",0,0.867924528301887,0,3,3
"java/engine/org/apache/derby/iapi/types/CollatorSQLVarchar.java",0,0.857798165137615,0,3,3
"java/engine/org/apache/derby/iapi/types/ConcatableDataValue.java",0,0.92,0,2,2
"java/engine/org/apache/derby/iapi/types/DTSClassInfo.java",0,0.717948717948718,0,3,3
"java/engine/org/apache/derby/iapi/types/DataType.java",0,0.832520325203252,4,3,7
"java/engine/org/apache/derby/iapi/types/DataTypeDescriptor.java",0,0.746910263299301,9,2,11
"java/engine/org/apache/derby/iapi/types/DataTypeUtilities.java",0,0.960698689956332,2,1,3
"java/engine/org/apache/derby/iapi/types/DataValueDescriptor.java",0,0.902696365767878,3,2,5
"java/engine/org/apache/derby/iapi/types/DataValueFactory.java",0,0.842509603072983,3,2,5
"java/engine/org/apache/derby/iapi/types/DataValueFactoryImpl.java",0,0.774922118380062,3,2,5
"java/engine/org/apache/derby/iapi/types/DateTimeDataValue.java",0,0.648484848484848,1,2,3
"java/engine/org/apache/derby/iapi/types/DateTimeParser.java",0,0.975,1,1,2
"java/engine/org/apache/derby/iapi/types/J2SEDataValueFactory.java",0,0.917808219178082,0,2,2
"java/engine/org/apache/derby/iapi/types/JSQLType.java",0,0.977464788732394,3,1,4
"java/engine/org/apache/derby/iapi/types/Like.java",0,0.78213802435724,4,3,7
"java/engine/org/apache/derby/iapi/types/NumberDataType.java",0,0.970856102003643,2,1,3
"java/engine/org/apache/derby/iapi/types/NumberDataValue.java",0,0.973094170403587,1,1,2
"java/engine/org/apache/derby/iapi/types/Orderable.java",0,0.90625,0,2,2
"java/engine/org/apache/derby/iapi/types/PositionedStream.java",0,1,0,1,1
"java/engine/org/apache/derby/iapi/types/RawToBinaryFormatStream.java",0,0.479020979020979,1,3,4
"java/engine/org/apache/derby/iapi/types/ReaderToUTF8Stream.java",0,0.436332767402377,1,4,5
"java/engine/org/apache/derby/iapi/types/RefDataValue.java",0,0.837837837837838,0,2,2
"java/engine/org/apache/derby/iapi/types/Resetable.java",0,0.886792452830189,0,2,2
"java/engine/org/apache/derby/iapi/types/RowLocation.java",0,0.853658536585366,0,2,2
"java/engine/org/apache/derby/iapi/types/SQLBinary.java",0,0.828926905132193,5,2,7
"java/engine/org/apache/derby/iapi/types/SQLBit.java",0,0.942965779467681,2,1,3
"java/engine/org/apache/derby/iapi/types/SQLBlob.java",0,0.782426778242678,3,3,6
"java/engine/org/apache/derby/iapi/types/SQLBoolean.java",0,0.981880931837791,3,1,4
"java/engine/org/apache/derby/iapi/types/SQLChar.java",0,0.818152244632401,4,3,7
"java/engine/org/apache/derby/iapi/types/SQLClob.java",0,0.616647127784291,3,3,6
"java/engine/org/apache/derby/iapi/types/SQLDate.java",0,0.85781990521327,3,2,5
"java/engine/org/apache/derby/iapi/types/SQLDecimal.java",0,0.99244966442953,3,1,4
"java/engine/org/apache/derby/iapi/types/SQLDouble.java",0,0.990066225165563,3,1,4
"java/engine/org/apache/derby/iapi/types/SQLInteger.java",0,0.991525423728814,1,1,2
"java/engine/org/apache/derby/iapi/types/SQLLongVarbit.java",0,0.905063291139241,1,2,3
"java/engine/org/apache/derby/iapi/types/SQLLongint.java",0,0.993399339933993,1,1,2
"java/engine/org/apache/derby/iapi/types/SQLLongvarchar.java",0,0.868571428571429,2,2,4
"java/engine/org/apache/derby/iapi/types/SQLReal.java",0,0.993311036789298,1,1,2
"java/engine/org/apache/derby/iapi/types/SQLRef.java",0,0.977272727272727,1,1,2
"java/engine/org/apache/derby/iapi/types/SQLSmallint.java",0,0.992021276595745,1,1,2
"java/engine/org/apache/derby/iapi/types/SQLTime.java",0,0.921830314585319,3,2,5
"java/engine/org/apache/derby/iapi/types/SQLTimestamp.java",0,0.685931558935361,4,2,6
"java/engine/org/apache/derby/iapi/types/SQLTinyint.java",0,0.991935483870968,1,1,2
"java/engine/org/apache/derby/iapi/types/SQLVarbit.java",0,0.926829268292683,2,1,3
"java/engine/org/apache/derby/iapi/types/SQLVarchar.java",0,0.803738317757009,1,4,5
"java/engine/org/apache/derby/iapi/types/SqlXmlUtil.java",0,0.850746268656716,4,2,6
"java/engine/org/apache/derby/iapi/types/StreamHeaderGenerator.java",0,1,0,1,1
"java/engine/org/apache/derby/iapi/types/StringDataValue.java",0,0.524390243902439,2,5,7
"java/engine/org/apache/derby/iapi/types/TypeId.java",0,0.931549471064095,6,1,7
"java/engine/org/apache/derby/iapi/types/UserDataValue.java",0,0.823529411764706,0,2,2
"java/engine/org/apache/derby/iapi/types/UserType.java",0,0.99,1,1,2
"java/engine/org/apache/derby/iapi/types/VariableSizeDataValue.java",0,0.892857142857143,0,2,2
"java/engine/org/apache/derby/iapi/types/WorkHorseForCollatorDatatypes.java",0,0.894736842105263,1,2,3
"java/engine/org/apache/derby/iapi/types/XML.java",0,0.458823529411765,5,3,8
"java/engine/org/apache/derby/iapi/types/XMLDataValue.java",0,0.583333333333333,2,2,4
"java/engine/org/apache/derby/iapi/util/ByteArray.java",0,0.965714285714286,1,1,2
"java/engine/org/apache/derby/iapi/util/CheapDateFormatter.java",0,0.967741935483871,1,1,2
"java/engine/org/apache/derby/iapi/util/DoubleProperties.java",0,0.926829268292683,0,2,2
"java/engine/org/apache/derby/iapi/util/IdUtil.java",0,0.80690537084399,3,2,5
"java/engine/org/apache/derby/iapi/util/JBitSet.java",0,0.976833976833977,1,1,2
"java/engine/org/apache/derby/iapi/util/Matchable.java",0,0.833333333333333,0,2,2
"java/engine/org/apache/derby/iapi/util/Operator.java",0,0.823529411764706,0,2,2
"java/engine/org/apache/derby/iapi/util/PropertyUtil.java",0,0.961165048543689,1,1,2
"java/engine/org/apache/derby/iapi/util/ReuseFactory.java",0,0.8984375,1,2,3
"java/engine/org/apache/derby/iapi/util/StringUtil.java",0,0.620423892100193,2,5,7
"java/engine/org/apache/derby/iapi/util/UTF8Util.java",0,0.971291866028708,1,1,2
"java/engine/org/apache/derby/impl/db/BasicDatabase.java",0,0.862190812720848,5,2,7
"java/engine/org/apache/derby/impl/db/DatabaseContextImpl.java",0,0.921052631578947,0,2,2
"java/engine/org/apache/derby/impl/db/SlaveDatabase.java",0,1,0,1,1
"java/engine/org/apache/derby/impl/db/StoreClassFactoryContext.java",0,0.838709677419355,0,3,3
"java/engine/org/apache/derby/impl/io/BaseStorageFactory.java",0,0.927586206896552,4,1,5
"java/engine/org/apache/derby/impl/io/CPFile.java",0,0.959183673469388,1,1,2
"java/engine/org/apache/derby/impl/io/CPStorageFactory.java",0,0.936170212765957,0,2,2
"java/engine/org/apache/derby/impl/io/DirFile.java",0,0.938405797101449,4,1,5
"java/engine/org/apache/derby/impl/io/DirFile4.java",0,0.944444444444444,5,1,6
"java/engine/org/apache/derby/impl/io/DirRandomAccessFile.java",0,0.918918918918919,0,2,2
"java/engine/org/apache/derby/impl/io/DirRandomAccessFile4.java",0,0.927710843373494,0,2,2
"java/engine/org/apache/derby/impl/io/DirStorageFactory.java",0,0.913461538461538,4,1,5
"java/engine/org/apache/derby/impl/io/DirStorageFactory4.java",0,0.849056603773585,2,3,5
"java/engine/org/apache/derby/impl/io/InputStreamFile.java",0,0.986046511627907,1,1,2
"java/engine/org/apache/derby/impl/io/JarDBFile.java",0,0.961538461538462,1,1,2
"java/engine/org/apache/derby/impl/io/JarStorageFactory.java",0,0.956521739130435,1,1,2
"java/engine/org/apache/derby/impl/io/URLFile.java",0,0.946902654867257,0,2,2
"java/engine/org/apache/derby/impl/io/URLStorageFactory.java",0,0.939393939393939,0,2,2
"java/engine/org/apache/derby/impl/io/VFMemoryStorageFactory.java",0,1,0,1,1
"java/engine/org/apache/derby/impl/io/vfmem/BlockedByteArray.java",0,1,0,1,1
"java/engine/org/apache/derby/impl/io/vfmem/BlockedByteArrayInputStream.java",0,1,0,1,1
"java/engine/org/apache/derby/impl/io/vfmem/BlockedByteArrayOutputStream.java",0,1,0,1,1
"java/engine/org/apache/derby/impl/io/vfmem/DataStore.java",0,1,0,1,1
"java/engine/org/apache/derby/impl/io/vfmem/DataStoreEntry.java",0,1,0,1,1
"java/engine/org/apache/derby/impl/io/vfmem/PathUtil.java",0,1,0,1,1
"java/engine/org/apache/derby/impl/io/vfmem/VirtualFile.java",0,1,0,1,1
"java/engine/org/apache/derby/impl/io/vfmem/VirtualRandomAccessFile.java",0,1,0,1,1
"java/engine/org/apache/derby/impl/jdbc/AutoPositioningStream.java",0,0.993827160493827,1,1,2
"java/engine/org/apache/derby/impl/jdbc/BinaryToRawStream.java",0,0.932773109243697,2,2,4
"java/engine/org/apache/derby/impl/jdbc/ClobAsciiStream.java",0,0.817307692307692,0,2,2
"java/engine/org/apache/derby/impl/jdbc/ClobUpdatableReader.java",0,0.953703703703704,2,1,3
"java/engine/org/apache/derby/impl/jdbc/ClobUtf8Writer.java",0,0.981818181818182,1,1,2
"java/engine/org/apache/derby/impl/jdbc/ConnectionChild.java",0,0.962025316455696,1,1,2
"java/engine/org/apache/derby/impl/jdbc/EmbedBlob.java",0,0.482364156339371,6,3,9
"java/engine/org/apache/derby/impl/jdbc/EmbedCallableStatement.java",0,0.960720130932897,3,1,4
"java/engine/org/apache/derby/impl/jdbc/EmbedCallableStatement169.java",0,0.875,0,2,2
"java/engine/org/apache/derby/impl/jdbc/EmbedCallableStatement20.java",0,0.868399675060926,2,2,4
"java/engine/org/apache/derby/impl/jdbc/EmbedCallableStatement30.java",0,0.942307692307692,0,2,2
"java/engine/org/apache/derby/impl/jdbc/EmbedCallableStatement40.java",0,0.380368098159509,1,3,4
"java/engine/org/apache/derby/impl/jdbc/EmbedClob.java",0,0.68922305764411,7,2,9
"java/engine/org/apache/derby/impl/jdbc/EmbedConnection.java",0,0.572991559862457,11,4,15
"java/engine/org/apache/derby/impl/jdbc/EmbedConnection30.java",0,0.951417004048583,3,1,4
"java/engine/org/apache/derby/impl/jdbc/EmbedConnection40.java",0,0.615094339622641,1,3,4
"java/engine/org/apache/derby/impl/jdbc/EmbedConnectionContext.java",0,0.961783439490446,1,1,2
"java/engine/org/apache/derby/impl/jdbc/EmbedDatabaseMetaData.java",0,0.749193548387097,8,3,11
"java/engine/org/apache/derby/impl/jdbc/EmbedDatabaseMetaData40.java",0,0.401869158878505,1,3,4
"java/engine/org/apache/derby/impl/jdbc/EmbedParameterMetaData30.java",0,0.892857142857143,0,2,2
"java/engine/org/apache/derby/impl/jdbc/EmbedParameterMetaData40.java",0,1,0,1,1
"java/engine/org/apache/derby/impl/jdbc/EmbedParameterSetMetaData.java",0,0.948275862068966,2,1,3
"java/engine/org/apache/derby/impl/jdbc/EmbedPreparedStatement.java",0,0.630309386470897,6,2,8
"java/engine/org/apache/derby/impl/jdbc/EmbedPreparedStatement169.java",0,0.884615384615385,0,2,2
"java/engine/org/apache/derby/impl/jdbc/EmbedPreparedStatement20.java",0,0.961538461538462,1,1,2
"java/engine/org/apache/derby/impl/jdbc/EmbedPreparedStatement30.java",0,0.929411764705882,0,2,2
"java/engine/org/apache/derby/impl/jdbc/EmbedPreparedStatement40.java",0,0.46969696969697,1,3,4
"java/engine/org/apache/derby/impl/jdbc/EmbedResultSet.java",0,0.657574568288854,11,3,14
"java/engine/org/apache/derby/impl/jdbc/EmbedResultSet169.java",0,0.886792452830189,0,2,2
"java/engine/org/apache/derby/impl/jdbc/EmbedResultSet20.java",0,0.859857482185273,3,2,5
"java/engine/org/apache/derby/impl/jdbc/EmbedResultSet40.java",0,0.457627118644068,0,3,3
"java/engine/org/apache/derby/impl/jdbc/EmbedResultSetMetaData.java",0,0.984615384615385,1,1,2
"java/engine/org/apache/derby/impl/jdbc/EmbedResultSetMetaData40.java",0,0.873417721518987,0,2,2
"java/engine/org/apache/derby/impl/jdbc/EmbedSQLException.java",0,0.798165137614679,0,4,4
"java/engine/org/apache/derby/impl/jdbc/EmbedSavepoint30.java",0,0.944,2,1,3
"java/engine/org/apache/derby/impl/jdbc/EmbedStatement.java",0,0.895308924485126,6,2,8
"java/engine/org/apache/derby/impl/jdbc/EmbedStatement40.java",0,0.975308641975309,1,1,2
"java/engine/org/apache/derby/impl/jdbc/EncryptedLOBFile.java",0,1,0,1,1
"java/engine/org/apache/derby/impl/jdbc/InternalClob.java",0,0.995238095238095,1,1,2
"java/engine/org/apache/derby/impl/jdbc/LOBFile.java",0,1,0,1,1
"java/engine/org/apache/derby/impl/jdbc/LOBInputStream.java",0,0.97165991902834,1,1,2
"java/engine/org/apache/derby/impl/jdbc/LOBOutputStream.java",0,0.954887218045113,1,1,2
"java/engine/org/apache/derby/impl/jdbc/LOBStoredProcedure.java",0,0.810344827586207,3,2,5
"java/engine/org/apache/derby/impl/jdbc/LOBStreamControl.java",0,0.80633147113594,2,2,4
"java/engine/org/apache/derby/impl/jdbc/PositionedStoreStream.java",0,0.991701244813278,1,1,2
"java/engine/org/apache/derby/impl/jdbc/ReaderToAscii.java",0,0.943396226415094,0,2,2
"java/engine/org/apache/derby/impl/jdbc/SQLExceptionFactory.java",0,0.983870967741935,1,1,2
"java/engine/org/apache/derby/impl/jdbc/SQLExceptionFactory40.java",0,0.888888888888889,1,2,3
"java/engine/org/apache/derby/impl/jdbc/StoreStreamClob.java",0,1,0,1,1
"java/engine/org/apache/derby/impl/jdbc/TemporaryClob.java",0,0.967592592592593,3,1,4
"java/engine/org/apache/derby/impl/jdbc/TransactionResourceImpl.java",0,0.89438202247191,2,2,4
"java/engine/org/apache/derby/impl/jdbc/UTF8Reader.java",0,0.9258114374034,2,2,4
"java/engine/org/apache/derby/impl/jdbc/UpdatableBlobStream.java",0,0.810924369747899,0,3,3
"java/engine/org/apache/derby/impl/jdbc/Util.java",0,0.730878186968839,2,3,5
"java/engine/org/apache/derby/impl/jdbc/authentication/AuthenticationServiceBase.java",0,0.725092250922509,2,2,4
"java/engine/org/apache/derby/impl/jdbc/authentication/BasicAuthenticationServiceImpl.java",0,0.714859437751004,2,2,4
"java/engine/org/apache/derby/impl/jdbc/authentication/JNDIAuthenticationSchemeBase.java",0,0.8828125,1,2,3
"java/engine/org/apache/derby/impl/jdbc/authentication/JNDIAuthenticationService.java",0,0.94017094017094,1,2,3
"java/engine/org/apache/derby/impl/jdbc/authentication/LDAPAuthenticationSchemeImpl.java",0,0.851485148514851,3,2,5
"java/engine/org/apache/derby/impl/jdbc/authentication/NoneAuthenticationServiceImpl.java",0,0.941176470588235,0,2,2
"java/engine/org/apache/derby/impl/jdbc/authentication/SpecificAuthenticationServiceImpl.java",0,0.956521739130435,1,1,2
"java/engine/org/apache/derby/impl/load/ColumnInfo.java",0,0.746724890829694,4,2,6
"java/engine/org/apache/derby/impl/load/ControlInfo.java",0,0.955729166666667,2,1,3
"java/engine/org/apache/derby/impl/load/Export.java",0,0.398692810457516,3,4,7
"java/engine/org/apache/derby/impl/load/ExportAbstract.java",0,0.562162162162162,1,2,3
"java/engine/org/apache/derby/impl/load/ExportResultSetForObject.java",0,0.606060606060606,2,2,4
"java/engine/org/apache/derby/impl/load/ExportWriteData.java",0,0.56981981981982,2,2,4
"java/engine/org/apache/derby/impl/load/ExportWriteDataAbstract.java",0,0.670103092783505,0,3,3
"java/engine/org/apache/derby/impl/load/Import.java",0,0.435294117647059,3,4,7
"java/engine/org/apache/derby/impl/load/ImportAbstract.java",0,0.508928571428571,2,3,5
"java/engine/org/apache/derby/impl/load/ImportBlob.java",0,1,0,1,1
"java/engine/org/apache/derby/impl/load/ImportClob.java",0,1,0,1,1
"java/engine/org/apache/derby/impl/load/ImportLobFile.java",0,0.925465838509317,0,2,2
"java/engine/org/apache/derby/impl/load/ImportReadData.java",0,0.846728971962617,3,2,5
"java/engine/org/apache/derby/impl/load/ImportResultSetMetaData.java",0,0.520661157024793,2,2,4
"java/engine/org/apache/derby/impl/load/LoadError.java",0,0.876651982378855,2,2,4
"java/engine/org/apache/derby/impl/services/bytecode/BCClass.java",0,0.980645161290323,2,1,3
"java/engine/org/apache/derby/impl/services/bytecode/BCExpr.java",0,0.869565217391304,0,2,2
"java/engine/org/apache/derby/impl/services/bytecode/BCJava.java",0,0.968944099378882,4,1,5
"java/engine/org/apache/derby/impl/services/bytecode/BCLocalField.java",0,0.837837837837838,0,2,2
"java/engine/org/apache/derby/impl/services/bytecode/BCMethod.java",0,0.99568655643422,1,1,2
"java/engine/org/apache/derby/impl/services/bytecode/BCMethodCaller.java",0,0.828571428571429,0,2,2
"java/engine/org/apache/derby/impl/services/bytecode/BCMethodDescriptor.java",0,0.950413223140496,1,1,2
"java/engine/org/apache/derby/impl/services/bytecode/CodeChunk.java",0,0.99685393258427,2,1,3
"java/engine/org/apache/derby/impl/services/bytecode/Conditional.java",0,0.977611940298508,2,1,3
"java/engine/org/apache/derby/impl/services/bytecode/GClass.java",0,0.942857142857143,2,1,3
"java/engine/org/apache/derby/impl/services/bytecode/OpcodeDebug.java",0,0.97609561752988,1,1,2
"java/engine/org/apache/derby/impl/services/bytecode/Type.java",0,0.930232558139535,0,2,2
"java/engine/org/apache/derby/impl/services/bytecode/VMTypeIdCacheable.java",0,0.942857142857143,0,2,2
"java/engine/org/apache/derby/impl/services/bytecode/d_BCValidate.java",0,0.969827586206897,2,1,3
"java/engine/org/apache/derby/impl/services/cache/BackgroundCleaner.java",0,1,0,1,1
"java/engine/org/apache/derby/impl/services/cache/CacheEntry.java",0,1,0,1,1
"java/engine/org/apache/derby/impl/services/cache/CacheStat.java",0,0.925925925925926,0,2,2
"java/engine/org/apache/derby/impl/services/cache/CachedItem.java",0,0.912121212121212,1,2,3
"java/engine/org/apache/derby/impl/services/cache/Clock.java",0,0.919766206163656,5,2,7
"java/engine/org/apache/derby/impl/services/cache/ClockFactory.java",0,0.918918918918919,0,2,2
"java/engine/org/apache/derby/impl/services/cache/ClockPolicy.java",0,1,0,1,1
"java/engine/org/apache/derby/impl/services/cache/ConcurrentCache.java",0,1,0,1,1
"java/engine/org/apache/derby/impl/services/cache/ConcurrentCacheFactory.java",0,1,0,1,1
"java/engine/org/apache/derby/impl/services/cache/ReplacementPolicy.java",0,1,0,1,1
"java/engine/org/apache/derby/impl/services/daemon/BasicDaemon.java",0,0.978378378378378,2,1,3
"java/engine/org/apache/derby/impl/services/daemon/ServiceRecord.java",0,0.91044776119403,0,2,2
"java/engine/org/apache/derby/impl/services/daemon/SingleThreadDaemonFactory.java",0,0.613333333333333,0,3,3
"java/engine/org/apache/derby/impl/services/jce/JCECipherFactory.java",0,0.861328125,4,2,6
"java/engine/org/apache/derby/impl/services/jce/JCECipherFactoryBuilder.java",0,0.903225806451613,0,2,2
"java/engine/org/apache/derby/impl/services/jce/JCECipherProvider.java",0,0.973404255319149,3,1,4
"java/engine/org/apache/derby/impl/services/jmx/JMXManagementService.java",0,0.887473460721868,1,2,3
"java/engine/org/apache/derby/impl/services/jmxnone/NoManagementService.java",0,1,0,1,1
"java/engine/org/apache/derby/impl/services/locks/AbstractPool.java",0,1,0,1,1
"java/engine/org/apache/derby/impl/services/locks/ActiveLock.java",0,0.930555555555556,2,1,3
"java/engine/org/apache/derby/impl/services/locks/ConcurrentLockSet.java",0,1,0,1,1
"java/engine/org/apache/derby/impl/services/locks/ConcurrentPool.java",0,1,0,1,1
"java/engine/org/apache/derby/impl/services/locks/Constants.java",0,0.877551020408163,0,2,2
"java/engine/org/apache/derby/impl/services/locks/Control.java",0,0.787878787878788,0,3,3
"java/engine/org/apache/derby/impl/services/locks/D_ActiveLock.java",0,0.851063829787234,1,2,3
"java/engine/org/apache/derby/impl/services/locks/D_Lock.java",0,0.921052631578947,0,2,2
"java/engine/org/apache/derby/impl/services/locks/D_LockControl.java",0,0.8875,1,2,3
"java/engine/org/apache/derby/impl/services/locks/Deadlock.java",0,0.848258706467662,1,3,4
"java/engine/org/apache/derby/impl/services/locks/Lock.java",0,0.893617021276596,1,2,3
"java/engine/org/apache/derby/impl/services/locks/LockControl.java",0,0.939169139465875,1,2,3
"java/engine/org/apache/derby/impl/services/locks/LockSet.java",0,0.538163001293661,2,3,5
"java/engine/org/apache/derby/impl/services/locks/LockSpace.java",0,0.798469387755102,1,2,3
"java/engine/org/apache/derby/impl/services/locks/LockTable.java",0,1,0,1,1
"java/engine/org/apache/derby/impl/services/locks/LockTableVTI.java",0,0.905797101449275,1,2,3
"java/engine/org/apache/derby/impl/services/locks/SinglePool.java",0,0.651162790697674,0,3,3
"java/engine/org/apache/derby/impl/services/locks/TableNameInfo.java",0,0.965714285714286,1,1,2
"java/engine/org/apache/derby/impl/services/locks/Timeout.java",0,0.979638009049774,2,1,3
"java/engine/org/apache/derby/impl/services/monitor/BaseMonitor.java",0,0.980674157303371,7,1,8
"java/engine/org/apache/derby/impl/services/monitor/FileMonitor.java",0,0.963087248322148,2,1,3
"java/engine/org/apache/derby/impl/services/monitor/ModuleInstance.java",0,0.947368421052632,0,2,2
"java/engine/org/apache/derby/impl/services/monitor/ProtocolKey.java",0,0.951612903225806,1,1,2
"java/engine/org/apache/derby/impl/services/monitor/ServiceBootContext.java",0,0.875,0,2,2
"java/engine/org/apache/derby/impl/services/monitor/StorageFactoryService.java",0,0.878625134264232,4,2,6
"java/engine/org/apache/derby/impl/services/monitor/TopService.java",0,0.982843137254902,2,1,3
"java/engine/org/apache/derby/impl/services/monitor/UpdateServiceProperties.java",0,0.95,2,1,3
"java/engine/org/apache/derby/impl/services/reflect/DatabaseClasses.java",0,0.981818181818182,1,1,2
"java/engine/org/apache/derby/impl/services/reflect/GCInstanceFactory.java",0,0.8125,0,2,2
"java/engine/org/apache/derby/impl/services/reflect/JarLoader.java",0,0.988909426987061,1,1,2
"java/engine/org/apache/derby/impl/services/reflect/LoadedGeneratedClass.java",0,0.938144329896907,0,2,2
"java/engine/org/apache/derby/impl/services/reflect/ReflectClassesJava2.java",0,0.928571428571429,1,2,3
"java/engine/org/apache/derby/impl/services/reflect/ReflectGeneratedClass.java",0,0.964071856287425,1,1,2
"java/engine/org/apache/derby/impl/services/reflect/ReflectLoaderJava2.java",0,0.928571428571429,0,2,2
"java/engine/org/apache/derby/impl/services/reflect/ReflectMethod.java",0,0.91044776119403,0,2,2
"java/engine/org/apache/derby/impl/services/reflect/UpdateLoader.java",0,0.931350114416476,1,2,3
"java/engine/org/apache/derby/impl/services/stream/BasicGetLogHeader.java",0,0.934065934065934,0,2,2
"java/engine/org/apache/derby/impl/services/stream/BasicHeaderPrintWriter.java",0,0.71900826446281,1,2,3
"java/engine/org/apache/derby/impl/services/stream/SingleStream.java",0,0.934782608695652,2,1,3
"java/engine/org/apache/derby/impl/services/timer/SingletonTimerFactory.java",0,0.635220125786163,1,2,3
"java/engine/org/apache/derby/impl/services/uuid/BasicUUID.java",0,0.981538461538462,1,1,2
"java/engine/org/apache/derby/impl/services/uuid/BasicUUIDFactory.java",0,0.963855421686747,1,1,2
"java/engine/org/apache/derby/impl/services/uuid/BasicUUIDGetter.java",0,0.833333333333333,0,2,2
"java/engine/org/apache/derby/impl/sql/CursorInfo.java",0,0.968253968253968,1,1,2
"java/engine/org/apache/derby/impl/sql/CursorTableReference.java",0,0.964705882352941,1,1,2
"java/engine/org/apache/derby/impl/sql/GenericActivationHolder.java",0,0.768028846153846,3,2,5
"java/engine/org/apache/derby/impl/sql/GenericClassInfo.java",0,0.853658536585366,0,2,2
"java/engine/org/apache/derby/impl/sql/GenericColumnDescriptor.java",0,0.959839357429719,2,1,3
"java/engine/org/apache/derby/impl/sql/GenericLanguageFactory.java",0,0.951612903225806,1,1,2
"java/engine/org/apache/derby/impl/sql/GenericParameter.java",0,0.976539589442815,2,1,3
"java/engine/org/apache/derby/impl/sql/GenericParameterValueSet.java",0,0.983673469387755,3,1,4
"java/engine/org/apache/derby/impl/sql/GenericPreparedStatement.java",0,0.874690849134378,6,2,8
"java/engine/org/apache/derby/impl/sql/GenericResultDescription.java",0,0.97887323943662,1,1,2
"java/engine/org/apache/derby/impl/sql/GenericStatement.java",0,0.884126984126984,5,2,7
"java/engine/org/apache/derby/impl/sql/GenericStorablePreparedStatement.java",0,0.97864768683274,1,1,2
"java/engine/org/apache/derby/impl/sql/LanguageDbPropertySetter.java",0,0.795918367346939,0,3,3
"java/engine/org/apache/derby/impl/sql/catalog/CoreDDFinderClassInfo.java",0,0.890625,1,2,3
"java/engine/org/apache/derby/impl/sql/catalog/DDColumnDependableFinder.java",0,0.943396226415094,0,2,2
"java/engine/org/apache/derby/impl/sql/catalog/DD_Version.java",0,0.780124223602484,9,2,11
"java/engine/org/apache/derby/impl/sql/catalog/DDdependableFinder.java",0,0.952380952380952,2,1,3
"java/engine/org/apache/derby/impl/sql/catalog/DataDictionaryImpl.java",0,0.745413582233666,13,2,15
"java/engine/org/apache/derby/impl/sql/catalog/DropDependencyFilter.java",0,0.966824644549763,1,1,2
"java/engine/org/apache/derby/impl/sql/catalog/IndexInfoImpl.java",0,0.957446808510638,1,1,2
"java/engine/org/apache/derby/impl/sql/catalog/NameTDCacheable.java",0,0.961538461538462,1,1,2
"java/engine/org/apache/derby/impl/sql/catalog/OIDTDCacheable.java",0,0.96,1,1,2
"java/engine/org/apache/derby/impl/sql/catalog/PermissionsCacheable.java",0,0.967741935483871,1,1,2
"java/engine/org/apache/derby/impl/sql/catalog/PermissionsCatalogRowFactory.java",0,0.737704918032787,1,2,3
"java/engine/org/apache/derby/impl/sql/catalog/RoleClosureIteratorImpl.java",0,1,0,1,1
"java/engine/org/apache/derby/impl/sql/catalog/SPSNameCacheable.java",0,0.978723404255319,1,1,2
"java/engine/org/apache/derby/impl/sql/catalog/SYSALIASESRowFactory.java",0,0.976377952755906,2,1,3
"java/engine/org/apache/derby/impl/sql/catalog/SYSCHECKSRowFactory.java",0,0.973333333333333,1,1,2
"java/engine/org/apache/derby/impl/sql/catalog/SYSCOLPERMSRowFactory.java",0,0.752321981424149,3,2,5
"java/engine/org/apache/derby/impl/sql/catalog/SYSCOLUMNSRowFactory.java",0,0.907127429805616,3,1,4
"java/engine/org/apache/derby/impl/sql/catalog/SYSCONGLOMERATESRowFactory.java",0,0.986455981941309,1,1,2
"java/engine/org/apache/derby/impl/sql/catalog/SYSCONSTRAINTSRowFactory.java",0,0.991228070175439,1,1,2
"java/engine/org/apache/derby/impl/sql/catalog/SYSDEPENDSRowFactory.java",0,0.975409836065574,1,1,2
"java/engine/org/apache/derby/impl/sql/catalog/SYSDUMMY1RowFactory.java",0,0.949152542372881,0,2,2
"java/engine/org/apache/derby/impl/sql/catalog/SYSFILESRowFactory.java",0,0.976653696498054,1,1,2
"java/engine/org/apache/derby/impl/sql/catalog/SYSFOREIGNKEYSRowFactory.java",0,0.981538461538462,1,1,2
"java/engine/org/apache/derby/impl/sql/catalog/SYSKEYSRowFactory.java",0,0.971153846153846,1,1,2
"java/engine/org/apache/derby/impl/sql/catalog/SYSROLESRowFactory.java",0,1,0,1,1
"java/engine/org/apache/derby/impl/sql/catalog/SYSROUTINEPERMSRowFactory.java",0,0.726923076923077,2,2,4
"java/engine/org/apache/derby/impl/sql/catalog/SYSSCHEMASRowFactory.java",0,0.974025974025974,1,1,2
"java/engine/org/apache/derby/impl/sql/catalog/SYSSTATEMENTSRowFactory.java",0,0.975929978118162,2,1,3
"java/engine/org/apache/derby/impl/sql/catalog/SYSSTATISTICSRowFactory.java",0,0.976284584980237,1,1,2
"java/engine/org/apache/derby/impl/sql/catalog/SYSTABLEPERMSRowFactory.java",0,0.765027322404372,2,2,4
"java/engine/org/apache/derby/impl/sql/catalog/SYSTABLESRowFactory.java",0,0.868965517241379,2,2,4
"java/engine/org/apache/derby/impl/sql/catalog/SYSTRIGGERSRowFactory.java",0,0.987473903966597,1,1,2
"java/engine/org/apache/derby/impl/sql/catalog/SYSVIEWSRowFactory.java",0,0.978102189781022,1,1,2
"java/engine/org/apache/derby/impl/sql/catalog/SystemColumnImpl.java",0,0.963636363636364,1,1,2
"java/engine/org/apache/derby/impl/sql/catalog/TDCacheable.java",0,0.957142857142857,1,1,2
"java/engine/org/apache/derby/impl/sql/catalog/TabInfoImpl.java",0,0.942324003392706,4,1,5
"java/engine/org/apache/derby/impl/sql/catalog/TableKey.java",0,0.927083333333333,0,2,2
"java/engine/org/apache/derby/impl/sql/compile/AccessPathImpl.java",0,0.971014492753623,1,1,2
"java/engine/org/apache/derby/impl/sql/compile/ActivationClassBuilder.java",0,0.986516853932584,1,1,2
"java/engine/org/apache/derby/impl/sql/compile/AggregateDefinition.java",0,0.918604651162791,1,2,3
"java/engine/org/apache/derby/impl/sql/compile/AggregateNode.java",0,0.937402190923318,3,1,4
"java/engine/org/apache/derby/impl/sql/compile/AllResultColumn.java",0,0.935483870967742,0,2,2
"java/engine/org/apache/derby/impl/sql/compile/AlterTableNode.java",0,0.653631284916201,2,3,5
"java/engine/org/apache/derby/impl/sql/compile/AndNode.java",0,0.983240223463687,1,1,2
"java/engine/org/apache/derby/impl/sql/compile/BaseColumnNode.java",0,0.946524064171123,3,1,4
"java/engine/org/apache/derby/impl/sql/compile/BaseJoinStrategy.java",0,0.931818181818182,2,1,3
"java/engine/org/apache/derby/impl/sql/compile/BaseTableNumbersVisitor.java",0,0.823008849557522,1,2,3
"java/engine/org/apache/derby/impl/sql/compile/BaseTypeCompiler.java",0,0.984375,1,1,2
"java/engine/org/apache/derby/impl/sql/compile/BetweenOperatorNode.java",0,0.981366459627329,1,1,2
"java/engine/org/apache/derby/impl/sql/compile/BinaryArithmeticOperatorNode.java",0,0.972222222222222,1,1,2
"java/engine/org/apache/derby/impl/sql/compile/BinaryComparisonOperatorNode.java",0,0.959905660377358,3,1,4
"java/engine/org/apache/derby/impl/sql/compile/BinaryListOperatorNode.java",0,0.981776765375854,2,1,3
"java/engine/org/apache/derby/impl/sql/compile/BinaryLogicalOperatorNode.java",0,0.97489539748954,1,1,2
"java/engine/org/apache/derby/impl/sql/compile/BinaryOperatorNode.java",0,0.707974137931034,2,3,5
"java/engine/org/apache/derby/impl/sql/compile/BinaryRelationalOperatorNode.java",0,0.616849394114253,2,4,6
"java/engine/org/apache/derby/impl/sql/compile/BitConstantNode.java",0,0.945736434108527,0,2,2
"java/engine/org/apache/derby/impl/sql/compile/BitTypeCompiler.java",0,0.966292134831461,1,1,2
"java/engine/org/apache/derby/impl/sql/compile/BooleanConstantNode.java",0,0.970338983050847,1,1,2
"java/engine/org/apache/derby/impl/sql/compile/BooleanTypeCompiler.java",0,0.955555555555556,1,1,2
"java/engine/org/apache/derby/impl/sql/compile/CLOBTypeCompiler.java",0,0.945205479452055,2,1,3
"java/engine/org/apache/derby/impl/sql/compile/C_NodeNames.java",0,0.836538461538462,4,3,7
"java/engine/org/apache/derby/impl/sql/compile/CallStatementNode.java",0,0.944615384615385,2,1,3
"java/engine/org/apache/derby/impl/sql/compile/CastNode.java",0,0.94716618635927,4,1,5
"java/engine/org/apache/derby/impl/sql/compile/CharConstantNode.java",0,0.836842105263158,1,2,3
"java/engine/org/apache/derby/impl/sql/compile/CharStream.java",0,0.960264900662252,1,1,2
"java/engine/org/apache/derby/impl/sql/compile/CharTypeCompiler.java",0,0.942708333333333,3,1,4
"java/engine/org/apache/derby/impl/sql/compile/CoalesceFunctionNode.java",0,0.807424593967517,5,2,7
"java/engine/org/apache/derby/impl/sql/compile/CollectNodesVisitor.java",0,0.951612903225806,1,1,2
"java/engine/org/apache/derby/impl/sql/compile/ColumnDefinitionNode.java",0,0.823529411764706,6,2,8
"java/engine/org/apache/derby/impl/sql/compile/ColumnOrdering.java",0,0.970588235294118,1,1,2
"java/engine/org/apache/derby/impl/sql/compile/ColumnReference.java",0,0.770144189991518,3,2,5
"java/engine/org/apache/derby/impl/sql/compile/CompilerContextImpl.java",0,0.696008188331627,2,3,5
"java/engine/org/apache/derby/impl/sql/compile/ConcatenationOperatorNode.java",0,0.620071684587814,2,2,4
"java/engine/org/apache/derby/impl/sql/compile/ConditionalNode.java",0,0.616966580976864,6,2,8
"java/engine/org/apache/derby/impl/sql/compile/ConstantNode.java",0,0.924137931034483,3,1,4
"java/engine/org/apache/derby/impl/sql/compile/ConstraintDefinitionNode.java",0,0.988636363636364,1,1,2
"java/engine/org/apache/derby/impl/sql/compile/CostEstimateImpl.java",0,0.838414634146341,1,2,3
"java/engine/org/apache/derby/impl/sql/compile/CountAggregateDefinition.java",0,0.895522388059702,0,2,2
"java/engine/org/apache/derby/impl/sql/compile/CreateAliasNode.java",0,0.639664804469274,2,4,6
"java/engine/org/apache/derby/impl/sql/compile/CreateIndexNode.java",0,0.936046511627907,3,1,4
"java/engine/org/apache/derby/impl/sql/compile/CreateRoleNode.java",0,1,0,1,1
"java/engine/org/apache/derby/impl/sql/compile/CreateSchemaNode.java",0,0.868421052631579,0,3,3
"java/engine/org/apache/derby/impl/sql/compile/CreateTableNode.java",0,0.635701275045537,4,3,7
"java/engine/org/apache/derby/impl/sql/compile/CreateTriggerNode.java",0,0.81587651598677,4,3,7
"java/engine/org/apache/derby/impl/sql/compile/CreateViewNode.java",0,0.954326923076923,5,1,6
"java/engine/org/apache/derby/impl/sql/compile/CurrentDatetimeOperatorNode.java",0,0.953125,3,1,4
"java/engine/org/apache/derby/impl/sql/compile/CurrentOfNode.java",0,0.961474036850921,2,1,3
"java/engine/org/apache/derby/impl/sql/compile/CurrentRowLocationNode.java",0,0.953216374269006,2,1,3
"java/engine/org/apache/derby/impl/sql/compile/CursorNode.java",0,0.858866103739445,2,3,5
"java/engine/org/apache/derby/impl/sql/compile/DB2LengthOperatorNode.java",0,0.923469387755102,2,1,3
"java/engine/org/apache/derby/impl/sql/compile/DDLStatementNode.java",0,0.616766467065868,1,4,5
"java/engine/org/apache/derby/impl/sql/compile/DMLModStatementNode.java",0,0.74,4,2,6
"java/engine/org/apache/derby/impl/sql/compile/DMLStatementNode.java",0,0.825,1,3,4
"java/engine/org/apache/derby/impl/sql/compile/DateTypeCompiler.java",0,0.954887218045113,1,1,2
"java/engine/org/apache/derby/impl/sql/compile/DefaultNode.java",0,0.979094076655052,1,1,2
"java/engine/org/apache/derby/impl/sql/compile/DefaultVTIModDeferPolicy.java",0,0.935483870967742,0,2,2
"java/engine/org/apache/derby/impl/sql/compile/DeleteNode.java",0,0.773226773226773,3,2,5
"java/engine/org/apache/derby/impl/sql/compile/DistinctNode.java",0,0.973760932944606,2,1,3
"java/engine/org/apache/derby/impl/sql/compile/DropAliasNode.java",0,0.907407407407407,3,1,4
"java/engine/org/apache/derby/impl/sql/compile/DropIndexNode.java",0,0.948717948717949,0,2,2
"java/engine/org/apache/derby/impl/sql/compile/DropRoleNode.java",0,1,0,1,1
"java/engine/org/apache/derby/impl/sql/compile/DropSchemaNode.java",0,0.848,1,2,3
"java/engine/org/apache/derby/impl/sql/compile/DropTableNode.java",0,0.888111888111888,1,2,3
"java/engine/org/apache/derby/impl/sql/compile/DropTriggerNode.java",0,0.935483870967742,0,2,2
"java/engine/org/apache/derby/impl/sql/compile/DropViewNode.java",0,0.678899082568807,0,3,3
"java/engine/org/apache/derby/impl/sql/compile/ExecSPSNode.java",0,0.981424148606811,1,1,2
"java/engine/org/apache/derby/impl/sql/compile/ExpressionClassBuilder.java",0,0.988197424892704,2,1,3
"java/engine/org/apache/derby/impl/sql/compile/ExtractOperatorNode.java",0,0.967741935483871,1,1,2
"java/engine/org/apache/derby/impl/sql/compile/FKConstraintDefinitionNode.java",0,0.662650602409639,2,2,4
"java/engine/org/apache/derby/impl/sql/compile/FromBaseTable.java",0,0.929205455726348,7,1,8
"java/engine/org/apache/derby/impl/sql/compile/FromList.java",0,0.850782190132371,2,3,5
"java/engine/org/apache/derby/impl/sql/compile/FromSubquery.java",0,0.923076923076923,3,2,5
"java/engine/org/apache/derby/impl/sql/compile/FromTable.java",0,0.870882740447958,2,3,5
"java/engine/org/apache/derby/impl/sql/compile/FromVTI.java",0,0.843621399176955,4,2,6
"java/engine/org/apache/derby/impl/sql/compile/GenerationClauseNode.java",0,1,0,1,1
"java/engine/org/apache/derby/impl/sql/compile/GetCurrentConnectionNode.java",0,0.972477064220184,1,1,2
"java/engine/org/apache/derby/impl/sql/compile/GrantNode.java",0,0.9,2,2,4
"java/engine/org/apache/derby/impl/sql/compile/GrantRoleNode.java",0,1,0,1,1
"java/engine/org/apache/derby/impl/sql/compile/GroupByColumn.java",0,0.961783439490446,1,1,2
"java/engine/org/apache/derby/impl/sql/compile/GroupByList.java",0,0.920118343195266,5,1,6
"java/engine/org/apache/derby/impl/sql/compile/GroupByNode.java",0,0.78975131876413,3,3,6
"java/engine/org/apache/derby/impl/sql/compile/HalfOuterJoinNode.java",0,0.988636363636364,2,1,3
"java/engine/org/apache/derby/impl/sql/compile/HasCorrelatedCRsVisitor.java",0,0.947761194029851,0,2,2
"java/engine/org/apache/derby/impl/sql/compile/HasNodeVisitor.java",0,0.956521739130435,1,1,2
"java/engine/org/apache/derby/impl/sql/compile/HasVariantValueNodeVisitor.java",0,0.949685534591195,2,1,3
"java/engine/org/apache/derby/impl/sql/compile/HashJoinStrategy.java",0,0.832592592592593,2,3,5
"java/engine/org/apache/derby/impl/sql/compile/HashTableNode.java",0,0.977324263038549,2,1,3
"java/engine/org/apache/derby/impl/sql/compile/InListOperatorNode.java",0,0.596649484536082,1,2,3
"java/engine/org/apache/derby/impl/sql/compile/IndexToBaseRowNode.java",0,0.813636363636364,2,3,5
"java/engine/org/apache/derby/impl/sql/compile/InsertNode.java",0,0.829831932773109,7,2,9
"java/engine/org/apache/derby/impl/sql/compile/IntersectOrExceptNode.java",0,0.877232142857143,3,2,5
"java/engine/org/apache/derby/impl/sql/compile/IsNode.java",0,0.973568281938326,1,1,2
"java/engine/org/apache/derby/impl/sql/compile/IsNullNode.java",0,0.96969696969697,3,1,4
"java/engine/org/apache/derby/impl/sql/compile/JavaToSQLValueNode.java",0,0.969945355191257,3,1,4
"java/engine/org/apache/derby/impl/sql/compile/JavaValueNode.java",0,0.927813163481953,2,2,4
"java/engine/org/apache/derby/impl/sql/compile/JoinNode.java",0,0.967906265919511,2,1,3
"java/engine/org/apache/derby/impl/sql/compile/LOBTypeCompiler.java",0,0.956834532374101,1,1,2
"java/engine/org/apache/derby/impl/sql/compile/LengthOperatorNode.java",0,0.932098765432099,3,1,4
"java/engine/org/apache/derby/impl/sql/compile/Level2CostEstimateImpl.java",0,0.915492957746479,0,2,2
"java/engine/org/apache/derby/impl/sql/compile/Level2OptimizerFactoryImpl.java",0,0.952,1,1,2
"java/engine/org/apache/derby/impl/sql/compile/Level2OptimizerImpl.java",0,0.988255033557047,2,1,3
"java/engine/org/apache/derby/impl/sql/compile/LikeEscapeOperatorNode.java",0,0.85101822079314,3,2,5
"java/engine/org/apache/derby/impl/sql/compile/LockTableNode.java",0,0.865168539325843,2,2,4
"java/engine/org/apache/derby/impl/sql/compile/MaterializeResultSetNode.java",0,0.944,2,1,3
"java/engine/org/apache/derby/impl/sql/compile/MaterializeSubqueryNode.java",0,0.898305084745763,0,2,2
"java/engine/org/apache/derby/impl/sql/compile/MaxMinAggregateDefinition.java",0,0.936936936936937,0,2,2
"java/engine/org/apache/derby/impl/sql/compile/MethodCallNode.java",0,0.911880409126672,4,2,6
"java/engine/org/apache/derby/impl/sql/compile/MiscellaneousStatementNode.java",0,0.934782608695652,0,2,2
"java/engine/org/apache/derby/impl/sql/compile/ModifyColumnNode.java",0,0.730952380952381,5,3,8
"java/engine/org/apache/derby/impl/sql/compile/NOPStatementNode.java",0,0.907692307692308,0,2,2
"java/engine/org/apache/derby/impl/sql/compile/NestedLoopJoinStrategy.java",0,0.841791044776119,2,2,4
"java/engine/org/apache/derby/impl/sql/compile/NewInvocationNode.java",0,0.720647773279352,4,2,6
"java/engine/org/apache/derby/impl/sql/compile/NodeFactoryImpl.java",0,0.862337662337662,5,2,7
"java/engine/org/apache/derby/impl/sql/compile/NonStaticMethodCallNode.java",0,0.983772819472617,2,1,3
"java/engine/org/apache/derby/impl/sql/compile/NormalizeResultSetNode.java",0,0.791304347826087,1,2,3
"java/engine/org/apache/derby/impl/sql/compile/NotNode.java",0,0.937984496124031,2,1,3
"java/engine/org/apache/derby/impl/sql/compile/NumericConstantNode.java",0,0.973180076628352,1,1,2
"java/engine/org/apache/derby/impl/sql/compile/NumericTypeCompiler.java",0,0.983576642335766,2,1,3
"java/engine/org/apache/derby/impl/sql/compile/OptimizerFactoryImpl.java",0,0.973214285714286,1,1,2
"java/engine/org/apache/derby/impl/sql/compile/OptimizerImpl.java",0,0.582292038557658,3,3,6
"java/engine/org/apache/derby/impl/sql/compile/OrNode.java",0,0.87037037037037,1,2,3
"java/engine/org/apache/derby/impl/sql/compile/OrderByColumn.java",0,0.424628450106157,1,4,5
"java/engine/org/apache/derby/impl/sql/compile/OrderByList.java",0,0.76056338028169,3,2,5
"java/engine/org/apache/derby/impl/sql/compile/OrderByNode.java",0,0.954198473282443,1,1,2
"java/engine/org/apache/derby/impl/sql/compile/OrderedColumn.java",0,0.818181818181818,0,3,3
"java/engine/org/apache/derby/impl/sql/compile/OrderedColumnList.java",0,0.91304347826087,1,2,3
"java/engine/org/apache/derby/impl/sql/compile/ParameterNode.java",0,0.841603053435115,2,3,5
"java/engine/org/apache/derby/impl/sql/compile/ParseException.java",0,0.972222222222222,1,1,2
"java/engine/org/apache/derby/impl/sql/compile/ParserImpl.java",0,0.911111111111111,1,2,3
"java/engine/org/apache/derby/impl/sql/compile/Predicate.java",0,0.545389563974267,1,4,5
"java/engine/org/apache/derby/impl/sql/compile/PredicateList.java",0,0.882562277580071,4,2,6
"java/engine/org/apache/derby/impl/sql/compile/PrivilegeNode.java",0,0.949790794979079,2,1,3
"java/engine/org/apache/derby/impl/sql/compile/ProjectRestrictNode.java",0,0.851891315929675,3,2,5
"java/engine/org/apache/derby/impl/sql/compile/QueryTreeNode.java",0,0.893105629348514,3,2,5
"java/engine/org/apache/derby/impl/sql/compile/QueryTreeNodeVector.java",0,0.96319018404908,1,1,2
"java/engine/org/apache/derby/impl/sql/compile/RefTypeCompiler.java",0,0.938775510204082,0,2,2
"java/engine/org/apache/derby/impl/sql/compile/ReferencedTablesVisitor.java",0,0.94392523364486,0,2,2
"java/engine/org/apache/derby/impl/sql/compile/RelationalOperator.java",0,0.844919786096257,1,2,3
"java/engine/org/apache/derby/impl/sql/compile/RemapCRsVisitor.java",0,0.94392523364486,0,2,2
"java/engine/org/apache/derby/impl/sql/compile/RenameNode.java",0,0.940659340659341,2,1,3
"java/engine/org/apache/derby/impl/sql/compile/ReplaceAggregatesWithCRVisitor.java",0,0.902439024390244,2,1,3
"java/engine/org/apache/derby/impl/sql/compile/ResultColumn.java",0,0.83013698630137,8,1,9
"java/engine/org/apache/derby/impl/sql/compile/ResultColumnList.java",0,0.848963242224317,8,1,9
"java/engine/org/apache/derby/impl/sql/compile/ResultSetNode.java",0,0.90894819466248,7,1,8
"java/engine/org/apache/derby/impl/sql/compile/RevokeNode.java",0,0.9,2,2,4
"java/engine/org/apache/derby/impl/sql/compile/RevokeRoleNode.java",0,1,0,1,1
"java/engine/org/apache/derby/impl/sql/compile/RoutineDesignator.java",0,0.887323943661972,1,2,3
"java/engine/org/apache/derby/impl/sql/compile/RowCountNode.java",0,1,0,1,1
"java/engine/org/apache/derby/impl/sql/compile/RowNumberColumnNode.java",0,1,0,1,1
"java/engine/org/apache/derby/impl/sql/compile/RowOrderingImpl.java",0,0.986754966887417,1,1,2
"java/engine/org/apache/derby/impl/sql/compile/RowResultSetNode.java",0,0.982961992136304,3,1,4
"java/engine/org/apache/derby/impl/sql/compile/SQLBooleanConstantNode.java",0,0.943396226415094,0,2,2
"java/engine/org/apache/derby/impl/sql/compile/SQLToJavaValueNode.java",0,0.965583173996176,3,1,4
"java/engine/org/apache/derby/impl/sql/compile/SavepointNode.java",0,0.952380952380952,1,1,2
"java/engine/org/apache/derby/impl/sql/compile/ScrollInsensitiveResultSetNode.java",0,0.951612903225806,1,1,2
"java/engine/org/apache/derby/impl/sql/compile/SelectNode.java",0,0.762559038213826,6,3,9
"java/engine/org/apache/derby/impl/sql/compile/SetOperatorNode.java",0,0.464253393665158,6,3,9
"java/engine/org/apache/derby/impl/sql/compile/SetRoleNode.java",0,1,0,1,1
"java/engine/org/apache/derby/impl/sql/compile/SetSchemaNode.java",0,0.966101694915254,1,1,2
"java/engine/org/apache/derby/impl/sql/compile/SetTransactionIsolationNode.java",0,0.947368421052632,0,2,2
"java/engine/org/apache/derby/impl/sql/compile/SimpleStringOperatorNode.java",0,0.899408284023669,4,1,5
"java/engine/org/apache/derby/impl/sql/compile/SingleChildResultSetNode.java",0,0.932389937106918,3,1,4
"java/engine/org/apache/derby/impl/sql/compile/SpecialFunctionNode.java",0,0.772563176895307,1,4,5
"java/engine/org/apache/derby/impl/sql/compile/StatementNode.java",0,0.982800982800983,1,1,2
"java/engine/org/apache/derby/impl/sql/compile/StaticClassFieldReferenceNode.java",0,0.97119341563786,2,1,3
"java/engine/org/apache/derby/impl/sql/compile/StaticMethodCallNode.java",0,0.907053941908714,6,1,7
"java/engine/org/apache/derby/impl/sql/compile/SubqueryList.java",0,0.857664233576642,1,3,4
"java/engine/org/apache/derby/impl/sql/compile/SubqueryNode.java",0,0.930309278350515,6,1,7
"java/engine/org/apache/derby/impl/sql/compile/SubstituteExpressionVisitor.java",0,0.903614457831325,0,2,2
"java/engine/org/apache/derby/impl/sql/compile/SumAvgAggregateDefinition.java",0,0.945205479452055,2,1,3
"java/engine/org/apache/derby/impl/sql/compile/TableElementList.java",0,0.553787396562699,6,3,9
"java/engine/org/apache/derby/impl/sql/compile/TableElementNode.java",0,0.968085106382979,1,1,2
"java/engine/org/apache/derby/impl/sql/compile/TableName.java",0,0.930147058823529,2,1,3
"java/engine/org/apache/derby/impl/sql/compile/TableOperatorNode.java",0,0.859026369168357,1,3,4
"java/engine/org/apache/derby/impl/sql/compile/TablePrivilegesNode.java",0,0.551515151515152,1,2,3
"java/engine/org/apache/derby/impl/sql/compile/TernaryOperatorNode.java",0,0.795568982880161,4,3,7
"java/engine/org/apache/derby/impl/sql/compile/TestConstraintNode.java",0,0.952054794520548,1,1,2
"java/engine/org/apache/derby/impl/sql/compile/TimeTypeCompiler.java",0,0.956834532374101,1,1,2
"java/engine/org/apache/derby/impl/sql/compile/TimestampOperatorNode.java",0,0.856060606060606,2,2,4
"java/engine/org/apache/derby/impl/sql/compile/TimestampTypeCompiler.java",0,0.95625,2,1,3
"java/engine/org/apache/derby/impl/sql/compile/Token.java",0,0.944954128440367,0,2,2
"java/engine/org/apache/derby/impl/sql/compile/TransactionStatementNode.java",0,0.90625,0,2,2
"java/engine/org/apache/derby/impl/sql/compile/TriggerReferencingStruct.java",0,0.882352941176471,0,2,2
"java/engine/org/apache/derby/impl/sql/compile/TypeCompilerFactoryImpl.java",0,0.895833333333333,2,2,4
"java/engine/org/apache/derby/impl/sql/compile/UCode_CharStream.java",0,0.987394957983193,1,1,2
"java/engine/org/apache/derby/impl/sql/compile/UnaryArithmeticOperatorNode.java",0,0.909420289855073,2,2,4
"java/engine/org/apache/derby/impl/sql/compile/UnaryComparisonOperatorNode.java",0,0.854347826086956,4,2,6
"java/engine/org/apache/derby/impl/sql/compile/UnaryDateTimestampOperatorNode.java",0,0.959390862944162,2,1,3
"java/engine/org/apache/derby/impl/sql/compile/UnaryLogicalOperatorNode.java",0,0.95,0,2,2
"java/engine/org/apache/derby/impl/sql/compile/UnaryOperatorNode.java",0,0.576009501187648,2,3,5
"java/engine/org/apache/derby/impl/sql/compile/UnionNode.java",0,0.7847533632287,2,2,4
"java/engine/org/apache/derby/impl/sql/compile/UntypedNullConstantNode.java",0,0.935185185185185,1,2,3
"java/engine/org/apache/derby/impl/sql/compile/UpdateNode.java",0,0.709104938271605,6,2,8
"java/engine/org/apache/derby/impl/sql/compile/UserDefinedTypeCompiler.java",0,0.954545454545455,1,1,2
"java/engine/org/apache/derby/impl/sql/compile/UserTypeConstantNode.java",0,0.942675159235669,1,2,3
"java/engine/org/apache/derby/impl/sql/compile/VTIDeferModPolicy.java",0,0.961352657004831,2,1,3
"java/engine/org/apache/derby/impl/sql/compile/ValueNode.java",0,0.933523945675482,5,1,6
"java/engine/org/apache/derby/impl/sql/compile/ValueNodeList.java",0,0.840659340659341,4,2,6
"java/engine/org/apache/derby/impl/sql/compile/VarbitConstantNode.java",0,0.879310344827586,0,2,2
"java/engine/org/apache/derby/impl/sql/compile/VerifyAggregateExpressionsVisitor.java",0,0.952702702702703,2,1,3
"java/engine/org/apache/derby/impl/sql/compile/VirtualColumnNode.java",0,0.976190476190476,2,1,3
"java/engine/org/apache/derby/impl/sql/compile/WindowFunctionColumnNode.java",0,1,0,1,1
"java/engine/org/apache/derby/impl/sql/compile/WindowNode.java",0,1,0,1,1
"java/engine/org/apache/derby/impl/sql/compile/XMLConstantNode.java",0,0.918604651162791,1,2,3
"java/engine/org/apache/derby/impl/sql/compile/XMLTypeCompiler.java",0,0.900621118012422,1,2,3
"java/engine/org/apache/derby/impl/sql/conn/CachedStatement.java",0,0.944444444444444,0,2,2
"java/engine/org/apache/derby/impl/sql/conn/GenericAuthorizer.java",0,0.726993865030675,2,3,5
"java/engine/org/apache/derby/impl/sql/conn/GenericLanguageConnectionContext.java",0,0.798611111111111,11,2,13
"java/engine/org/apache/derby/impl/sql/conn/GenericLanguageConnectionFactory.java",0,0.958149779735683,4,1,5
"java/engine/org/apache/derby/impl/sql/conn/GenericStatementContext.java",0,0.921219822109276,5,2,7
"java/engine/org/apache/derby/impl/sql/conn/SQLSessionContextImpl.java",0,1,0,1,1
"java/engine/org/apache/derby/impl/sql/conn/TempTableInfo.java",0,0.9765625,1,1,2
"java/engine/org/apache/derby/impl/sql/depend/BasicDependency.java",0,0.927710843373494,0,2,2
"java/engine/org/apache/derby/impl/sql/depend/BasicDependencyManager.java",0,0.950573065902579,6,1,7
"java/engine/org/apache/derby/impl/sql/depend/BasicProviderInfo.java",0,0.969387755102041,1,1,2
"java/engine/org/apache/derby/impl/sql/depend/DepClassInfo.java",0,0.846153846153846,0,2,2
"java/engine/org/apache/derby/impl/sql/execute/AggregateSortObserver.java",0,0.967213114754098,1,1,2
"java/engine/org/apache/derby/impl/sql/execute/AggregatorInfo.java",0,0.977186311787072,1,1,2
"java/engine/org/apache/derby/impl/sql/execute/AggregatorInfoList.java",0,0.953488372093023,1,1,2
"java/engine/org/apache/derby/impl/sql/execute/AlterTableConstantAction.java",0,0.535906897530514,9,3,12
"java/engine/org/apache/derby/impl/sql/execute/AnyResultSet.java",0,0.97609561752988,1,1,2
"java/engine/org/apache/derby/impl/sql/execute/AutoincrementCounter.java",0,0.969827586206897,2,1,3
"java/engine/org/apache/derby/impl/sql/execute/AvgAggregator.java",0,0.976,1,1,2
"java/engine/org/apache/derby/impl/sql/execute/BaseActivation.java",0,0.83987103707684,6,2,8
"java/engine/org/apache/derby/impl/sql/execute/BaseExpressionActivation.java",0,0.954198473282443,1,1,2
"java/engine/org/apache/derby/impl/sql/execute/BasicNoPutResultSetImpl.java",0,0.993123772102161,2,1,3
"java/engine/org/apache/derby/impl/sql/execute/BasicSortObserver.java",0,0.965909090909091,1,1,2
"java/engine/org/apache/derby/impl/sql/execute/BulkTableScanResultSet.java",0,0.975935828877005,3,1,4
"java/engine/org/apache/derby/impl/sql/execute/CallStatementResultSet.java",0,0.915730337078652,5,1,6
"java/engine/org/apache/derby/impl/sql/execute/CardinalityCounter.java",0,0.9625,1,1,2
"java/engine/org/apache/derby/impl/sql/execute/ColumnInfo.java",0,0.86833855799373,2,3,5
"java/engine/org/apache/derby/impl/sql/execute/ConstantActionActivation.java",0,0.907692307692308,0,2,2
"java/engine/org/apache/derby/impl/sql/execute/ConstraintConstantAction.java",0,0.975757575757576,3,1,4
"java/engine/org/apache/derby/impl/sql/execute/ConstraintInfo.java",0,0.978571428571429,1,1,2
"java/engine/org/apache/derby/impl/sql/execute/CountAggregator.java",0,0.962732919254658,1,1,2
"java/engine/org/apache/derby/impl/sql/execute/CreateAliasConstantAction.java",0,0.775577557755776,1,2,3
"java/engine/org/apache/derby/impl/sql/execute/CreateConstraintConstantAction.java",0,0.975925925925926,2,1,3
"java/engine/org/apache/derby/impl/sql/execute/CreateIndexConstantAction.java",0,0.622242647058823,2,3,5
"java/engine/org/apache/derby/impl/sql/execute/CreateRoleConstantAction.java",0,1,0,1,1
"java/engine/org/apache/derby/impl/sql/execute/CreateSchemaConstantAction.java",0,0.808139534883721,1,2,3
"java/engine/org/apache/derby/impl/sql/execute/CreateTableConstantAction.java",0,0.843501326259947,4,2,6
"java/engine/org/apache/derby/impl/sql/execute/CreateTriggerConstantAction.java",0,0.830508474576271,3,3,6
"java/engine/org/apache/derby/impl/sql/execute/CreateViewConstantAction.java",0,0.964285714285714,2,1,3
"java/engine/org/apache/derby/impl/sql/execute/CurrentDatetime.java",0,0.947368421052632,0,2,2
"java/engine/org/apache/derby/impl/sql/execute/CurrentOfResultSet.java",0,0.872093023255814,3,2,5
"java/engine/org/apache/derby/impl/sql/execute/CursorActivation.java",0,0.877551020408163,0,2,2
"java/engine/org/apache/derby/impl/sql/execute/DDLConstantAction.java",0,0.551390568319226,4,2,6
"java/engine/org/apache/derby/impl/sql/execute/DDLSingleTableConstantAction.java",0,0.743055555555556,1,3,4
"java/engine/org/apache/derby/impl/sql/execute/DMLVTIResultSet.java",0,0.9375,3,1,4
"java/engine/org/apache/derby/impl/sql/execute/DMLWriteResultSet.java",0,0.74468085106383,1,3,4
"java/engine/org/apache/derby/impl/sql/execute/DeleteCascadeResultSet.java",0,0.98125,3,1,4
"java/engine/org/apache/derby/impl/sql/execute/DeleteConstantAction.java",0,0.967914438502674,1,1,2
"java/engine/org/apache/derby/impl/sql/execute/DeleteResultSet.java",0,0.971875,4,1,5
"java/engine/org/apache/derby/impl/sql/execute/DeleteVTIResultSet.java",0,0.954285714285714,3,1,4
"java/engine/org/apache/derby/impl/sql/execute/DependentResultSet.java",0,0.970505617977528,3,1,4
"java/engine/org/apache/derby/impl/sql/execute/DistinctGroupedAggregateResultSet.java",0,0.940594059405941,0,2,2
"java/engine/org/apache/derby/impl/sql/execute/DistinctScalarAggregateResultSet.java",0,0.95959595959596,2,1,3
"java/engine/org/apache/derby/impl/sql/execute/DistinctScanResultSet.java",0,0.9375,2,1,3
"java/engine/org/apache/derby/impl/sql/execute/DropAliasConstantAction.java",0,0.939130434782609,1,2,3
"java/engine/org/apache/derby/impl/sql/execute/DropConstraintConstantAction.java",0,0.968992248062015,2,1,3
"java/engine/org/apache/derby/impl/sql/execute/DropIndexConstantAction.java",0,0.918478260869565,2,1,3
"java/engine/org/apache/derby/impl/sql/execute/DropRoleConstantAction.java",0,1,0,1,1
"java/engine/org/apache/derby/impl/sql/execute/DropSchemaConstantAction.java",0,0.932038834951456,1,2,3
"java/engine/org/apache/derby/impl/sql/execute/DropStatisticsConstantAction.java",0,0.941176470588235,0,2,2
"java/engine/org/apache/derby/impl/sql/execute/DropTableConstantAction.java",0,0.963730569948187,3,1,4
"java/engine/org/apache/derby/impl/sql/execute/DropTriggerConstantAction.java",0,0.959459459459459,1,1,2
"java/engine/org/apache/derby/impl/sql/execute/DropViewConstantAction.java",0,0.955882352941177,1,1,2
"java/engine/org/apache/derby/impl/sql/execute/FKInfo.java",0,0.978102189781022,1,1,2
"java/engine/org/apache/derby/impl/sql/execute/ForeignKeyRIChecker.java",0,0.9453125,0,2,2
"java/engine/org/apache/derby/impl/sql/execute/GenericAggregateResultSet.java",0,0.962566844919786,1,1,2
"java/engine/org/apache/derby/impl/sql/execute/GenericAggregator.java",0,0.984575835475578,1,1,2
"java/engine/org/apache/derby/impl/sql/execute/GenericConstantActionFactory.java",0,0.854651162790698,4,2,6
"java/engine/org/apache/derby/impl/sql/execute/GenericExecutionContext.java",0,0.936170212765957,0,2,2
"java/engine/org/apache/derby/impl/sql/execute/GenericExecutionFactory.java",0,0.983695652173913,1,1,2
"java/engine/org/apache/derby/impl/sql/execute/GenericQualifier.java",0,0.969072164948454,1,1,2
"java/engine/org/apache/derby/impl/sql/execute/GenericRIChecker.java",0,0.971774193548387,1,1,2
"java/engine/org/apache/derby/impl/sql/execute/GenericResultSetFactory.java",0,0.845977011494253,6,2,8
"java/engine/org/apache/derby/impl/sql/execute/GenericScanQualifier.java",0,0.967741935483871,1,1,2
"java/engine/org/apache/derby/impl/sql/execute/GenericTriggerExecutor.java",0,0.76890756302521,3,2,5
"java/engine/org/apache/derby/impl/sql/execute/GrantRevokeConstantAction.java",0,0.861538461538462,1,2,3
"java/engine/org/apache/derby/impl/sql/execute/GrantRoleConstantAction.java",0,1,0,1,1
"java/engine/org/apache/derby/impl/sql/execute/GroupedAggregateResultSet.java",0,0.988522238163558,2,1,3
"java/engine/org/apache/derby/impl/sql/execute/HashJoinResultSet.java",0,0.888888888888889,0,2,2
"java/engine/org/apache/derby/impl/sql/execute/HashLeftOuterJoinResultSet.java",0,0.898305084745763,0,2,2
"java/engine/org/apache/derby/impl/sql/execute/HashScanResultSet.java",0,0.951822916666667,5,1,6
"java/engine/org/apache/derby/impl/sql/execute/HashTableResultSet.java",0,0.979591836734694,3,1,4
"java/engine/org/apache/derby/impl/sql/execute/IndexChanger.java",0,0.985401459854015,2,1,3
"java/engine/org/apache/derby/impl/sql/execute/IndexColumnOrder.java",0,0.702857142857143,1,2,3
"java/engine/org/apache/derby/impl/sql/execute/IndexConstantAction.java",0,0.919540229885057,0,2,2
"java/engine/org/apache/derby/impl/sql/execute/IndexRow.java",0,0.933333333333333,0,2,2
"java/engine/org/apache/derby/impl/sql/execute/IndexRowToBaseRowResultSet.java",0,0.885113268608414,2,2,4
"java/engine/org/apache/derby/impl/sql/execute/IndexSetChanger.java",0,0.985185185185185,1,1,2
"java/engine/org/apache/derby/impl/sql/execute/IndexValueRow.java",0,0.913907284768212,2,1,3
"java/engine/org/apache/derby/impl/sql/execute/InsertConstantAction.java",0,0.978571428571429,1,1,2
"java/engine/org/apache/derby/impl/sql/execute/InsertResultSet.java",0,0.874439461883408,6,2,8
"java/engine/org/apache/derby/impl/sql/execute/InsertVTIResultSet.java",0,0.972508591065292,3,1,4
"java/engine/org/apache/derby/impl/sql/execute/InternalTriggerExecutionContext.java",0,0.983965014577259,2,1,3
"java/engine/org/apache/derby/impl/sql/execute/JarUtil.java",0,0.985,1,1,2
"java/engine/org/apache/derby/impl/sql/execute/JoinResultSet.java",0,0.965397923875433,3,1,4
"java/engine/org/apache/derby/impl/sql/execute/LastIndexKeyResultSet.java",0,0.924528301886792,3,1,4
"java/engine/org/apache/derby/impl/sql/execute/LockTableConstantAction.java",0,0.942622950819672,0,2,2
"java/engine/org/apache/derby/impl/sql/execute/MaterializedResultSet.java",0,0.958115183246073,2,1,3
"java/engine/org/apache/derby/impl/sql/execute/MaxMinAggregator.java",0,0.877049180327869,1,2,3
"java/engine/org/apache/derby/impl/sql/execute/MergeJoinResultSet.java",0,0.979865771812081,1,1,2
"java/engine/org/apache/derby/impl/sql/execute/MiscResultSet.java",0,0.641025641025641,1,3,4
"java/engine/org/apache/derby/impl/sql/execute/MultiProbeTableScanResultSet.java",0,0.863529411764706,1,2,3
"java/engine/org/apache/derby/impl/sql/execute/NestedLoopJoinResultSet.java",0,0.97923875432526,1,1,2
"java/engine/org/apache/derby/impl/sql/execute/NestedLoopLeftOuterJoinResultSet.java",0,0.979020979020979,1,1,2
"java/engine/org/apache/derby/impl/sql/execute/NoPutResultSetImpl.java",0,0.859778597785978,4,2,6
"java/engine/org/apache/derby/impl/sql/execute/NoRowsResultSetImpl.java",0,0.753623188405797,4,2,6
"java/engine/org/apache/derby/impl/sql/execute/NormalizeResultSet.java",0,0.702637889688249,2,2,4
"java/engine/org/apache/derby/impl/sql/execute/OnceResultSet.java",0,0.980392156862745,1,1,2
"java/engine/org/apache/derby/impl/sql/execute/OrderableAggregator.java",0,0.95,0,2,2
"java/engine/org/apache/derby/impl/sql/execute/PrivilegeInfo.java",0,0.717171717171717,1,3,4
"java/engine/org/apache/derby/impl/sql/execute/ProjectRestrictResultSet.java",0,0.866888519134775,3,2,5
"java/engine/org/apache/derby/impl/sql/execute/RIBulkChecker.java",0,0.979827089337176,1,1,2
"java/engine/org/apache/derby/impl/sql/execute/RISetChecker.java",0,0.952941176470588,1,1,2
"java/engine/org/apache/derby/impl/sql/execute/RealResultSetStatisticsFactory.java",0,0.944403803950256,4,1,5
"java/engine/org/apache/derby/impl/sql/execute/ReferencedKeyRIChecker.java",0,0.944444444444444,0,2,2
"java/engine/org/apache/derby/impl/sql/execute/RenameConstantAction.java",0,0.985,1,1,2
"java/engine/org/apache/derby/impl/sql/execute/RevokeRoleConstantAction.java",0,1,0,1,1
"java/engine/org/apache/derby/impl/sql/execute/RoutinePrivilegeInfo.java",0,0.7,1,4,5
"java/engine/org/apache/derby/impl/sql/execute/RowChangerImpl.java",0,0.969798657718121,3,1,4
"java/engine/org/apache/derby/impl/sql/execute/RowCountResultSet.java",0,1,0,1,1
"java/engine/org/apache/derby/impl/sql/execute/RowResultSet.java",0,0.974358974358974,1,1,2
"java/engine/org/apache/derby/impl/sql/execute/RowTriggerExecutor.java",0,0.921875,2,1,3
"java/engine/org/apache/derby/impl/sql/execute/RowUtil.java",0,0.983050847457627,1,1,2
"java/engine/org/apache/derby/impl/sql/execute/SavepointConstantAction.java",0,0.931372549019608,0,2,2
"java/engine/org/apache/derby/impl/sql/execute/ScalarAggregateResultSet.java",0,0.981052631578947,2,1,3
"java/engine/org/apache/derby/impl/sql/execute/ScanResultSet.java",0,0.820833333333333,0,2,2
"java/engine/org/apache/derby/impl/sql/execute/ScrollInsensitiveResultSet.java",0,0.682605111294312,7,2,9
"java/engine/org/apache/derby/impl/sql/execute/SetConstraintsConstantAction.java",0,0.987603305785124,1,1,2
"java/engine/org/apache/derby/impl/sql/execute/SetOpResultSet.java",0,0.651629072681704,2,2,4
"java/engine/org/apache/derby/impl/sql/execute/SetRoleConstantAction.java",0,1,0,1,1
"java/engine/org/apache/derby/impl/sql/execute/SetSchemaConstantAction.java",0,0.912698412698413,3,1,4
"java/engine/org/apache/derby/impl/sql/execute/SetTransactionIsolationConstantAction.java",0,0.931818181818182,0,2,2
"java/engine/org/apache/derby/impl/sql/execute/SetTransactionResultSet.java",0,0.885245901639344,1,2,3
"java/engine/org/apache/derby/impl/sql/execute/SortResultSet.java",0,0.988817891373802,2,1,3
"java/engine/org/apache/derby/impl/sql/execute/SqlXmlExecutor.java",0,0.945454545454545,2,1,3
"java/engine/org/apache/derby/impl/sql/execute/StatementTriggerExecutor.java",0,0.931818181818182,0,2,2
"java/engine/org/apache/derby/impl/sql/execute/SumAggregator.java",0,0.936842105263158,0,2,2
"java/engine/org/apache/derby/impl/sql/execute/SystemAggregator.java",0,0.921052631578947,0,2,2
"java/engine/org/apache/derby/impl/sql/execute/TablePrivilegeInfo.java",0,0.461783439490446,4,3,7
"java/engine/org/apache/derby/impl/sql/execute/TableScanResultSet.java",0,0.869745003445899,6,2,8
"java/engine/org/apache/derby/impl/sql/execute/TemporaryRowHolderImpl.java",0,0.788177339901478,3,2,5
"java/engine/org/apache/derby/impl/sql/execute/TemporaryRowHolderResultSet.java",0,0.943625325238508,4,1,5
"java/engine/org/apache/derby/impl/sql/execute/TriggerEvent.java",0,0.948717948717949,0,2,2
"java/engine/org/apache/derby/impl/sql/execute/TriggerEventActivator.java",0,0.979381443298969,1,1,2
"java/engine/org/apache/derby/impl/sql/execute/TriggerEvents.java",0,0.842105263157895,0,2,2
"java/engine/org/apache/derby/impl/sql/execute/TriggerInfo.java",0,0.97864768683274,1,1,2
"java/engine/org/apache/derby/impl/sql/execute/UnionResultSet.java",0,0.98,1,1,2
"java/engine/org/apache/derby/impl/sql/execute/UniqueIndexSortObserver.java",0,0.922077922077922,0,2,2
"java/engine/org/apache/derby/impl/sql/execute/UniqueWithDuplicateNullsIndexSortObserver.java",0,1,0,1,1
"java/engine/org/apache/derby/impl/sql/execute/UpdatableVTIConstantAction.java",0,0.953846153846154,1,1,2
"java/engine/org/apache/derby/impl/sql/execute/UpdateConstantAction.java",0,0.969849246231156,1,1,2
"java/engine/org/apache/derby/impl/sql/execute/UpdateResultSet.java",0,0.973660308810173,5,1,6
"java/engine/org/apache/derby/impl/sql/execute/UpdateVTIResultSet.java",0,0.960975609756098,3,1,4
"java/engine/org/apache/derby/impl/sql/execute/VTIResultSet.java",0,0.786179921773142,2,2,4
"java/engine/org/apache/derby/impl/sql/execute/ValueRow.java",0,0.934362934362934,2,1,3
"java/engine/org/apache/derby/impl/sql/execute/WindowResultSet.java",0,1,0,1,1
"java/engine/org/apache/derby/impl/sql/execute/WriteCursorConstantAction.java",0,0.984575835475578,1,1,2
"java/engine/org/apache/derby/impl/sql/execute/rts/RealAnyResultSetStatistics.java",0,0.962962962962963,1,1,2
"java/engine/org/apache/derby/impl/sql/execute/rts/RealBasicNoPutResultSetStatistics.java",0,0.97489539748954,1,1,2
"java/engine/org/apache/derby/impl/sql/execute/rts/RealCurrentOfStatistics.java",0,0.951219512195122,1,1,2
"java/engine/org/apache/derby/impl/sql/execute/rts/RealDeleteCascadeResultSetStatistics.java",0,0.965909090909091,1,1,2
"java/engine/org/apache/derby/impl/sql/execute/rts/RealDeleteResultSetStatistics.java",0,0.953488372093023,1,1,2
"java/engine/org/apache/derby/impl/sql/execute/rts/RealDeleteVTIResultSetStatistics.java",0,0.945454545454545,0,2,2
"java/engine/org/apache/derby/impl/sql/execute/rts/RealDistinctScalarAggregateStatistics.java",0,0.956834532374101,1,1,2
"java/engine/org/apache/derby/impl/sql/execute/rts/RealDistinctScanStatistics.java",0,0.976653696498054,1,1,2
"java/engine/org/apache/derby/impl/sql/execute/rts/RealGroupedAggregateStatistics.java",0,0.964705882352941,1,1,2
"java/engine/org/apache/derby/impl/sql/execute/rts/RealHashJoinStatistics.java",0,0.925925925925926,1,2,3
"java/engine/org/apache/derby/impl/sql/execute/rts/RealHashLeftOuterJoinStatistics.java",0,0.916666666666667,1,2,3
"java/engine/org/apache/derby/impl/sql/execute/rts/RealHashScanStatistics.java",0,0.978723404255319,1,1,2
"java/engine/org/apache/derby/impl/sql/execute/rts/RealHashTableStatistics.java",0,0.975708502024291,1,1,2
"java/engine/org/apache/derby/impl/sql/execute/rts/RealIndexRowToBaseRowStatistics.java",0,0.967567567567568,1,1,2
"java/engine/org/apache/derby/impl/sql/execute/rts/RealInsertResultSetStatistics.java",0,0.964705882352941,1,1,2
"java/engine/org/apache/derby/impl/sql/execute/rts/RealInsertVTIResultSetStatistics.java",0,0.951612903225806,1,1,2
"java/engine/org/apache/derby/impl/sql/execute/rts/RealJoinResultSetStatistics.java",0,0.903846153846154,1,2,3
"java/engine/org/apache/derby/impl/sql/execute/rts/RealLastIndexKeyScanStatistics.java",0,0.968586387434555,1,1,2
"java/engine/org/apache/derby/impl/sql/execute/rts/RealMaterializedResultSetStatistics.java",0,0.961290322580645,1,1,2
"java/engine/org/apache/derby/impl/sql/execute/rts/RealNestedLoopJoinStatistics.java",0,0.913636363636364,1,2,3
"java/engine/org/apache/derby/impl/sql/execute/rts/RealNestedLoopLeftOuterJoinStatistics.java",0,0.954022988505747,2,1,3
"java/engine/org/apache/derby/impl/sql/execute/rts/RealNoPutResultSetStatistics.java",0,0.943396226415094,0,2,2
"java/engine/org/apache/derby/impl/sql/execute/rts/RealNoRowsResultSetStatistics.java",0,0.956521739130435,1,1,2
"java/engine/org/apache/derby/impl/sql/execute/rts/RealNormalizeResultSetStatistics.java",0,0.958620689655172,1,1,2
"java/engine/org/apache/derby/impl/sql/execute/rts/RealOnceResultSetStatistics.java",0,0.96319018404908,1,1,2
"java/engine/org/apache/derby/impl/sql/execute/rts/RealProjectRestrictStatistics.java",0,0.975806451612903,1,1,2
"java/engine/org/apache/derby/impl/sql/execute/rts/RealRowCountStatistics.java",0,1,0,1,1
"java/engine/org/apache/derby/impl/sql/execute/rts/RealRowResultSetStatistics.java",0,0.955882352941177,1,1,2
"java/engine/org/apache/derby/impl/sql/execute/rts/RealScalarAggregateStatistics.java",0,0.961038961038961,1,1,2
"java/engine/org/apache/derby/impl/sql/execute/rts/RealScrollInsensitiveResultSetStatistics.java",0,0.961783439490446,1,1,2
"java/engine/org/apache/derby/impl/sql/execute/rts/RealSetOpResultSetStatistics.java",0,0.971153846153846,1,1,2
"java/engine/org/apache/derby/impl/sql/execute/rts/RealSortStatistics.java",0,0.967213114754098,1,1,2
"java/engine/org/apache/derby/impl/sql/execute/rts/RealTableScanStatistics.java",0,0.930909090909091,2,1,3
"java/engine/org/apache/derby/impl/sql/execute/rts/RealUnionResultSetStatistics.java",0,0.964705882352941,1,1,2
"java/engine/org/apache/derby/impl/sql/execute/rts/RealUpdateResultSetStatistics.java",0,0.958620689655172,1,1,2
"java/engine/org/apache/derby/impl/sql/execute/rts/RealVTIStatistics.java",0,0.960526315789474,1,1,2
"java/engine/org/apache/derby/impl/sql/execute/rts/RealWindowResultSetStatistics.java",0,1,0,1,1
"java/engine/org/apache/derby/impl/sql/execute/rts/ResultSetStatistics.java",0,0.903225806451613,0,2,2
"java/engine/org/apache/derby/impl/sql/execute/rts/RunTimeStatisticsImpl.java",0,0.984334203655353,1,1,2
"java/engine/org/apache/derby/impl/store/access/BackingStoreHashTableFromScan.java",0,0.939024390243902,3,1,4
"java/engine/org/apache/derby/impl/store/access/CacheableConglomerate.java",0,0.951923076923077,3,1,4
"java/engine/org/apache/derby/impl/store/access/PC_XenaVersion.java",0,0.918604651162791,1,2,3
"java/engine/org/apache/derby/impl/store/access/PropertyConglomerate.java",0,0.979874213836478,3,1,4
"java/engine/org/apache/derby/impl/store/access/RAMAccessManager.java",0,0.955307262569832,4,1,5
"java/engine/org/apache/derby/impl/store/access/RAMTransaction.java",0,0.883749488334016,5,2,7
"java/engine/org/apache/derby/impl/store/access/RAMTransactionContext.java",0,0.900709219858156,3,1,4
"java/engine/org/apache/derby/impl/store/access/RllRAMAccessManager.java",0,0.923076923076923,1,2,3
"java/engine/org/apache/derby/impl/store/access/StorableFormatId.java",0,0.96969696969697,2,1,3
"java/engine/org/apache/derby/impl/store/access/UTF.java",0,0.9,0,2,2
"java/engine/org/apache/derby/impl/store/access/UTFQualifier.java",0,0.92,2,1,3
"java/engine/org/apache/derby/impl/store/access/btree/BTree.java",0,0.899866488651535,2,2,4
"java/engine/org/apache/derby/impl/store/access/btree/BTreeController.java",0,0.797491039426523,3,3,6
"java/engine/org/apache/derby/impl/store/access/btree/BTreeCostController.java",0,0.971851851851852,3,1,4
"java/engine/org/apache/derby/impl/store/access/btree/BTreeForwardScan.java",0,0.876826722338205,3,2,5
"java/engine/org/apache/derby/impl/store/access/btree/BTreeLockingPolicy.java",0,0.937106918238994,3,1,4
"java/engine/org/apache/derby/impl/store/access/btree/BTreeMaxScan.java",0,0.927272727272727,2,2,4
"java/engine/org/apache/derby/impl/store/access/btree/BTreePostCommit.java",0,0.618147448015123,3,2,5
"java/engine/org/apache/derby/impl/store/access/btree/BTreeRowPosition.java",0,0.5,1,2,3
"java/engine/org/apache/derby/impl/store/access/btree/BTreeScan.java",0,0.88031565103025,5,2,7
"java/engine/org/apache/derby/impl/store/access/btree/BTreeScanInfo.java",0,0.965116279069767,1,1,2
"java/engine/org/apache/derby/impl/store/access/btree/BranchControlRow.java",0,0.977506426735218,3,1,4
"java/engine/org/apache/derby/impl/store/access/btree/BranchRow.java",0,0.9375,2,1,3
"java/engine/org/apache/derby/impl/store/access/btree/ControlRow.java",0,0.984644020474639,4,1,5
"java/engine/org/apache/derby/impl/store/access/btree/D_BTreeController.java",0,0.981735159817352,3,1,4
"java/engine/org/apache/derby/impl/store/access/btree/LeafControlRow.java",0,0.969924812030075,4,1,5
"java/engine/org/apache/derby/impl/store/access/btree/OpenBTree.java",0,0.963503649635037,4,1,5
"java/engine/org/apache/derby/impl/store/access/btree/SearchParameters.java",0,0.970731707317073,1,1,2
"java/engine/org/apache/derby/impl/store/access/btree/WaitError.java",0,0.818181818181818,0,2,2
"java/engine/org/apache/derby/impl/store/access/btree/index/B2I.java",0,0.684253915910965,4,2,6
"java/engine/org/apache/derby/impl/store/access/btree/index/B2IController.java",0,0.910377358490566,4,1,5
"java/engine/org/apache/derby/impl/store/access/btree/index/B2ICostController.java",0,0.746666666666667,0,3,3
"java/engine/org/apache/derby/impl/store/access/btree/index/B2IFactory.java",0,0.863777089783282,2,2,4
"java/engine/org/apache/derby/impl/store/access/btree/index/B2IForwardScan.java",0,0.912878787878788,2,2,4
"java/engine/org/apache/derby/impl/store/access/btree/index/B2IMaxScan.java",0,0.913793103448276,3,1,4
"java/engine/org/apache/derby/impl/store/access/btree/index/B2INoLocking.java",0,0.906666666666667,2,2,4
"java/engine/org/apache/derby/impl/store/access/btree/index/B2IRowLocking1.java",0,0.943502824858757,3,1,4
"java/engine/org/apache/derby/impl/store/access/btree/index/B2IRowLocking2.java",0,0.86734693877551,0,3,3
"java/engine/org/apache/derby/impl/store/access/btree/index/B2IRowLocking3.java",0,0.880304678998912,3,2,5
"java/engine/org/apache/derby/impl/store/access/btree/index/B2IRowLockingRR.java",0,0.947019867549669,2,1,3
"java/engine/org/apache/derby/impl/store/access/btree/index/B2IStaticCompiledInfo.java",0,0.967441860465116,2,1,3
"java/engine/org/apache/derby/impl/store/access/btree/index/B2ITableLocking3.java",0,0.886792452830189,0,2,2
"java/engine/org/apache/derby/impl/store/access/btree/index/B2IUndo.java",0,0.927272727272727,4,1,5
"java/engine/org/apache/derby/impl/store/access/btree/index/B2I_10_3.java",0,1,0,1,1
"java/engine/org/apache/derby/impl/store/access/btree/index/B2I_v10_2.java",0,1,0,1,1
"java/engine/org/apache/derby/impl/store/access/btree/index/D_B2IController.java",0,0.547619047619048,0,3,3
"java/engine/org/apache/derby/impl/store/access/conglomerate/BinaryOrderableWrapper.java",0,0.966666666666667,1,1,2
"java/engine/org/apache/derby/impl/store/access/conglomerate/ConglomerateUtil.java",0,0.660146699266504,1,2,3
"java/engine/org/apache/derby/impl/store/access/conglomerate/GenericConglomerate.java",0,0.973214285714286,1,1,2
"java/engine/org/apache/derby/impl/store/access/conglomerate/GenericConglomerateController.java",0,0.933194154488518,3,1,4
"java/engine/org/apache/derby/impl/store/access/conglomerate/GenericController.java",0,0.974248927038627,1,1,2
"java/engine/org/apache/derby/impl/store/access/conglomerate/GenericCostController.java",0,0.946969696969697,2,1,3
"java/engine/org/apache/derby/impl/store/access/conglomerate/GenericScanController.java",0,0.898009950248756,6,1,7
"java/engine/org/apache/derby/impl/store/access/conglomerate/OpenConglomerate.java",0,0.959826275787188,2,1,3
"java/engine/org/apache/derby/impl/store/access/conglomerate/OpenConglomerateScratchSpace.java",0,0.668161434977579,1,3,4
"java/engine/org/apache/derby/impl/store/access/conglomerate/RowPosition.java",0,0.827868852459016,1,2,3
"java/engine/org/apache/derby/impl/store/access/conglomerate/TemplateRow.java",0,0.819875776397516,1,2,3
"java/engine/org/apache/derby/impl/store/access/heap/D_HeapController.java",0,0.972222222222222,2,1,3
"java/engine/org/apache/derby/impl/store/access/heap/Heap.java",0,0.664521319388576,2,2,4
"java/engine/org/apache/derby/impl/store/access/heap/HeapClassInfo.java",0,0.818181818181818,0,2,2
"java/engine/org/apache/derby/impl/store/access/heap/HeapCompressScan.java",0,0.903669724770642,3,2,5
"java/engine/org/apache/derby/impl/store/access/heap/HeapConglomerateFactory.java",0,0.880877742946709,2,2,4
"java/engine/org/apache/derby/impl/store/access/heap/HeapController.java",0,0.864864864864865,2,2,4
"java/engine/org/apache/derby/impl/store/access/heap/HeapCostController.java",0,0.972081218274112,3,1,4
"java/engine/org/apache/derby/impl/store/access/heap/HeapPostCommit.java",0,0.979695431472081,2,1,3
"java/engine/org/apache/derby/impl/store/access/heap/HeapRowLocation.java",0,0.915254237288136,3,1,4
"java/engine/org/apache/derby/impl/store/access/heap/HeapScan.java",0,0.72069825436409,2,3,5
"java/engine/org/apache/derby/impl/store/access/heap/HeapScanInfo.java",0,0.958041958041958,1,1,2
"java/engine/org/apache/derby/impl/store/access/heap/Heap_v10_2.java",0,1,0,1,1
"java/engine/org/apache/derby/impl/store/access/heap/OpenHeap.java",0,0.926829268292683,0,2,2
"java/engine/org/apache/derby/impl/store/access/sort/ExternalSortFactory.java",0,0.933333333333333,3,1,4
"java/engine/org/apache/derby/impl/store/access/sort/MergeInserter.java",0,0.939799331103679,2,1,3
"java/engine/org/apache/derby/impl/store/access/sort/MergeScan.java",0,0.955284552845528,2,1,3
"java/engine/org/apache/derby/impl/store/access/sort/MergeScanRowSource.java",0,0.935714285714286,2,1,3
"java/engine/org/apache/derby/impl/store/access/sort/MergeSort.java",0,0.95741935483871,4,1,5
"java/engine/org/apache/derby/impl/store/access/sort/MergeSortInfo.java",0,0.964705882352941,1,1,2
"java/engine/org/apache/derby/impl/store/access/sort/Node.java",0,0.942307692307692,0,2,2
"java/engine/org/apache/derby/impl/store/access/sort/NodeAllocator.java",0,0.831730769230769,1,2,3
"java/engine/org/apache/derby/impl/store/access/sort/Scan.java",0,0.891891891891892,5,1,6
"java/engine/org/apache/derby/impl/store/access/sort/SortBuffer.java",0,0.991608391608392,1,1,2
"java/engine/org/apache/derby/impl/store/access/sort/SortBufferRowSource.java",0,0.864077669902913,2,2,4
"java/engine/org/apache/derby/impl/store/access/sort/SortBufferScan.java",0,0.929203539823009,1,2,3
"java/engine/org/apache/derby/impl/store/access/sort/SortScan.java",0,0.865591397849462,3,2,5
"java/engine/org/apache/derby/impl/store/access/sort/UniqueWithDuplicateNullsExternalSortFactory.java",0,1,0,1,1
"java/engine/org/apache/derby/impl/store/access/sort/UniqueWithDuplicateNullsMergeSort.java",0,1,0,1,1
"java/engine/org/apache/derby/impl/store/raw/RawStore.java",0,0.383961566888396,8,4,12
"java/engine/org/apache/derby/impl/store/raw/data/AllocExtent.java",0,0.785512699905927,2,2,4
"java/engine/org/apache/derby/impl/store/raw/data/AllocPage.java",0,0.86247723132969,4,2,6
"java/engine/org/apache/derby/impl/store/raw/data/AllocPageOperation.java",0,0.964912280701754,1,1,2
"java/engine/org/apache/derby/impl/store/raw/data/AllocationActions.java",0,0.594059405940594,1,3,4
"java/engine/org/apache/derby/impl/store/raw/data/AllocationCache.java",0,0.978693181818182,2,1,3
"java/engine/org/apache/derby/impl/store/raw/data/BaseContainer.java",0,0.792025862068966,5,2,7
"java/engine/org/apache/derby/impl/store/raw/data/BaseContainerHandle.java",0,0.853245531514581,4,2,6
"java/engine/org/apache/derby/impl/store/raw/data/BaseDataFileFactory.java",0,0.688141592920354,9,2,11
"java/engine/org/apache/derby/impl/store/raw/data/BaseDataFileFactoryJ4.java",0,1,0,1,1
"java/engine/org/apache/derby/impl/store/raw/data/BasePage.java",0,0.917268786127168,5,1,6
"java/engine/org/apache/derby/impl/store/raw/data/BufferedByteHolderInputStream.java",0,0.82089552238806,0,3,3
"java/engine/org/apache/derby/impl/store/raw/data/ByteHolder.java",0,0.948387096774194,2,1,3
"java/engine/org/apache/derby/impl/store/raw/data/ByteHolderInputStream.java",0,0.9,0,2,2
"java/engine/org/apache/derby/impl/store/raw/data/CachedPage.java",0,0.514657980456026,4,3,7
"java/engine/org/apache/derby/impl/store/raw/data/ChainAllocPageOperation.java",0,0.963414634146341,1,1,2
"java/engine/org/apache/derby/impl/store/raw/data/CompressSpacePageOperation.java",0,0.925764192139738,2,1,3
"java/engine/org/apache/derby/impl/store/raw/data/CompressSpacePageOperation10_2.java",0,1,0,1,1
"java/engine/org/apache/derby/impl/store/raw/data/ContainerActionOnCommit.java",0,0.907692307692308,0,2,2
"java/engine/org/apache/derby/impl/store/raw/data/ContainerBasicOperation.java",0,0.900398406374502,2,2,4
"java/engine/org/apache/derby/impl/store/raw/data/ContainerHandleActionOnCommit.java",0,0.934782608695652,0,2,2
"java/engine/org/apache/derby/impl/store/raw/data/ContainerOperation.java",0,0.946488294314381,3,1,4
"java/engine/org/apache/derby/impl/store/raw/data/ContainerUndoOperation.java",0,0.955128205128205,2,1,3
"java/engine/org/apache/derby/impl/store/raw/data/CopyRowsOperation.java",0,0.969230769230769,2,1,3
"java/engine/org/apache/derby/impl/store/raw/data/D_BaseContainerHandle.java",0,0.926829268292683,3,1,4
"java/engine/org/apache/derby/impl/store/raw/data/D_DiagnosticUtil.java",0,0.933638443935927,1,2,3
"java/engine/org/apache/derby/impl/store/raw/data/D_RecordId.java",0,0.934579439252336,1,2,3
"java/engine/org/apache/derby/impl/store/raw/data/D_StoredPage.java",0,0.977777777777778,2,1,3
"java/engine/org/apache/derby/impl/store/raw/data/DecryptInputStream.java",0,0.934782608695652,0,2,2
"java/engine/org/apache/derby/impl/store/raw/data/DeleteOperation.java",0,0.970930232558139,2,1,3
"java/engine/org/apache/derby/impl/store/raw/data/DirectActions.java",0,0.981072555205047,1,1,2
"java/engine/org/apache/derby/impl/store/raw/data/DirectAllocActions.java",0,0.608695652173913,1,3,4
"java/engine/org/apache/derby/impl/store/raw/data/DropOnCommit.java",0,0.9375,0,2,2
"java/engine/org/apache/derby/impl/store/raw/data/EncryptContainerOperation.java",0,0.943661971830986,3,1,4
"java/engine/org/apache/derby/impl/store/raw/data/EncryptContainerUndoOperation.java",0,0.967032967032967,1,1,2
"java/engine/org/apache/derby/impl/store/raw/data/EncryptData.java",0,0.64027149321267,1,2,3
"java/engine/org/apache/derby/impl/store/raw/data/FileContainer.java",0,0.788707799767171,5,2,7
"java/engine/org/apache/derby/impl/store/raw/data/InitPageOperation.java",0,0.946938775510204,3,1,4
"java/engine/org/apache/derby/impl/store/raw/data/InputStreamContainer.java",0,0.806691449814126,4,3,7
"java/engine/org/apache/derby/impl/store/raw/data/InsertOperation.java",0,0.972361809045226,2,1,3
"java/engine/org/apache/derby/impl/store/raw/data/InvalidatePageOperation.java",0,0.952662721893491,2,1,3
"java/engine/org/apache/derby/impl/store/raw/data/LoggableActions.java",0,0.97489539748954,1,1,2
"java/engine/org/apache/derby/impl/store/raw/data/LoggableAllocActions.java",0,0.533333333333333,3,2,5
"java/engine/org/apache/derby/impl/store/raw/data/LogicalPageOperation.java",0,0.978520286396181,2,1,3
"java/engine/org/apache/derby/impl/store/raw/data/LogicalUndoOperation.java",0,0.97119341563786,2,1,3
"java/engine/org/apache/derby/impl/store/raw/data/LongColumnException.java",0,0.924050632911392,0,2,2
"java/engine/org/apache/derby/impl/store/raw/data/MemByteHolder.java",0,0.980952380952381,2,1,3
"java/engine/org/apache/derby/impl/store/raw/data/NoSpaceOnPage.java",0,0.872340425531915,0,2,2
"java/engine/org/apache/derby/impl/store/raw/data/OverflowInputStream.java",0,0.73186119873817,4,2,6
"java/engine/org/apache/derby/impl/store/raw/data/PageActions.java",0,0.865051903114187,2,2,4
"java/engine/org/apache/derby/impl/store/raw/data/PageBasicOperation.java",0,0.955773955773956,3,1,4
"java/engine/org/apache/derby/impl/store/raw/data/PageCreationArgs.java",0,1,0,1,1
"java/engine/org/apache/derby/impl/store/raw/data/PageVersion.java",0,0.901639344262295,0,2,2
"java/engine/org/apache/derby/impl/store/raw/data/PhysicalPageOperation.java",0,0.946308724832215,2,1,3
"java/engine/org/apache/derby/impl/store/raw/data/PhysicalUndoOperation.java",0,0.910313901345291,2,2,4
"java/engine/org/apache/derby/impl/store/raw/data/PurgeOperation.java",0,0.966887417218543,2,1,3
"java/engine/org/apache/derby/impl/store/raw/data/RAFContainer.java",0,0.598480050664978,6,3,9
"java/engine/org/apache/derby/impl/store/raw/data/RAFContainer4.java",0,0.995967741935484,1,1,2
"java/engine/org/apache/derby/impl/store/raw/data/RFResource.java",0,0.82421875,1,2,3
"java/engine/org/apache/derby/impl/store/raw/data/RawField.java",0,0.828571428571429,0,2,2
"java/engine/org/apache/derby/impl/store/raw/data/ReclaimSpace.java",0,0.975,1,1,2
"java/engine/org/apache/derby/impl/store/raw/data/ReclaimSpaceHelper.java",0,0.826325411334552,2,2,4
"java/engine/org/apache/derby/impl/store/raw/data/RecordId.java",0,0.944078947368421,3,1,4
"java/engine/org/apache/derby/impl/store/raw/data/RememberBytesInputStream.java",0,0.77431906614786,1,2,3
"java/engine/org/apache/derby/impl/store/raw/data/RemoveFileOperation.java",0,0.959537572254335,2,1,3
"java/engine/org/apache/derby/impl/store/raw/data/SetReservedSpaceOperation.java",0,0.956756756756757,2,1,3
"java/engine/org/apache/derby/impl/store/raw/data/SpaceInformation.java",0,0.933333333333333,0,2,2
"java/engine/org/apache/derby/impl/store/raw/data/StoredFieldHeader.java",0,0.99020979020979,2,1,3
"java/engine/org/apache/derby/impl/store/raw/data/StoredPage.java",0,0.963328163084423,4,1,5
"java/engine/org/apache/derby/impl/store/raw/data/StoredRecordHeader.java",0,0.832684824902724,2,2,4
"java/engine/org/apache/derby/impl/store/raw/data/StreamFileContainer.java",0,0.863175675675676,2,2,4
"java/engine/org/apache/derby/impl/store/raw/data/StreamFileContainerHandle.java",0,0.971786833855799,2,1,3
"java/engine/org/apache/derby/impl/store/raw/data/SyncOnCommit.java",0,0.91358024691358,1,2,3
"java/engine/org/apache/derby/impl/store/raw/data/TempRAFContainer.java",0,0.947368421052632,2,1,3
"java/engine/org/apache/derby/impl/store/raw/data/TruncateOnCommit.java",0,0.935185185185185,1,2,3
"java/engine/org/apache/derby/impl/store/raw/data/UpdateFieldOperation.java",0,0.970350404312669,2,1,3
"java/engine/org/apache/derby/impl/store/raw/data/UpdateOperation.java",0,0.979591836734694,2,1,3
"java/engine/org/apache/derby/impl/store/raw/log/CheckpointOperation.java",0,0.949367088607595,3,1,4
"java/engine/org/apache/derby/impl/store/raw/log/ChecksumOperation.java",0,0.977358490566038,1,1,2
"java/engine/org/apache/derby/impl/store/raw/log/D_FlushedScan.java",0,0.892857142857143,0,2,2
"java/engine/org/apache/derby/impl/store/raw/log/D_LogToFile.java",0,0.836363636363636,0,3,3
"java/engine/org/apache/derby/impl/store/raw/log/FileLogger.java",0,0.983312731767614,4,1,5
"java/engine/org/apache/derby/impl/store/raw/log/FlushedScan.java",0,0.986111111111111,2,1,3
"java/engine/org/apache/derby/impl/store/raw/log/FlushedScanHandle.java",0,0.962566844919786,2,1,3
"java/engine/org/apache/derby/impl/store/raw/log/LogAccessFile.java",0,0.477035490605428,3,3,6
"java/engine/org/apache/derby/impl/store/raw/log/LogAccessFileBuffer.java",0,0.831325301204819,1,3,4
"java/engine/org/apache/derby/impl/store/raw/log/LogCounter.java",0,0.924050632911392,1,2,3
"java/engine/org/apache/derby/impl/store/raw/log/LogRecord.java",0,0.923566878980892,1,2,3
"java/engine/org/apache/derby/impl/store/raw/log/LogToFile.java",0,0.751441048034935,9,3,12
"java/engine/org/apache/derby/impl/store/raw/log/ReadOnly.java",0,0.641975308641975,4,4,8
"java/engine/org/apache/derby/impl/store/raw/log/Scan.java",0,0.869462025316456,2,2,4
"java/engine/org/apache/derby/impl/store/raw/log/StreamLogScan.java",0,0.87603305785124,1,2,3
"java/engine/org/apache/derby/impl/store/raw/xact/BeginXact.java",0,0.966292134831461,1,1,2
"java/engine/org/apache/derby/impl/store/raw/xact/ContainerLocking2.java",0,0.938053097345133,1,2,3
"java/engine/org/apache/derby/impl/store/raw/xact/ContainerLocking3.java",0,0.91358024691358,1,2,3
"java/engine/org/apache/derby/impl/store/raw/xact/D_Xact.java",0,0.890625,1,2,3
"java/engine/org/apache/derby/impl/store/raw/xact/EndXact.java",0,0.969849246231156,1,1,2
"java/engine/org/apache/derby/impl/store/raw/xact/EscalateContainerKey.java",0,0.914285714285714,0,2,2
"java/engine/org/apache/derby/impl/store/raw/xact/GlobalXactId.java",0,0.96319018404908,1,1,2
"java/engine/org/apache/derby/impl/store/raw/xact/InternalXact.java",0,0.896774193548387,2,2,4
"java/engine/org/apache/derby/impl/store/raw/xact/NoLocking.java",0,0.941176470588235,0,2,2
"java/engine/org/apache/derby/impl/store/raw/xact/RowLocking1.java",0,0.95,0,2,2
"java/engine/org/apache/derby/impl/store/raw/xact/RowLocking2.java",0,0.918181818181818,1,2,3
"java/engine/org/apache/derby/impl/store/raw/xact/RowLocking2nohold.java",0,0.943396226415094,0,2,2
"java/engine/org/apache/derby/impl/store/raw/xact/RowLocking3.java",0,0.965779467680608,2,1,3
"java/engine/org/apache/derby/impl/store/raw/xact/RowLocking3Escalate.java",0,0.949152542372881,0,2,2
"java/engine/org/apache/derby/impl/store/raw/xact/RowLockingRR.java",0,0.945454545454545,0,2,2
"java/engine/org/apache/derby/impl/store/raw/xact/SavePoint.java",0,0.924050632911392,0,2,2
"java/engine/org/apache/derby/impl/store/raw/xact/TransactionTable.java",0,0.9287109375,3,2,5
"java/engine/org/apache/derby/impl/store/raw/xact/TransactionTableEntry.java",0,0.985714285714286,2,1,3
"java/engine/org/apache/derby/impl/store/raw/xact/Xact.java",0,0.928775948460988,6,1,7
"java/engine/org/apache/derby/impl/store/raw/xact/XactContext.java",0,0.910179640718563,3,1,4
"java/engine/org/apache/derby/impl/store/raw/xact/XactFactory.java",0,0.811206896551724,4,2,6
"java/engine/org/apache/derby/impl/store/raw/xact/XactId.java",0,0.965909090909091,1,1,2
"java/engine/org/apache/derby/impl/store/raw/xact/XactXAResourceManager.java",0,0.982808022922636,1,1,2
"java/engine/org/apache/derby/impl/store/replication/ReplicationLogger.java",0,0.971428571428571,2,1,3
"java/engine/org/apache/derby/impl/store/replication/buffer/LogBufferElement.java",0,0.773584905660377,1,2,3
"java/engine/org/apache/derby/impl/store/replication/buffer/LogBufferFullException.java",0,0.928571428571429,0,2,2
"java/engine/org/apache/derby/impl/store/replication/buffer/ReplicationLogBuffer.java",0,0.778666666666667,0,2,2
"java/engine/org/apache/derby/impl/store/replication/master/AsynchronousLogShipper.java",0,0.862144420131291,0,2,2
"java/engine/org/apache/derby/impl/store/replication/master/LogShipper.java",0,1,0,1,1
"java/engine/org/apache/derby/impl/store/replication/master/MasterController.java",0,0.924382716049383,1,2,3
"java/engine/org/apache/derby/impl/store/replication/net/ReplicationMessage.java",0,1,0,1,1
"java/engine/org/apache/derby/impl/store/replication/net/ReplicationMessageReceive.java",0,0.976470588235294,1,1,2
"java/engine/org/apache/derby/impl/store/replication/net/ReplicationMessageTransmit.java",0,1,0,1,1
"java/engine/org/apache/derby/impl/store/replication/net/SlaveAddress.java",0,1,0,1,1
"java/engine/org/apache/derby/impl/store/replication/net/SocketConnection.java",0,0.919354838709677,0,2,2
"java/engine/org/apache/derby/impl/store/replication/slave/ReplicationLogScan.java",0,0.66743648960739,0,2,2
"java/engine/org/apache/derby/impl/store/replication/slave/SlaveController.java",0,0.990196078431373,1,1,2
"java/engine/org/apache/derby/io/StorageFactory.java",0,0.931623931623932,2,1,3
"java/engine/org/apache/derby/io/StorageFile.java",0,0.962585034013605,2,1,3
"java/engine/org/apache/derby/io/StorageRandomAccessFile.java",0,0.781954887218045,1,2,3
"java/engine/org/apache/derby/io/WritableStorageFactory.java",0,0.869565217391304,1,2,3
"java/engine/org/apache/derby/jdbc/AutoloadedDriver.java",0,0.941964285714286,2,1,3
"java/engine/org/apache/derby/jdbc/Driver169.java",0,0.95364238410596,2,1,3
"java/engine/org/apache/derby/jdbc/Driver20.java",0,0.941964285714286,3,1,4
"java/engine/org/apache/derby/jdbc/Driver30.java",0,0.759493670886076,1,2,3
"java/engine/org/apache/derby/jdbc/Driver40.java",0,0.510416666666667,3,3,6
"java/engine/org/apache/derby/jdbc/EmbedPooledConnection.java",0,0.601680672268908,3,4,7
"java/engine/org/apache/derby/jdbc/EmbedPooledConnection40.java",0,0.824,1,2,3
"java/engine/org/apache/derby/jdbc/EmbedXAConnection.java",0,0.834745762711864,2,2,4
"java/engine/org/apache/derby/jdbc/EmbedXAConnection40.java",0,0.576923076923077,1,2,3
"java/engine/org/apache/derby/jdbc/EmbedXAResource.java",0,0.858862144420131,3,2,5
"java/engine/org/apache/derby/jdbc/EmbeddedConnectionPoolDataSource.java",0,0.644927536231884,2,3,5
"java/engine/org/apache/derby/jdbc/EmbeddedConnectionPoolDataSource40.java",0,0.935483870967742,0,2,2
"java/engine/org/apache/derby/jdbc/EmbeddedDataSource.java",0,0.953321364452424,3,1,4
"java/engine/org/apache/derby/jdbc/EmbeddedDataSource40.java",0,0.864864864864865,1,2,3
"java/engine/org/apache/derby/jdbc/EmbeddedDriver.java",0,0.781553398058252,0,3,3
"java/engine/org/apache/derby/jdbc/EmbeddedSimpleDataSource.java",0,0.971014492753623,2,1,3
"java/engine/org/apache/derby/jdbc/EmbeddedXADataSource.java",0,0.745901639344262,3,2,5
"java/engine/org/apache/derby/jdbc/EmbeddedXADataSource40.java",0,0.941176470588235,0,2,2
"java/engine/org/apache/derby/jdbc/InternalDriver.java",0,0.771065182829889,3,2,5
"java/engine/org/apache/derby/jdbc/JDBC.java",0,1,0,1,1
"java/engine/org/apache/derby/jdbc/ReferenceableDataSource.java",0,0.967254408060453,1,1,2
"java/engine/org/apache/derby/jdbc/ResourceAdapterImpl.java",0,0.868055555555556,1,2,3
"java/engine/org/apache/derby/jdbc/XAStatementControl.java",0,0.928251121076233,2,1,3
"java/engine/org/apache/derby/jdbc/XATransactionState.java",0,0.644110275689223,2,3,5
"java/engine/org/apache/derby/mbeans/JDBCMBean.java",0,1,0,1,1
"java/engine/org/apache/derby/mbeans/Management.java",0,1,0,1,1
"java/engine/org/apache/derby/mbeans/ManagementMBean.java",0,1,0,1,1
"java/engine/org/apache/derby/mbeans/VersionMBean.java",0,1,0,1,1
"java/engine/org/apache/derby/osgi/EmbeddedActivator.java",0,0.86046511627907,0,2,2
"java/engine/org/apache/derby/security/DatabasePermission.java",0,0.73991935483871,1,2,3
"java/engine/org/apache/derby/security/SystemPermission.java",0,0.758771929824561,1,2,3
"java/engine/org/apache/derby/vti/DeferModification.java",0,0.96,1,1,2
"java/engine/org/apache/derby/vti/IFastPath.java",0,0.931818181818182,0,2,2
"java/engine/org/apache/derby/vti/IQualifyable.java",0,0.842105263157895,0,2,2
"java/engine/org/apache/derby/vti/Pushable.java",0,0.917808219178082,0,2,2
"java/engine/org/apache/derby/vti/UpdatableVTITemplate.java",0,0.99041095890411,2,1,3
"java/engine/org/apache/derby/vti/VTICosting.java",0,0.496062992125984,0,3,3
"java/engine/org/apache/derby/vti/VTIEnvironment.java",0,0.753623188405797,0,3,3
"java/engine/org/apache/derby/vti/VTIMetaDataTemplate.java",0,0.978947368421053,1,1,2
"java/engine/org/apache/derby/vti/VTITemplate.java",0,0.992937853107345,2,1,3
"java/shared/org/apache/derby/shared/common/error/ExceptionSeverity.java",0,0.918918918918919,0,2,2
"java/shared/org/apache/derby/shared/common/error/ExceptionUtil.java",0,0.9375,1,2,3
"java/shared/org/apache/derby/shared/common/i18n/MessageUtil.java",0,0.97910447761194,2,1,3
"java/shared/org/apache/derby/shared/common/reference/Attribute.java",0,0.756272401433692,3,3,6
"java/shared/org/apache/derby/shared/common/reference/JDBC30Translation.java",0,0.846153846153846,1,2,3
"java/shared/org/apache/derby/shared/common/reference/JDBC40Translation.java",0,0.8,0,2,2
"java/shared/org/apache/derby/shared/common/reference/MessageId.java",0,0.740740740740741,9,2,11
"java/shared/org/apache/derby/shared/common/reference/SQLState.java",0,0.736118746564046,14,2,16
"java/shared/org/apache/derby/shared/common/sanity/AssertFailure.java",0,0.687179487179487,1,3,4
"java/shared/org/apache/derby/shared/common/sanity/SanityManager.java",0,0.969444444444444,2,1,3
"java/shared/org/apache/derby/shared/common/sanity/ThreadDump.java",0,1,0,1,1
"java/storeless/org/apache/derby/impl/storeless/EmptyDictionary.java",0,0.868453105968331,5,2,7
"java/storeless/org/apache/derby/impl/storeless/NoOpTransaction.java",0,0.955710955710956,3,1,4
"java/storeless/org/apache/derby/impl/storeless/StorelessDatabase.java",0,1,0,1,1
"java/storeless/org/apache/derby/impl/storeless/StorelessService.java",0,1,0,1,1
"java/stubs/felix/org/osgi/framework/AdminPermission.java",0,1,0,1,1
"java/stubs/felix/org/osgi/framework/AllServiceListener.java",0,1,0,1,1
"java/stubs/felix/org/osgi/framework/Bundle.java",0,1,0,1,1
"java/stubs/felix/org/osgi/framework/BundleActivator.java",0,1,0,1,1
"java/stubs/felix/org/osgi/framework/BundleContext.java",0,1,0,1,1
"java/stubs/felix/org/osgi/framework/BundleEvent.java",0,1,0,1,1
"java/stubs/felix/org/osgi/framework/BundleException.java",0,1,0,1,1
"java/stubs/felix/org/osgi/framework/BundleListener.java",0,1,0,1,1
"java/stubs/felix/org/osgi/framework/BundlePermission.java",0,1,0,1,1
"java/stubs/felix/org/osgi/framework/Configurable.java",0,1,0,1,1
"java/stubs/felix/org/osgi/framework/Constants.java",0,1,0,1,1
"java/stubs/felix/org/osgi/framework/Filter.java",0,1,0,1,1
"java/stubs/felix/org/osgi/framework/FrameworkEvent.java",0,1,0,1,1
"java/stubs/felix/org/osgi/framework/FrameworkListener.java",0,1,0,1,1
"java/stubs/felix/org/osgi/framework/FrameworkUtil.java",0,1,0,1,1
"java/stubs/felix/org/osgi/framework/InvalidSyntaxException.java",0,1,0,1,1
"java/stubs/felix/org/osgi/framework/PackagePermission.java",0,1,0,1,1
"java/stubs/felix/org/osgi/framework/ServiceEvent.java",0,1,0,1,1
"java/stubs/felix/org/osgi/framework/ServiceFactory.java",0,1,0,1,1
"java/stubs/felix/org/osgi/framework/ServiceListener.java",0,1,0,1,1
"java/stubs/felix/org/osgi/framework/ServicePermission.java",0,1,0,1,1
"java/stubs/felix/org/osgi/framework/ServiceReference.java",0,1,0,1,1
"java/stubs/felix/org/osgi/framework/ServiceRegistration.java",0,1,0,1,1
"java/stubs/felix/org/osgi/framework/SynchronousBundleListener.java",0,1,0,1,1
"java/stubs/felix/org/osgi/framework/Version.java",0,1,0,1,1
"java/stubs/jdbc3/java/sql/Array.java",0,1,0,1,1
"java/stubs/jdbc3/java/sql/BatchUpdateException.java",0,1,0,1,1
"java/stubs/jdbc3/java/sql/Blob.java",0,1,0,1,1
"java/stubs/jdbc3/java/sql/CallableStatement.java",0,1,0,1,1
"java/stubs/jdbc3/java/sql/Clob.java",0,1,0,1,1
"java/stubs/jdbc3/java/sql/Connection.java",0,1,0,1,1
"java/stubs/jdbc3/java/sql/DataTruncation.java",0,1,0,1,1
"java/stubs/jdbc3/java/sql/DatabaseMetaData.java",0,1,0,1,1
"java/stubs/jdbc3/java/sql/Date.java",0,1,0,1,1
"java/stubs/jdbc3/java/sql/Driver.java",0,1,0,1,1
"java/stubs/jdbc3/java/sql/DriverManager.java",0,1,0,1,1
"java/stubs/jdbc3/java/sql/DriverPropertyInfo.java",0,1,0,1,1
"java/stubs/jdbc3/java/sql/ParameterMetaData.java",0,1,0,1,1
"java/stubs/jdbc3/java/sql/PreparedStatement.java",0,1,0,1,1
"java/stubs/jdbc3/java/sql/Ref.java",0,1,0,1,1
"java/stubs/jdbc3/java/sql/ResultSet.java",0,1,0,1,1
"java/stubs/jdbc3/java/sql/ResultSetMetaData.java",0,1,0,1,1
"java/stubs/jdbc3/java/sql/SQLData.java",0,1,0,1,1
"java/stubs/jdbc3/java/sql/SQLException.java",0,1,0,1,1
"java/stubs/jdbc3/java/sql/SQLInput.java",0,1,0,1,1
"java/stubs/jdbc3/java/sql/SQLOutput.java",0,1,0,1,1
"java/stubs/jdbc3/java/sql/SQLPermission.java",0,1,0,1,1
"java/stubs/jdbc3/java/sql/SQLWarning.java",0,1,0,1,1
"java/stubs/jdbc3/java/sql/Savepoint.java",0,1,0,1,1
"java/stubs/jdbc3/java/sql/Statement.java",0,1,0,1,1
"java/stubs/jdbc3/java/sql/Struct.java",0,1,0,1,1
"java/stubs/jdbc3/java/sql/Time.java",0,1,0,1,1
"java/stubs/jdbc3/java/sql/Timestamp.java",0,0.996960486322188,1,1,2
"java/stubs/jdbc3/java/sql/Types.java",0,1,0,1,1
"java/stubs/jdbc3/javax/sql/ConnectionEvent.java",0,1,0,1,1
"java/stubs/jdbc3/javax/sql/ConnectionEventListener.java",0,1,0,1,1
"java/stubs/jdbc3/javax/sql/ConnectionPoolDataSource.java",0,1,0,1,1
"java/stubs/jdbc3/javax/sql/DataSource.java",0,1,0,1,1
"java/stubs/jdbc3/javax/sql/PooledConnection.java",0,1,0,1,1
"java/stubs/jdbc3/javax/sql/RowSet.java",0,1,0,1,1
"java/stubs/jdbc3/javax/sql/RowSetEvent.java",0,1,0,1,1
"java/stubs/jdbc3/javax/sql/RowSetInternal.java",0,1,0,1,1
"java/stubs/jdbc3/javax/sql/RowSetListener.java",0,1,0,1,1
"java/stubs/jdbc3/javax/sql/RowSetMetaData.java",0,1,0,1,1
"java/stubs/jdbc3/javax/sql/RowSetReader.java",0,1,0,1,1
"java/stubs/jdbc3/javax/sql/RowSetWriter.java",0,1,0,1,1
"java/stubs/jdbc3/javax/sql/XAConnection.java",0,1,0,1,1
"java/stubs/jdbc3/javax/sql/XADataSource.java",0,1,0,1,1
"java/stubs/jdbc4/java/sql/Array.java",0,1,0,1,1
"java/stubs/jdbc4/java/sql/BatchUpdateException.java",0,1,0,1,1
"java/stubs/jdbc4/java/sql/Blob.java",0,1,0,1,1
"java/stubs/jdbc4/java/sql/CallableStatement.java",0,1,0,1,1
"java/stubs/jdbc4/java/sql/ClientInfoStatus.java",0,1,0,1,1
"java/stubs/jdbc4/java/sql/Clob.java",0,1,0,1,1
"java/stubs/jdbc4/java/sql/Connection.java",0,1,0,1,1
"java/stubs/jdbc4/java/sql/DataTruncation.java",0,1,0,1,1
"java/stubs/jdbc4/java/sql/DatabaseMetaData.java",0,1,0,1,1
"java/stubs/jdbc4/java/sql/Date.java",0,1,0,1,1
"java/stubs/jdbc4/java/sql/Driver.java",0,1,0,1,1
"java/stubs/jdbc4/java/sql/DriverManager.java",0,1,0,1,1
"java/stubs/jdbc4/java/sql/DriverPropertyInfo.java",0,1,0,1,1
"java/stubs/jdbc4/java/sql/NClob.java",0,1,0,1,1
"java/stubs/jdbc4/java/sql/ParameterMetaData.java",0,1,0,1,1
"java/stubs/jdbc4/java/sql/PreparedStatement.java",0,1,0,1,1
"java/stubs/jdbc4/java/sql/Ref.java",0,1,0,1,1
"java/stubs/jdbc4/java/sql/ResultSet.java",0,1,0,1,1
"java/stubs/jdbc4/java/sql/ResultSetMetaData.java",0,1,0,1,1
"java/stubs/jdbc4/java/sql/RowId.java",0,1,0,1,1
"java/stubs/jdbc4/java/sql/RowIdLifetime.java",0,1,0,1,1
"java/stubs/jdbc4/java/sql/SQLClientInfoException.java",0,1,0,1,1
"java/stubs/jdbc4/java/sql/SQLData.java",0,1,0,1,1
"java/stubs/jdbc4/java/sql/SQLDataException.java",0,1,0,1,1
"java/stubs/jdbc4/java/sql/SQLException.java",0,1,0,1,1
"java/stubs/jdbc4/java/sql/SQLFeatureNotSupportedException.java",0,1,0,1,1
"java/stubs/jdbc4/java/sql/SQLInput.java",0,1,0,1,1
"java/stubs/jdbc4/java/sql/SQLIntegrityConstraintViolationException.java",0,1,0,1,1
"java/stubs/jdbc4/java/sql/SQLInvalidAuthorizationSpecException.java",0,1,0,1,1
"java/stubs/jdbc4/java/sql/SQLNonTransientConnectionException.java",0,1,0,1,1
"java/stubs/jdbc4/java/sql/SQLNonTransientException.java",0,1,0,1,1
"java/stubs/jdbc4/java/sql/SQLOutput.java",0,1,0,1,1
"java/stubs/jdbc4/java/sql/SQLPermission.java",0,1,0,1,1
"java/stubs/jdbc4/java/sql/SQLRecoverableException.java",0,1,0,1,1
"java/stubs/jdbc4/java/sql/SQLSyntaxErrorException.java",0,1,0,1,1
"java/stubs/jdbc4/java/sql/SQLTimeoutException.java",0,1,0,1,1
"java/stubs/jdbc4/java/sql/SQLTransactionRollbackException.java",0,1,0,1,1
"java/stubs/jdbc4/java/sql/SQLTransientConnectionException.java",0,1,0,1,1
"java/stubs/jdbc4/java/sql/SQLTransientException.java",0,1,0,1,1
"java/stubs/jdbc4/java/sql/SQLWarning.java",0,1,0,1,1
"java/stubs/jdbc4/java/sql/SQLXML.java",0,1,0,1,1
"java/stubs/jdbc4/java/sql/Savepoint.java",0,1,0,1,1
"java/stubs/jdbc4/java/sql/Statement.java",0,1,0,1,1
"java/stubs/jdbc4/java/sql/Struct.java",0,1,0,1,1
"java/stubs/jdbc4/java/sql/Time.java",0,1,0,1,1
"java/stubs/jdbc4/java/sql/Timestamp.java",0,1,0,1,1
"java/stubs/jdbc4/java/sql/Types.java",0,1,0,1,1
"java/stubs/jdbc4/java/sql/Wrapper.java",0,1,0,1,1
"java/stubs/jdbc4/javax/sql/CommonDataSource.java",0,1,0,1,1
"java/stubs/jdbc4/javax/sql/ConnectionEvent.java",0,1,0,1,1
"java/stubs/jdbc4/javax/sql/ConnectionEventListener.java",0,1,0,1,1
"java/stubs/jdbc4/javax/sql/ConnectionPoolDataSource.java",0,1,0,1,1
"java/stubs/jdbc4/javax/sql/DataSource.java",0,1,0,1,1
"java/stubs/jdbc4/javax/sql/PooledConnection.java",0,1,0,1,1
"java/stubs/jdbc4/javax/sql/RowSet.java",0,1,0,1,1
"java/stubs/jdbc4/javax/sql/RowSetEvent.java",0,1,0,1,1
"java/stubs/jdbc4/javax/sql/RowSetInternal.java",0,1,0,1,1
"java/stubs/jdbc4/javax/sql/RowSetListener.java",0,1,0,1,1
"java/stubs/jdbc4/javax/sql/RowSetMetaData.java",0,1,0,1,1
"java/stubs/jdbc4/javax/sql/RowSetReader.java",0,1,0,1,1
"java/stubs/jdbc4/javax/sql/RowSetWriter.java",0,1,0,1,1
"java/stubs/jdbc4/javax/sql/StatementEvent.java",0,1,0,1,1
"java/stubs/jdbc4/javax/sql/StatementEventListener.java",0,1,0,1,1
"java/stubs/jdbc4/javax/sql/XAConnection.java",0,1,0,1,1
"java/stubs/jdbc4/javax/sql/XADataSource.java",0,1,0,1,1
"java/stubs/jdbc4/javax/sql/rowset/BaseRowSet.java",0,1,0,1,1
"java/stubs/jdbc4/javax/sql/rowset/CachedRowSet.java",0,1,0,1,1
"java/stubs/jdbc4/javax/sql/rowset/FilteredRowSet.java",0,1,0,1,1
"java/stubs/jdbc4/javax/sql/rowset/JdbcRowSet.java",0,1,0,1,1
"java/stubs/jdbc4/javax/sql/rowset/JoinRowSet.java",0,1,0,1,1
"java/stubs/jdbc4/javax/sql/rowset/Joinable.java",0,1,0,1,1
"java/stubs/jdbc4/javax/sql/rowset/Predicate.java",0,1,0,1,1
"java/stubs/jdbc4/javax/sql/rowset/RowSetMetaDataImpl.java",0,1,0,1,1
"java/stubs/jdbc4/javax/sql/rowset/RowSetWarning.java",0,1,0,1,1
"java/stubs/jdbc4/javax/sql/rowset/WebRowSet.java",0,1,0,1,1
"java/stubs/jdbc4/javax/sql/rowset/serial/SQLInputImpl.java",0,1,0,1,1
"java/stubs/jdbc4/javax/sql/rowset/serial/SQLOutputImpl.java",0,1,0,1,1
"java/stubs/jdbc4/javax/sql/rowset/serial/SerialArray.java",0,1,0,1,1
"java/stubs/jdbc4/javax/sql/rowset/serial/SerialBlob.java",0,1,0,1,1
"java/stubs/jdbc4/javax/sql/rowset/serial/SerialClob.java",0,1,0,1,1
"java/stubs/jdbc4/javax/sql/rowset/serial/SerialDatalink.java",0,1,0,1,1
"java/stubs/jdbc4/javax/sql/rowset/serial/SerialException.java",0,1,0,1,1
"java/stubs/jdbc4/javax/sql/rowset/serial/SerialJavaObject.java",0,1,0,1,1
"java/stubs/jdbc4/javax/sql/rowset/serial/SerialRef.java",0,1,0,1,1
"java/stubs/jdbc4/javax/sql/rowset/serial/SerialStruct.java",0,1,0,1,1
"java/stubs/jdbc4/javax/sql/rowset/spi/SyncFactory.java",0,1,0,1,1
"java/stubs/jdbc4/javax/sql/rowset/spi/SyncFactoryException.java",0,1,0,1,1
"java/stubs/jdbc4/javax/sql/rowset/spi/SyncProvider.java",0,1,0,1,1
"java/stubs/jdbc4/javax/sql/rowset/spi/SyncProviderException.java",0,1,0,1,1
"java/stubs/jdbc4/javax/sql/rowset/spi/SyncResolver.java",0,1,0,1,1
"java/stubs/jdbc4/javax/sql/rowset/spi/TransactionalWriter.java",0,1,0,1,1
"java/stubs/jdbc4/javax/sql/rowset/spi/XmlReader.java",0,1,0,1,1
"java/stubs/jdbc4/javax/sql/rowset/spi/XmlWriter.java",0,1,0,1,1
"java/stubs/jsr169/java/sql/BatchUpdateException.java",0,1,0,1,1
"java/stubs/jsr169/java/sql/Blob.java",0,1,0,1,1
"java/stubs/jsr169/java/sql/CallableStatement.java",0,1,0,1,1
"java/stubs/jsr169/java/sql/Clob.java",0,1,0,1,1
"java/stubs/jsr169/java/sql/Connection.java",0,1,0,1,1
"java/stubs/jsr169/java/sql/DataTruncation.java",0,1,0,1,1
"java/stubs/jsr169/java/sql/DatabaseMetaData.java",0,1,0,1,1
"java/stubs/jsr169/java/sql/Date.java",0,1,0,1,1
"java/stubs/jsr169/java/sql/PreparedStatement.java",0,1,0,1,1
"java/stubs/jsr169/java/sql/ResultSet.java",0,1,0,1,1
"java/stubs/jsr169/java/sql/ResultSetMetaData.java",0,1,0,1,1
"java/stubs/jsr169/java/sql/SQLException.java",0,1,0,1,1
"java/stubs/jsr169/java/sql/SQLWarning.java",0,1,0,1,1
"java/stubs/jsr169/java/sql/Savepoint.java",0,1,0,1,1
"java/stubs/jsr169/java/sql/Statement.java",0,1,0,1,1
"java/stubs/jsr169/java/sql/Time.java",0,1,0,1,1
"java/stubs/jsr169/java/sql/Timestamp.java",0,0.997601918465228,1,1,2
"java/stubs/jsr169/java/sql/Types.java",0,1,0,1,1
"java/stubs/jsr169/javax/sql/DataSource.java",0,1,0,1,1
"java/stubs/jsr169/javax/sql/RowSet.java",0,1,0,1,1
"java/stubs/jsr169/javax/sql/RowSetEvent.java",0,1,0,1,1
"java/stubs/jsr169/javax/sql/RowSetInternal.java",0,1,0,1,1
"java/stubs/jsr169/javax/sql/RowSetListener.java",0,1,0,1,1
"java/stubs/jsr169/javax/sql/RowSetMetaData.java",0,1,0,1,1
"java/stubs/jsr169/javax/sql/RowSetReader.java",0,1,0,1,1
"java/stubs/jsr169/javax/sql/RowSetWriter.java",0,1,0,1,1
"java/testing/org/apache/derby/PackagePrivateTestSuite.java",0,1,0,1,1
"java/testing/org/apache/derby/client/am/LogicalStatementEntityTest.java",0,1,0,1,1
"java/testing/org/apache/derby/client/am/_Suite.java",0,1,0,1,1
"java/testing/org/apache/derby/impl/drda/ProtocolTest.java",0,0.99780701754386,1,1,2
"java/testing/org/apache/derby/impl/drda/_Suite.java",0,1,0,1,1
"java/testing/org/apache/derby/impl/jdbc/BiggerStoreStreamClobTest.java",0,1,0,1,1
"java/testing/org/apache/derby/impl/jdbc/BiggerTemporaryClobTest.java",0,0.987341772151899,1,1,2
"java/testing/org/apache/derby/impl/jdbc/InternalClobTest.java",0,1,0,1,1
"java/testing/org/apache/derby/impl/jdbc/SmallStoreStreamClobTest.java",0,1,0,1,1
"java/testing/org/apache/derby/impl/jdbc/SmallTemporaryClobTest.java",0,0.98780487804878,1,1,2
"java/testing/org/apache/derby/impl/jdbc/UTF8ReaderTest.java",0,1,0,1,1
"java/testing/org/apache/derby/impl/jdbc/_Suite.java",0,1,0,1,1
"java/testing/org/apache/derbyTesting/functionTests/harness/BackgroundStreamDrainer.java",0,0.954198473282443,1,1,2
"java/testing/org/apache/derbyTesting/functionTests/harness/BackgroundStreamSaver.java",0,0.931818181818182,0,2,2
"java/testing/org/apache/derbyTesting/functionTests/harness/CopySuppFiles.java",0,0.680412371134021,0,2,2
"java/testing/org/apache/derbyTesting/functionTests/harness/CurrentTime.java",0,0.869565217391304,0,2,2
"java/testing/org/apache/derbyTesting/functionTests/harness/FileCompare.java",0,0.844827586206897,2,3,5
"java/testing/org/apache/derbyTesting/functionTests/harness/GRFileFilter.java",0,0.888888888888889,0,2,2
"java/testing/org/apache/derbyTesting/functionTests/harness/GenerateReport.java",0,0.977464788732394,1,1,2
"java/testing/org/apache/derbyTesting/functionTests/harness/HandleResult.java",0,0.785714285714286,0,2,2
"java/testing/org/apache/derbyTesting/functionTests/harness/JavaVersionHolder.java",0,0.843971631205674,1,2,3
"java/testing/org/apache/derbyTesting/functionTests/harness/ManageSysProps.java",0,0.901639344262295,0,2,2
"java/testing/org/apache/derbyTesting/functionTests/harness/MultiTest.java",0,0.926666666666667,2,1,3
"java/testing/org/apache/derbyTesting/functionTests/harness/NetServer.java",0,0.819915254237288,2,2,4
"java/testing/org/apache/derbyTesting/functionTests/harness/ProcessStreamDrainer.java",0,0.941747572815534,0,2,2
"java/testing/org/apache/derbyTesting/functionTests/harness/ProcessStreamResult.java",0,0.521367521367521,1,3,4
"java/testing/org/apache/derbyTesting/functionTests/harness/PropertyUtil.java",0,0.959731543624161,1,1,2
"java/testing/org/apache/derbyTesting/functionTests/harness/RunClass.java",0,0.82089552238806,0,2,2
"java/testing/org/apache/derbyTesting/functionTests/harness/RunIJ.java",0,0.888888888888889,0,2,2
"java/testing/org/apache/derbyTesting/functionTests/harness/RunList.java",0,0.639569635385535,4,2,6
"java/testing/org/apache/derbyTesting/functionTests/harness/RunSuite.java",0,0.915841584158416,1,2,3
"java/testing/org/apache/derbyTesting/functionTests/harness/RunTest.java",0,0.70520039748261,7,2,9
"java/testing/org/apache/derbyTesting/functionTests/harness/Sed.java",0,0.477638640429338,4,3,7
"java/testing/org/apache/derbyTesting/functionTests/harness/SimpleDiff.java",0,0.984251968503937,1,1,2
"java/testing/org/apache/derbyTesting/functionTests/harness/SkipTest.java",0,0.898550724637681,0,2,2
"java/testing/org/apache/derbyTesting/functionTests/harness/SpecialFlags.java",0,0.944444444444444,2,1,3
"java/testing/org/apache/derbyTesting/functionTests/harness/SysInfoLog.java",0,0.939393939393939,1,2,3
"java/testing/org/apache/derbyTesting/functionTests/harness/TimedProcess.java",0,0.944954128440367,0,2,2
"java/testing/org/apache/derbyTesting/functionTests/harness/UnJar.java",0,0.941176470588235,0,2,2
"java/testing/org/apache/derbyTesting/functionTests/harness/currentjvm.java",0,0.944444444444444,0,2,2
"java/testing/org/apache/derbyTesting/functionTests/harness/dbcleanup.java",0,0.984210526315789,1,1,2
"java/testing/org/apache/derbyTesting/functionTests/harness/ibm13.java",0,0.938144329896907,0,2,2
"java/testing/org/apache/derbyTesting/functionTests/harness/ibm14.java",0,0.938144329896907,0,2,2
"java/testing/org/apache/derbyTesting/functionTests/harness/ibm15.java",0,1,0,1,1
"java/testing/org/apache/derbyTesting/functionTests/harness/ibm16.java",0,0.989795918367347,1,1,2
"java/testing/org/apache/derbyTesting/functionTests/harness/j9_13.java",0,0.955555555555556,1,1,2
"java/testing/org/apache/derbyTesting/functionTests/harness/j9_22.java",0,1,0,1,1
"java/testing/org/apache/derbyTesting/functionTests/harness/j9_foundation.java",0,0.899280575539568,1,2,3
"java/testing/org/apache/derbyTesting/functionTests/harness/j9_foundation11.java",0,1,0,1,1
"java/testing/org/apache/derbyTesting/functionTests/harness/j9dee15.java",0,1,0,1,1
"java/testing/org/apache/derbyTesting/functionTests/harness/jdk13.java",0,0.938144329896907,0,2,2
"java/testing/org/apache/derbyTesting/functionTests/harness/jdk14.java",0,0.938144329896907,0,2,2
"java/testing/org/apache/derbyTesting/functionTests/harness/jdk15.java",0,0.938144329896907,0,2,2
"java/testing/org/apache/derbyTesting/functionTests/harness/jdk16.java",0,0.933333333333333,0,2,2
"java/testing/org/apache/derbyTesting/functionTests/harness/jdk17.java",0,1,0,1,1
"java/testing/org/apache/derbyTesting/functionTests/harness/jvm.java",0,0.928400954653938,4,1,5
"java/testing/org/apache/derbyTesting/functionTests/harness/shutdown.java",0,0.94392523364486,0,2,2
"java/testing/org/apache/derbyTesting/functionTests/suites/All.java",0,0.883333333333333,0,2,2
"java/testing/org/apache/derbyTesting/functionTests/suites/AllPackages.java",0,0.801652892561983,3,2,5
"java/testing/org/apache/derbyTesting/functionTests/suites/EncryptionSuite.java",0,0.973451327433628,2,1,3
"java/testing/org/apache/derbyTesting/functionTests/suites/XMLSuite.java",0,0.964285714285714,1,1,2
"java/testing/org/apache/derbyTesting/functionTests/testData/serializedDataSources/SerializeDataSources.java",0,1,0,1,1
"java/testing/org/apache/derbyTesting/functionTests/tests/demo/CheckToursDBTest.java",0,1,0,1,1
"java/testing/org/apache/derbyTesting/functionTests/tests/demo/_Suite.java",0,1,0,1,1
"java/testing/org/apache/derbyTesting/functionTests/tests/derbynet/BadConnectionTest.java",0,0.88695652173913,1,2,3
"java/testing/org/apache/derbyTesting/functionTests/tests/derbynet/ByteArrayCombinerStreamTest.java",0,0.963855421686747,2,1,3
"java/testing/org/apache/derbyTesting/functionTests/tests/derbynet/CheckSecurityManager.java",0,0.589928057553957,1,2,3
"java/testing/org/apache/derbyTesting/functionTests/tests/derbynet/ClientSideSystemPropertiesTest.java",0,0.973451327433628,2,1,3
"java/testing/org/apache/derbyTesting/functionTests/tests/derbynet/DRDAProtocolTest.java",0,0.731182795698925,0,3,3
"java/testing/org/apache/derbyTesting/functionTests/tests/derbynet/DerbyNetAutoStart.java",0,0.978448275862069,2,1,3
"java/testing/org/apache/derbyTesting/functionTests/tests/derbynet/DerbyNetNewServer.java",0,0.879310344827586,2,2,4
"java/testing/org/apache/derbyTesting/functionTests/tests/derbynet/GetCurrentPropertiesTest.java",0,1,0,1,1
"java/testing/org/apache/derbyTesting/functionTests/tests/derbynet/LOBLocatorReleaseTest.java",0,1,0,1,1
"java/testing/org/apache/derbyTesting/functionTests/tests/derbynet/NSSecurityMechanismTest.java",0,0.896764252696456,2,2,4
"java/testing/org/apache/derbyTesting/functionTests/tests/derbynet/NSinSameJVMTest.java",0,0.552238805970149,0,2,2
"java/testing/org/apache/derbyTesting/functionTests/tests/derbynet/NetHarnessJavaTest.java",0,0.897196261682243,1,2,3
"java/testing/org/apache/derbyTesting/functionTests/tests/derbynet/NetIjTest.java",0,0.69811320754717,0,2,2
"java/testing/org/apache/derbyTesting/functionTests/tests/derbynet/NetworkServerControlApiTest.java",0,0.939739413680782,0,2,2
"java/testing/org/apache/derbyTesting/functionTests/tests/derbynet/NetworkServerControlClientCommandTest.java",0,0.793893129770992,1,2,3
"java/testing/org/apache/derbyTesting/functionTests/tests/derbynet/OutBufferedStreamTest.java",0,1,0,1,1
"java/testing/org/apache/derbyTesting/functionTests/tests/derbynet/PrepareStatementTest.java",0,0.91196388261851,6,1,7
"java/testing/org/apache/derbyTesting/functionTests/tests/derbynet/SSLTest.java",0,0.976331360946746,3,1,4
"java/testing/org/apache/derbyTesting/functionTests/tests/derbynet/SecureServerTest.java",0,0.861216730038023,2,3,5
"java/testing/org/apache/derbyTesting/functionTests/tests/derbynet/ServerPropertiesTest.java",0,0.99375,2,1,3
"java/testing/org/apache/derbyTesting/functionTests/tests/derbynet/ShutDownDBWhenNSShutsDownTest.java",0,0.588744588744589,1,2,3
"java/testing/org/apache/derbyTesting/functionTests/tests/derbynet/SqlExceptionTest.java",0,0.44311377245509,2,3,5
"java/testing/org/apache/derbyTesting/functionTests/tests/derbynet/SuicideOfStreamingTest.java",0,1,0,1,1
"java/testing/org/apache/derbyTesting/functionTests/tests/derbynet/SwitchablePrintStream.java",0,0.86046511627907,0,2,2
"java/testing/org/apache/derbyTesting/functionTests/tests/derbynet/SysinfoTest.java",0,1,0,1,1
"java/testing/org/apache/derbyTesting/functionTests/tests/derbynet/TestEnc.java",0,0.931818181818182,0,2,2
"java/testing/org/apache/derbyTesting/functionTests/tests/derbynet/_Suite.java",0,0.593406593406593,6,3,9
"java/testing/org/apache/derbyTesting/functionTests/tests/derbynet/dblook_test_net.java",0,0.898550724637681,1,2,3
"java/testing/org/apache/derbyTesting/functionTests/tests/derbynet/dblook_test_net_territory.java",0,1,0,1,1
"java/testing/org/apache/derbyTesting/functionTests/tests/derbynet/executeUpdate.java",0,0.897196261682243,1,2,3
"java/testing/org/apache/derbyTesting/functionTests/tests/derbynet/runtimeinfo.java",0,0.842857142857143,3,2,5
"java/testing/org/apache/derbyTesting/functionTests/tests/derbynet/testProtocol.java",0,1,0,1,1
"java/testing/org/apache/derbyTesting/functionTests/tests/engine/ErrorStreamTest.java",0,1,0,1,1
"java/testing/org/apache/derbyTesting/functionTests/tests/engine/_Suite.java",0,1,0,1,1
"java/testing/org/apache/derbyTesting/functionTests/tests/i18n/DefaultLocale.java",0,0.833333333333333,0,2,2
"java/testing/org/apache/derbyTesting/functionTests/tests/i18n/LocalizedAttributeScriptTest.java",0,0.994565217391304,1,1,2
"java/testing/org/apache/derbyTesting/functionTests/tests/i18n/LocalizedDisplayScriptTest.java",0,0.992592592592593,1,1,2
"java/testing/org/apache/derbyTesting/functionTests/tests/i18n/_Suite.java",0,1,0,1,1
"java/testing/org/apache/derbyTesting/functionTests/tests/jdbc4/BlobClobTestSetup.java",0,0.810344827586207,1,3,4
"java/testing/org/apache/derbyTesting/functionTests/tests/jdbc4/BlobSetMethodsTest.java",0,0.621761658031088,0,2,2
"java/testing/org/apache/derbyTesting/functionTests/tests/jdbc4/BlobTest.java",0,0.482291666666667,2,4,6
"java/testing/org/apache/derbyTesting/functionTests/tests/jdbc4/CallableStatementTest.java",0,0.766277128547579,1,2,3
"java/testing/org/apache/derbyTesting/functionTests/tests/jdbc4/CallableStatementTestSetup.java",0,0.962825278810409,1,1,2
"java/testing/org/apache/derbyTesting/functionTests/tests/jdbc4/ClobTest.java",0,0.35522664199815,3,4,7
"java/testing/org/apache/derbyTesting/functionTests/tests/jdbc4/ConnectionMethodsTest.java",0,1,0,1,1
"java/testing/org/apache/derbyTesting/functionTests/tests/jdbc4/ConnectionTest.java",0,0.808510638297872,0,3,3
"java/testing/org/apache/derbyTesting/functionTests/tests/jdbc4/DataSourceTest.java",0,0.559602649006622,1,3,4
"java/testing/org/apache/derbyTesting/functionTests/tests/jdbc4/Derby3650Test.java",0,0.80623973727422,0,2,2
"java/testing/org/apache/derbyTesting/functionTests/tests/jdbc4/JDBC40TranslationTest.java",0,0.829268292682927,1,2,3
"java/testing/org/apache/derbyTesting/functionTests/tests/jdbc4/JDBC4FromJDBC3DataSourceTest.java",0,0.980519480519481,1,1,2
"java/testing/org/apache/derbyTesting/functionTests/tests/jdbc4/LobStreamTest.java",0,0.927927927927928,0,2,2
"java/testing/org/apache/derbyTesting/functionTests/tests/jdbc4/ParameterMetaDataWrapperTest.java",0,0.669811320754717,0,3,3
"java/testing/org/apache/derbyTesting/functionTests/tests/jdbc4/PreparedStatementTest.java",0,0.705245628642798,2,2,4
"java/testing/org/apache/derbyTesting/functionTests/tests/jdbc4/ResultSetMetaDataTest.java",0,0.691588785046729,0,3,3
"java/testing/org/apache/derbyTesting/functionTests/tests/jdbc4/ResultSetTest.java",0,0.598477157360406,0,4,4
"java/testing/org/apache/derbyTesting/functionTests/tests/jdbc4/RowIdNotImplementedTest.java",0,0.962962962962963,2,1,3
"java/testing/org/apache/derbyTesting/functionTests/tests/jdbc4/SetObjectUnsupportedTest.java",0,0.986175115207373,1,1,2
"java/testing/org/apache/derbyTesting/functionTests/tests/jdbc4/StatementEventsTest.java",0,0.862332695984704,2,2,4
"java/testing/org/apache/derbyTesting/functionTests/tests/jdbc4/StatementTest.java",0,0.678571428571429,2,3,5
"java/testing/org/apache/derbyTesting/functionTests/tests/jdbc4/StatementTestSetup.java",0,0.851485148514851,0,3,3
"java/testing/org/apache/derbyTesting/functionTests/tests/jdbc4/StreamTruncationTest.java",0,1,0,1,1
"java/testing/org/apache/derbyTesting/functionTests/tests/jdbc4/TestDbMetaData.java",0,0.729241877256318,0,4,4
"java/testing/org/apache/derbyTesting/functionTests/tests/jdbc4/TestJDBC40Exception.java",0,0.422619047619048,0,3,3
"java/testing/org/apache/derbyTesting/functionTests/tests/jdbc4/UnsupportedVetter.java",0,0.953424657534247,2,1,3
"java/testing/org/apache/derbyTesting/functionTests/tests/jdbc4/VerifySignatures.java",0,0.850098619329389,1,2,3
"java/testing/org/apache/derbyTesting/functionTests/tests/jdbc4/XA40Test.java",0,0.946808510638298,2,1,3
"java/testing/org/apache/derbyTesting/functionTests/tests/jdbc4/_Suite.java",0,0.871794871794872,4,2,6
"java/testing/org/apache/derbyTesting/functionTests/tests/jdbcapi/AIjdbcTest.java",0,1,0,1,1
"java/testing/org/apache/derbyTesting/functionTests/tests/jdbcapi/AssertEventCatcher.java",0,1,0,1,1
"java/testing/org/apache/derbyTesting/functionTests/tests/jdbcapi/AuthenticationTest.java",0,0.578676470588235,2,2,4
"java/testing/org/apache/derbyTesting/functionTests/tests/jdbcapi/AutoGenJDBC30Test.java",0,0.71188717259906,1,3,4
"java/testing/org/apache/derbyTesting/functionTests/tests/jdbcapi/AutoloadTest.java",0,0.997658079625293,1,1,2
"java/testing/org/apache/derbyTesting/functionTests/tests/jdbcapi/BLOBDataModelSetup.java",0,0.882758620689655,1,2,3
"java/testing/org/apache/derbyTesting/functionTests/tests/jdbcapi/BLOBTest.java",0,0.925675675675676,1,2,3
"java/testing/org/apache/derbyTesting/functionTests/tests/jdbcapi/BatchUpdateTest.java",0,0.883858267716535,3,2,5
"java/testing/org/apache/derbyTesting/functionTests/tests/jdbcapi/BlobClob4BlobTest.java",0,0.867291844273941,7,2,9
"java/testing/org/apache/derbyTesting/functionTests/tests/jdbcapi/BlobStoredProcedureTest.java",0,0.929347826086957,3,1,4
"java/testing/org/apache/derbyTesting/functionTests/tests/jdbcapi/BlobUpdatableStreamTest.java",0,0.990196078431373,1,1,2
"java/testing/org/apache/derbyTesting/functionTests/tests/jdbcapi/CacheSessionDataTest.java",0,1,0,1,1
"java/testing/org/apache/derbyTesting/functionTests/tests/jdbcapi/CallableTest.java",0,0.974358974358974,2,1,3
"java/testing/org/apache/derbyTesting/functionTests/tests/jdbcapi/CharacterStreamsTest.java",0,0.928042328042328,0,2,2
"java/testing/org/apache/derbyTesting/functionTests/tests/jdbcapi/ClientConnectionPoolDataSourceTest.java",0,1,0,1,1
"java/testing/org/apache/derbyTesting/functionTests/tests/jdbcapi/ClobStoredProcedureTest.java",0,0.968481375358166,4,1,5
"java/testing/org/apache/derbyTesting/functionTests/tests/jdbcapi/ClobTest.java",0,1,0,1,1
"java/testing/org/apache/derbyTesting/functionTests/tests/jdbcapi/ClobTruncateTest.java",0,1,0,1,1
"java/testing/org/apache/derbyTesting/functionTests/tests/jdbcapi/ClobUpdatableReaderTest.java",0,0.983922829581994,2,1,3
"java/testing/org/apache/derbyTesting/functionTests/tests/jdbcapi/ClosedObjectTest.java",0,0.944303797468354,3,1,4
"java/testing/org/apache/derbyTesting/functionTests/tests/jdbcapi/Compat_BlobClob4BlobTest.java",0,1,0,1,1
"java/testing/org/apache/derbyTesting/functionTests/tests/jdbcapi/ConcurrencyTest.java",0,0.791620727673649,3,2,5
"java/testing/org/apache/derbyTesting/functionTests/tests/jdbcapi/DMDBugsTest.java",0,0.989690721649485,1,1,2
"java/testing/org/apache/derbyTesting/functionTests/tests/jdbcapi/DSCreateShutdownDBTest.java",0,1,0,1,1
"java/testing/org/apache/derbyTesting/functionTests/tests/jdbcapi/DataSourcePropertiesTest.java",0,0.75,0,2,2
"java/testing/org/apache/derbyTesting/functionTests/tests/jdbcapi/DataSourceReferenceTest.java",0,0.853372434017595,0,2,2
"java/testing/org/apache/derbyTesting/functionTests/tests/jdbcapi/DataSourceSerializationTest.java",0,1,0,1,1
"java/testing/org/apache/derbyTesting/functionTests/tests/jdbcapi/DataSourceTest.java",0,0.983850931677019,2,1,3
"java/testing/org/apache/derbyTesting/functionTests/tests/jdbcapi/DatabaseMetaDataTest.java",0,0.557471264367816,5,3,8
"java/testing/org/apache/derbyTesting/functionTests/tests/jdbcapi/DboPowersTest.java",0,0.690566037735849,2,2,4
"java/testing/org/apache/derbyTesting/functionTests/tests/jdbcapi/DriverMgrAuthenticationTest.java",0,0.992156862745098,1,1,2
"java/testing/org/apache/derbyTesting/functionTests/tests/jdbcapi/DriverTest.java",0,0.967576791808874,3,1,4
"java/testing/org/apache/derbyTesting/functionTests/tests/jdbcapi/HoldabilityTest.java",0,0.730645161290323,2,3,5
"java/testing/org/apache/derbyTesting/functionTests/tests/jdbcapi/InternationalConnectSimpleDSTest.java",0,1,0,1,1
"java/testing/org/apache/derbyTesting/functionTests/tests/jdbcapi/InternationalConnectTest.java",0,1,0,1,1
"java/testing/org/apache/derbyTesting/functionTests/tests/jdbcapi/InvalidLDAPServerAuthenticationTest.java",0,1,0,1,1
"java/testing/org/apache/derbyTesting/functionTests/tests/jdbcapi/J2EEDataSourceTest.java",0,0.892831105710814,2,2,4
"java/testing/org/apache/derbyTesting/functionTests/tests/jdbcapi/JDBCDriversAllTest.java",0,1,0,1,1
"java/testing/org/apache/derbyTesting/functionTests/tests/jdbcapi/JDBCDriversClientTest.java",0,1,0,1,1
"java/testing/org/apache/derbyTesting/functionTests/tests/jdbcapi/JDBCDriversEmbeddedTest.java",0,1,0,1,1
"java/testing/org/apache/derbyTesting/functionTests/tests/jdbcapi/JDBCDriversPropertyTest.java",0,0.985714285714286,1,1,2
"java/testing/org/apache/derbyTesting/functionTests/tests/jdbcapi/JDBCHarnessJavaTest.java",0,0.988372093023256,1,1,2
"java/testing/org/apache/derbyTesting/functionTests/tests/jdbcapi/LDAPAuthenticationTest.java",0,1,0,1,1
"java/testing/org/apache/derbyTesting/functionTests/tests/jdbcapi/LargeDataLocksTest.java",0,0.962085308056872,1,1,2
"java/testing/org/apache/derbyTesting/functionTests/tests/jdbcapi/LobLengthTest.java",0,0.909090909090909,1,2,3
"java/testing/org/apache/derbyTesting/functionTests/tests/jdbcapi/LobStreamsTest.java",0,0.9,3,1,4
"java/testing/org/apache/derbyTesting/functionTests/tests/jdbcapi/NullSQLTextTest.java",0,1,0,1,1
"java/testing/org/apache/derbyTesting/functionTests/tests/jdbcapi/ParameterMappingTest.java",0,0.995516877637131,1,1,2
"java/testing/org/apache/derbyTesting/functionTests/tests/jdbcapi/ParameterMetaDataJdbc30Test.java",0,1,0,1,1
"java/testing/org/apache/derbyTesting/functionTests/tests/jdbcapi/PoolDSAuthenticationTest.java",0,0.949090909090909,0,2,2
"java/testing/org/apache/derbyTesting/functionTests/tests/jdbcapi/PoolXADSCreateShutdownDBTest.java",0,1,0,1,1
"java/testing/org/apache/derbyTesting/functionTests/tests/jdbcapi/PrepStmtMetaDataTest.java",0,0.93048128342246,0,2,2
"java/testing/org/apache/derbyTesting/functionTests/tests/jdbcapi/PrepStmtNullTest.java",0,1,0,1,1
"java/testing/org/apache/derbyTesting/functionTests/tests/jdbcapi/ProcedureTest.java",0,0.579406631762653,1,3,4
"java/testing/org/apache/derbyTesting/functionTests/tests/jdbcapi/RelativeTest.java",0,1,0,1,1
"java/testing/org/apache/derbyTesting/functionTests/tests/jdbcapi/ResultSetCloseTest.java",0,0.742424242424242,1,3,4
"java/testing/org/apache/derbyTesting/functionTests/tests/jdbcapi/ResultSetJDBC30Test.java",0,1,0,1,1
"java/testing/org/apache/derbyTesting/functionTests/tests/jdbcapi/ResultSetMiscTest.java",0,1,0,1,1
"java/testing/org/apache/derbyTesting/functionTests/tests/jdbcapi/ResultSetStreamTest.java",0,0.859405940594059,0,2,2
"java/testing/org/apache/derbyTesting/functionTests/tests/jdbcapi/SURBaseTest.java",0,0.796363636363636,2,3,5
"java/testing/org/apache/derbyTesting/functionTests/tests/jdbcapi/SURDataModelSetup.java",0,0.799163179916318,1,3,4
"java/testing/org/apache/derbyTesting/functionTests/tests/jdbcapi/SURQueryMixTest.java",0,0.913344887348354,5,1,6
"java/testing/org/apache/derbyTesting/functionTests/tests/jdbcapi/SURTest.java",0,0.506180469715698,2,5,7
"java/testing/org/apache/derbyTesting/functionTests/tests/jdbcapi/SURijTest.java",0,1,0,1,1
"java/testing/org/apache/derbyTesting/functionTests/tests/jdbcapi/SavepointJdbc30Test.java",0,0.999137931034483,1,1,2
"java/testing/org/apache/derbyTesting/functionTests/tests/jdbcapi/ScrollResultSetTest.java",0,0.771604938271605,2,2,4
"java/testing/org/apache/derbyTesting/functionTests/tests/jdbcapi/SetQueryTimeoutTest.java",0,0.707096774193548,2,3,5
"java/testing/org/apache/derbyTesting/functionTests/tests/jdbcapi/SetTransactionIsolationTest.java",0,0.929530201342282,0,2,2
"java/testing/org/apache/derbyTesting/functionTests/tests/jdbcapi/StatementJdbc20Test.java",0,1,0,1,1
"java/testing/org/apache/derbyTesting/functionTests/tests/jdbcapi/StatementJdbc30Test.java",0,0.854227405247813,1,2,3
"java/testing/org/apache/derbyTesting/functionTests/tests/jdbcapi/StatementPoolingTest.java",0,0.995402298850575,1,1,2
"java/testing/org/apache/derbyTesting/functionTests/tests/jdbcapi/StreamTest.java",0,0.976470588235294,1,1,2
"java/testing/org/apache/derbyTesting/functionTests/tests/jdbcapi/URCoveringIndexTest.java",0,0.857142857142857,1,2,3
"java/testing/org/apache/derbyTesting/functionTests/tests/jdbcapi/UpdatableResultSetTest.java",0,0.966804979253112,2,1,3
"java/testing/org/apache/derbyTesting/functionTests/tests/jdbcapi/UpdateXXXTest.java",0,0.684807256235828,2,2,4
"java/testing/org/apache/derbyTesting/functionTests/tests/jdbcapi/XADSAuthenticationTest.java",0,0.945054945054945,0,2,2
"java/testing/org/apache/derbyTesting/functionTests/tests/jdbcapi/XAJNDITest.java",0,0.897560975609756,0,2,2
"java/testing/org/apache/derbyTesting/functionTests/tests/jdbcapi/XATest.java",0,0.821984435797665,1,2,3
"java/testing/org/apache/derbyTesting/functionTests/tests/jdbcapi/XATransactionTest.java",0,0.785714285714286,0,3,3
"java/testing/org/apache/derbyTesting/functionTests/tests/jdbcapi/_Suite.java",0,0.395209580838323,4,4,8
"java/testing/org/apache/derbyTesting/functionTests/tests/jdbcapi/connectionJdbc20.java",0,0.870860927152318,2,2,4
"java/testing/org/apache/derbyTesting/functionTests/tests/jdbcapi/derbyStress.java",0,0.862068965517241,1,2,3
"java/testing/org/apache/derbyTesting/functionTests/tests/jdbcapi/maxfieldsize.java",0,0.941358024691358,2,1,3
"java/testing/org/apache/derbyTesting/functionTests/tests/jdbcapi/metadataMultiConnTest.java",0,1,0,1,1
"java/testing/org/apache/derbyTesting/functionTests/tests/jdbcapi/resultsetJdbc20.java",0,0.896825396825397,0,2,2
"java/testing/org/apache/derbyTesting/functionTests/tests/jdbcapi/rsgetXXXcolumnNames.java",0,0.75,1,2,3
"java/testing/org/apache/derbyTesting/functionTests/tests/junitTests/compatibility/BLOBCLOB_CompatibilitySuite.java",0,1,0,1,1
"java/testing/org/apache/derbyTesting/functionTests/tests/junitTests/compatibility/CompatibilityCombinations.java",0,0.917227456258412,0,2,2
"java/testing/org/apache/derbyTesting/functionTests/tests/junitTests/compatibility/CompatibilitySuite.java",0,0.857685009487666,2,2,4
"java/testing/org/apache/derbyTesting/functionTests/tests/junitTests/compatibility/JDBCDriverTest.java",0,0.691729323308271,1,2,3
"java/testing/org/apache/derbyTesting/functionTests/tests/junitTests/compatibility/Pinger.java",0,0.954198473282443,1,1,2
"java/testing/org/apache/derbyTesting/functionTests/tests/junitTests/derbyNet/CompatibilityTest.java",0,0.9125,1,2,3
"java/testing/org/apache/derbyTesting/functionTests/tests/lang/AggregateClassLoadingTest.java",0,1,0,1,1
"java/testing/org/apache/derbyTesting/functionTests/tests/lang/AlterColumnTest.java",0,1,0,1,1
"java/testing/org/apache/derbyTesting/functionTests/tests/lang/AnsiSignatures.java",0,1,0,1,1
"java/testing/org/apache/derbyTesting/functionTests/tests/lang/AnsiSignaturesTest.java",0,1,0,1,1
"java/testing/org/apache/derbyTesting/functionTests/tests/lang/AnsiTrimTest.java",0,0.919811320754717,0,2,2
"java/testing/org/apache/derbyTesting/functionTests/tests/lang/ArithmeticTest.java",0,1,0,1,1
"java/testing/org/apache/derbyTesting/functionTests/tests/lang/BigDataTest.java",0,1,0,1,1
"java/testing/org/apache/derbyTesting/functionTests/tests/lang/Bug4356Test.java",0,1,0,1,1
"java/testing/org/apache/derbyTesting/functionTests/tests/lang/Bug5052rtsTest.java",0,0.979310344827586,1,1,2
"java/testing/org/apache/derbyTesting/functionTests/tests/lang/Bug5054Test.java",0,1,0,1,1
"java/testing/org/apache/derbyTesting/functionTests/tests/lang/CaseExpressionTest.java",0,0.729885057471264,0,3,3
"java/testing/org/apache/derbyTesting/functionTests/tests/lang/CastingTest.java",0,0.960725075528701,3,1,4
"java/testing/org/apache/derbyTesting/functionTests/tests/lang/CharUTF8Test.java",0,1,0,1,1
"java/testing/org/apache/derbyTesting/functionTests/tests/lang/CoalesceTest.java",0,0.965964343598055,2,1,3
"java/testing/org/apache/derbyTesting/functionTests/tests/lang/CollationTest.java",0,0.671490593342981,4,3,7
"java/testing/org/apache/derbyTesting/functionTests/tests/lang/CollationTest2.java",0,0.878149100257069,4,2,6
"java/testing/org/apache/derbyTesting/functionTests/tests/lang/CommentTest.java",0,0.894366197183099,1,2,3
"java/testing/org/apache/derbyTesting/functionTests/tests/lang/CompressTableTest.java",0,1,0,1,1
"java/testing/org/apache/derbyTesting/functionTests/tests/lang/ConcurrentImplicitCreateSchema.java",0,0.968911917098446,1,1,2
"java/testing/org/apache/derbyTesting/functionTests/tests/lang/ConglomerateSharingTest.java",0,1,0,1,1
"java/testing/org/apache/derbyTesting/functionTests/tests/lang/ConnectTest.java",0,1,0,1,1
"java/testing/org/apache/derbyTesting/functionTests/tests/lang/ConstantExpressionTest.java",0,1,0,1,1
"java/testing/org/apache/derbyTesting/functionTests/tests/lang/CreateTableFromQueryTest.java",0,0.904907975460123,1,2,3
"java/testing/org/apache/derbyTesting/functionTests/tests/lang/CurrentOfTest.java",0,0.929356357927786,0,2,2
"java/testing/org/apache/derbyTesting/functionTests/tests/lang/CursorTest.java",0,0.792372881355932,0,2,2
"java/testing/org/apache/derbyTesting/functionTests/tests/lang/DBInJarTest.java",0,1,0,1,1
"java/testing/org/apache/derbyTesting/functionTests/tests/lang/DatabaseClassLoadingTest.java",0,0.911620294599018,1,2,3
"java/testing/org/apache/derbyTesting/functionTests/tests/lang/DateTimeTest.java",0,1,0,1,1
"java/testing/org/apache/derbyTesting/functionTests/tests/lang/DeadlockModeTest.java",0,1,0,1,1
"java/testing/org/apache/derbyTesting/functionTests/tests/lang/DeclareGlobalTempTableJavaTest.java",0,1,0,1,1
"java/testing/org/apache/derbyTesting/functionTests/tests/lang/DistinctTest.java",0,0.962962962962963,3,1,4
"java/testing/org/apache/derbyTesting/functionTests/tests/lang/DynamicLikeOptimizationTest.java",0,0.984455958549223,1,1,2
"java/testing/org/apache/derbyTesting/functionTests/tests/lang/ErrorCodeTest.java",0,0.961089494163424,5,1,6
"java/testing/org/apache/derbyTesting/functionTests/tests/lang/ErrorMessageTest.java",0,1,0,1,1
"java/testing/org/apache/derbyTesting/functionTests/tests/lang/ExistsWithSubqueriesTest.java",0,0.699815837937385,0,2,2
"java/testing/org/apache/derbyTesting/functionTests/tests/lang/ForBitDataTest.java",0,0.985407725321888,2,1,3
"java/testing/org/apache/derbyTesting/functionTests/tests/lang/ForUpdateTest.java",0,0.901204819277108,1,2,3
"java/testing/org/apache/derbyTesting/functionTests/tests/lang/FullCollationTests.java",0,1,0,1,1
"java/testing/org/apache/derbyTesting/functionTests/tests/lang/GeneratedColumnsHelper.java",0,1,0,1,1
"java/testing/org/apache/derbyTesting/functionTests/tests/lang/GeneratedColumnsPermsTest.java",0,1,0,1,1
"java/testing/org/apache/derbyTesting/functionTests/tests/lang/GeneratedColumnsTest.java",0,1,0,1,1
"java/testing/org/apache/derbyTesting/functionTests/tests/lang/GetPropertyInfoTest.java",0,0.840579710144927,0,2,2
"java/testing/org/apache/derbyTesting/functionTests/tests/lang/GrantRevokeDDLTest.java",0,0.939313203078745,7,1,8
"java/testing/org/apache/derbyTesting/functionTests/tests/lang/GrantRevokeTest.java",0,0.943973941368078,5,1,6
"java/testing/org/apache/derbyTesting/functionTests/tests/lang/GroupByExpressionTest.java",0,0.63179347826087,3,2,5
"java/testing/org/apache/derbyTesting/functionTests/tests/lang/GroupByTest.java",0,0.733748886910062,6,2,8
"java/testing/org/apache/derbyTesting/functionTests/tests/lang/HoldCursorTest.java",0,0.997566909975669,1,1,2
"java/testing/org/apache/derbyTesting/functionTests/tests/lang/InListMultiProbeTest.java",0,0.963296844816484,2,1,3
"java/testing/org/apache/derbyTesting/functionTests/tests/lang/JitTest.java",0,0.968253968253968,1,1,2
"java/testing/org/apache/derbyTesting/functionTests/tests/lang/LangHarnessJavaTest.java",0,0.849206349206349,2,2,4
"java/testing/org/apache/derbyTesting/functionTests/tests/lang/LangProcedureTest.java",0,0.888065843621399,2,2,4
"java/testing/org/apache/derbyTesting/functionTests/tests/lang/LangScripts.java",0,0.95625,2,1,3
"java/testing/org/apache/derbyTesting/functionTests/tests/lang/LazyDefaultSchemaCreationTest.java",0,0.78961038961039,0,2,2
"java/testing/org/apache/derbyTesting/functionTests/tests/lang/MathTrigFunctionsTest.java",0,1,0,1,1
"java/testing/org/apache/derbyTesting/functionTests/tests/lang/MiscErrorsTest.java",0,1,0,1,1
"java/testing/org/apache/derbyTesting/functionTests/tests/lang/MixedCaseExpressionTest.java",0,1,0,1,1
"java/testing/org/apache/derbyTesting/functionTests/tests/lang/NestedWhereSubqueryTest.java",0,1,0,1,1
"java/testing/org/apache/derbyTesting/functionTests/tests/lang/NullIfTest.java",0,0.980519480519481,1,1,2
"java/testing/org/apache/derbyTesting/functionTests/tests/lang/NullableUniqueConstraintTest.java",0,0.868761552680222,0,2,2
"java/testing/org/apache/derbyTesting/functionTests/tests/lang/NullsTest.java",0,1,0,1,1
"java/testing/org/apache/derbyTesting/functionTests/tests/lang/OLAPTest.java",0,0.560830860534125,1,2,3
"java/testing/org/apache/derbyTesting/functionTests/tests/lang/OffsetFetchNextTest.java",0,1,0,1,1
"java/testing/org/apache/derbyTesting/functionTests/tests/lang/OptimizerOverridesTest.java",0,1,0,1,1
"java/testing/org/apache/derbyTesting/functionTests/tests/lang/PrecedenceTest.java",0,1,0,1,1
"java/testing/org/apache/derbyTesting/functionTests/tests/lang/PredicatePushdownTest.java",0,1,0,1,1
"java/testing/org/apache/derbyTesting/functionTests/tests/lang/PrepareExecuteDDL.java",0,0.898148148148148,0,2,2
"java/testing/org/apache/derbyTesting/functionTests/tests/lang/PrimaryKeyTest.java",0,0.992779783393502,1,1,2
"java/testing/org/apache/derbyTesting/functionTests/tests/lang/ProcedureInTriggerTest.java",0,0.97997138769671,1,1,2
"java/testing/org/apache/derbyTesting/functionTests/tests/lang/ReferentialActionsTest.java",0,1,0,1,1
"java/testing/org/apache/derbyTesting/functionTests/tests/lang/ReleaseCompileLocksTest.java",0,0.735177865612648,0,3,3
"java/testing/org/apache/derbyTesting/functionTests/tests/lang/RenameIndexTest.java",0,1,0,1,1
"java/testing/org/apache/derbyTesting/functionTests/tests/lang/RenameTableTest.java",0,1,0,1,1
"java/testing/org/apache/derbyTesting/functionTests/tests/lang/ResultSetsFromPreparedStatementTest.java",0,0.958313817330211,5,1,6
"java/testing/org/apache/derbyTesting/functionTests/tests/lang/RolesConferredPrivilegesTest.java",0,0.993348115299335,1,1,2
"java/testing/org/apache/derbyTesting/functionTests/tests/lang/RolesTest.java",0,0.994720965309201,2,1,3
"java/testing/org/apache/derbyTesting/functionTests/tests/lang/RoutineSecurityTest.java",0,1,0,1,1
"java/testing/org/apache/derbyTesting/functionTests/tests/lang/RoutineTest.java",0,0.57593984962406,0,3,3
"java/testing/org/apache/derbyTesting/functionTests/tests/lang/SQLAuthorizationPropTest.java",0,0.925287356321839,0,2,2
"java/testing/org/apache/derbyTesting/functionTests/tests/lang/SQLSessionContextTest.java",0,1,0,1,1
"java/testing/org/apache/derbyTesting/functionTests/tests/lang/ScrollCursors1Test.java",0,0.998643147896879,1,1,2
"java/testing/org/apache/derbyTesting/functionTests/tests/lang/ScrollCursors2Test.java",0,0.956636005256242,1,1,2
"java/testing/org/apache/derbyTesting/functionTests/tests/lang/SecurityPolicyReloadingTest.java",0,0.990498812351544,2,1,3
"java/testing/org/apache/derbyTesting/functionTests/tests/lang/SelectivityTest.java",0,1,0,1,1
"java/testing/org/apache/derbyTesting/functionTests/tests/lang/ShutdownDatabase.java",0,0.973886328725038,1,1,2
"java/testing/org/apache/derbyTesting/functionTests/tests/lang/ShutdownDatabaseTest.java",0,0.996376811594203,1,1,2
"java/testing/org/apache/derbyTesting/functionTests/tests/lang/SimpleTest.java",0,1,0,1,1
"java/testing/org/apache/derbyTesting/functionTests/tests/lang/SpillHashTest.java",0,1,0,1,1
"java/testing/org/apache/derbyTesting/functionTests/tests/lang/StalePlansTest.java",0,0.996742671009772,1,1,2
"java/testing/org/apache/derbyTesting/functionTests/tests/lang/StatementPlanCacheTest.java",0,0.994152046783626,1,1,2
"java/testing/org/apache/derbyTesting/functionTests/tests/lang/StreamsTest.java",0,0.938118811881188,1,2,3
"java/testing/org/apache/derbyTesting/functionTests/tests/lang/StringArrayVTI.java",0,1,0,1,1
"java/testing/org/apache/derbyTesting/functionTests/tests/lang/StringColumnVTI.java",0,1,0,1,1
"java/testing/org/apache/derbyTesting/functionTests/tests/lang/SynonymTest.java",0,1,0,1,1
"java/testing/org/apache/derbyTesting/functionTests/tests/lang/SysDiagVTIMappingTest.java",0,0.91375,4,1,5
"java/testing/org/apache/derbyTesting/functionTests/tests/lang/SystemCatalogTest.java",0,0.983870967741935,1,1,2
"java/testing/org/apache/derbyTesting/functionTests/tests/lang/TableFunctionTest.java",0,0.973226238286479,5,1,6
"java/testing/org/apache/derbyTesting/functionTests/tests/lang/TableVTI.java",0,0.998639455782313,1,1,2
"java/testing/org/apache/derbyTesting/functionTests/tests/lang/TimeHandlingTest.java",0,0.992654774396642,3,1,4
"java/testing/org/apache/derbyTesting/functionTests/tests/lang/TimestampArithTest.java",0,1,0,1,1
"java/testing/org/apache/derbyTesting/functionTests/tests/lang/TriggerTest.java",0,0.639494026704146,4,2,6
"java/testing/org/apache/derbyTesting/functionTests/tests/lang/TruncateTableTest.java",0,1,0,1,1
"java/testing/org/apache/derbyTesting/functionTests/tests/lang/UnaryArithmeticParameterTest.java",0,1,0,1,1
"java/testing/org/apache/derbyTesting/functionTests/tests/lang/UngroupedAggregatesNegativeTest.java",0,1,0,1,1
"java/testing/org/apache/derbyTesting/functionTests/tests/lang/UniqueConstraintSetNullTest.java",0,1,0,1,1
"java/testing/org/apache/derbyTesting/functionTests/tests/lang/UpdatableResultSetTest.java",0,0.986211424819435,4,1,5
"java/testing/org/apache/derbyTesting/functionTests/tests/lang/UpdateCursorTest.java",0,0.982608695652174,1,1,2
"java/testing/org/apache/derbyTesting/functionTests/tests/lang/UpdateStatisticsTest.java",0,1,0,1,1
"java/testing/org/apache/derbyTesting/functionTests/tests/lang/UserLobTest.java",0,1,0,1,1
"java/testing/org/apache/derbyTesting/functionTests/tests/lang/VTITest.java",0,0.740384615384615,1,2,3
"java/testing/org/apache/derbyTesting/functionTests/tests/lang/ViewsTest.java",0,0.963244613434727,1,1,2
"java/testing/org/apache/derbyTesting/functionTests/tests/lang/WISCInsert.java",0,0.972477064220184,1,1,2
"java/testing/org/apache/derbyTesting/functionTests/tests/lang/WarehouseVTI.java",0,1,0,1,1
"java/testing/org/apache/derbyTesting/functionTests/tests/lang/WiscMetaData.java",0,0.958041958041958,1,1,2
"java/testing/org/apache/derbyTesting/functionTests/tests/lang/WiscVTI.java",0,0.976744186046512,1,1,2
"java/testing/org/apache/derbyTesting/functionTests/tests/lang/XMLBindingTest.java",0,1,0,1,1
"java/testing/org/apache/derbyTesting/functionTests/tests/lang/XMLMissingClassesTest.java",0,1,0,1,1
"java/testing/org/apache/derbyTesting/functionTests/tests/lang/XMLTypeAndOpsTest.java",0,0.992,5,1,6
"java/testing/org/apache/derbyTesting/functionTests/tests/lang/_Suite.java",0,0.457894736842105,11,4,15
"java/testing/org/apache/derbyTesting/functionTests/tests/lang/concateTests.java",0,0.935222672064777,2,2,4
"java/testing/org/apache/derbyTesting/functionTests/tests/lang/dbManagerLimits.java",0,0.974803149606299,2,1,3
"java/testing/org/apache/derbyTesting/functionTests/tests/lang/dbjarUtil.java",0,0.955882352941177,1,1,2
"java/testing/org/apache/derbyTesting/functionTests/tests/lang/declareGlobalTempTableJavaJDBC30.java",0,0.991754122938531,2,1,3
"java/testing/org/apache/derbyTesting/functionTests/tests/lang/largeCodeGen.java",0,0.73444976076555,2,2,4
"java/testing/org/apache/derbyTesting/functionTests/tests/lang/maxMemPerTab.java",0,0.96078431372549,1,1,2
"java/testing/org/apache/derbyTesting/functionTests/tests/lang/outparams.java",0,0.854545454545454,1,2,3
"java/testing/org/apache/derbyTesting/functionTests/tests/lang/outparams30.java",0,0.875,0,2,2
"java/testing/org/apache/derbyTesting/functionTests/tests/lang/simpleThread.java",0,0.954887218045113,1,1,2
"java/testing/org/apache/derbyTesting/functionTests/tests/lang/simpleThreadWrapper.java",0,0.866666666666667,0,2,2
"java/testing/org/apache/derbyTesting/functionTests/tests/lang/userDefMethods.java",0,0.481012658227848,2,2,4
"java/testing/org/apache/derbyTesting/functionTests/tests/lang/wisconsin.java",0,0.783251231527094,3,2,5
"java/testing/org/apache/derbyTesting/functionTests/tests/largedata/LobLimits.java",0,0.781710914454277,1,3,4
"java/testing/org/apache/derbyTesting/functionTests/tests/management/InactiveManagementMBeanTest.java",0,1,0,1,1
"java/testing/org/apache/derbyTesting/functionTests/tests/management/JDBCMBeanTest.java",0,1,0,1,1
"java/testing/org/apache/derbyTesting/functionTests/tests/management/JMXConnectionDecorator.java",0,1,0,1,1
"java/testing/org/apache/derbyTesting/functionTests/tests/management/JMXConnectionGetter.java",0,1,0,1,1
"java/testing/org/apache/derbyTesting/functionTests/tests/management/JMXTest.java",0,1,0,1,1
"java/testing/org/apache/derbyTesting/functionTests/tests/management/MBeanTest.java",0,1,0,1,1
"java/testing/org/apache/derbyTesting/functionTests/tests/management/ManagementMBeanTest.java",0,1,0,1,1
"java/testing/org/apache/derbyTesting/functionTests/tests/management/NetworkServerMBeanTest.java",0,0.996825396825397,1,1,2
"java/testing/org/apache/derbyTesting/functionTests/tests/management/PlatformConnectionGetter.java",0,1,0,1,1
"java/testing/org/apache/derbyTesting/functionTests/tests/management/RemoteConnectionGetter.java",0,1,0,1,1
"java/testing/org/apache/derbyTesting/functionTests/tests/management/VersionMBeanTest.java",0,1,0,1,1
"java/testing/org/apache/derbyTesting/functionTests/tests/management/_Suite.java",0,1,0,1,1
"java/testing/org/apache/derbyTesting/functionTests/tests/memory/BlobMemTest.java",0,0.860986547085202,0,2,2
"java/testing/org/apache/derbyTesting/functionTests/tests/memory/ClobMemTest.java",0,1,0,1,1
"java/testing/org/apache/derbyTesting/functionTests/tests/memory/ConnectionHandling.java",0,0.954887218045113,1,1,2
"java/testing/org/apache/derbyTesting/functionTests/tests/memory/ConnectionHandlingJunit.java",0,1,0,1,1
"java/testing/org/apache/derbyTesting/functionTests/tests/memory/MultiByteClobTest.java",0,0.775862068965517,0,2,2
"java/testing/org/apache/derbyTesting/functionTests/tests/memory/_Suite.java",0,1,0,1,1
"java/testing/org/apache/derbyTesting/functionTests/tests/memorydb/BasicInMemoryDbTest.java",0,1,0,1,1
"java/testing/org/apache/derbyTesting/functionTests/tests/memorydb/_Suite.java",0,1,0,1,1
"java/testing/org/apache/derbyTesting/functionTests/tests/multi/StressMulti10x1.java",0,0.810810810810811,0,2,2
"java/testing/org/apache/derbyTesting/functionTests/tests/multi/StressMulti50x59.java",0,0.891891891891892,0,2,2
"java/testing/org/apache/derbyTesting/functionTests/tests/multi/StressMultiTest.java",0,0.5,0,2,2
"java/testing/org/apache/derbyTesting/functionTests/tests/nist/NistScripts.java",0,0.995495495495496,1,1,2
"java/testing/org/apache/derbyTesting/functionTests/tests/perf/StartupExistingDBTest.java",0,0.986666666666667,1,1,2
"java/testing/org/apache/derbyTesting/functionTests/tests/perf/StartupNewDBTest.java",0,0.985714285714286,1,1,2
"java/testing/org/apache/derbyTesting/functionTests/tests/replicationTests/ClientRunner.java",0,1,0,1,1
"java/testing/org/apache/derbyTesting/functionTests/tests/replicationTests/DestroySlaveDB.java",0,1,0,1,1
"java/testing/org/apache/derbyTesting/functionTests/tests/replicationTests/KillMaster.java",0,1,0,1,1
"java/testing/org/apache/derbyTesting/functionTests/tests/replicationTests/KillSlave.java",0,1,0,1,1
"java/testing/org/apache/derbyTesting/functionTests/tests/replicationTests/ReplicationRun.java",0,0.920272673384707,2,2,4
"java/testing/org/apache/derbyTesting/functionTests/tests/replicationTests/ReplicationRun_CleanUp.java",0,0.985507246376812,1,1,2
"java/testing/org/apache/derbyTesting/functionTests/tests/replicationTests/ReplicationRun_Distributed.java",0,0.993630573248408,2,1,3
"java/testing/org/apache/derbyTesting/functionTests/tests/replicationTests/ReplicationRun_Full.java",0,0.997222222222222,1,1,2
"java/testing/org/apache/derbyTesting/functionTests/tests/replicationTests/ReplicationRun_Local.java",0,0.988372093023256,2,1,3
"java/testing/org/apache/derbyTesting/functionTests/tests/replicationTests/ReplicationRun_Local_1.java",0,0.94488188976378,2,1,3
"java/testing/org/apache/derbyTesting/functionTests/tests/replicationTests/ReplicationRun_Local_3.java",0,1,0,1,1
"java/testing/org/apache/derbyTesting/functionTests/tests/replicationTests/ReplicationRun_Local_3_p1.java",0,1,0,1,1
"java/testing/org/apache/derbyTesting/functionTests/tests/replicationTests/ReplicationRun_Local_3_p2.java",0,1,0,1,1
"java/testing/org/apache/derbyTesting/functionTests/tests/replicationTests/ReplicationRun_Local_3_p3.java",0,1,0,1,1
"java/testing/org/apache/derbyTesting/functionTests/tests/replicationTests/ReplicationRun_Local_3_p4.java",0,1,0,1,1
"java/testing/org/apache/derbyTesting/functionTests/tests/replicationTests/ReplicationRun_Local_StateTest_part1.java",0,0.997695852534562,1,1,2
"java/testing/org/apache/derbyTesting/functionTests/tests/replicationTests/ReplicationRun_Local_StateTest_part1_1.java",0,0.996153846153846,1,1,2
"java/testing/org/apache/derbyTesting/functionTests/tests/replicationTests/ReplicationRun_Local_StateTest_part1_2.java",0,0.996644295302013,1,1,2
"java/testing/org/apache/derbyTesting/functionTests/tests/replicationTests/ReplicationRun_Local_StateTest_part1_3.java",0,0.994535519125683,1,1,2
"java/testing/org/apache/derbyTesting/functionTests/tests/replicationTests/ReplicationRun_Local_StateTest_part2.java",0,0.974178403755869,2,1,3
"java/testing/org/apache/derbyTesting/functionTests/tests/replicationTests/ReplicationRun_Local_showStateChange.java",0,1,0,1,1
"java/testing/org/apache/derbyTesting/functionTests/tests/replicationTests/ReplicationSuite.java",0,0.885714285714286,0,2,2
"java/testing/org/apache/derbyTesting/functionTests/tests/replicationTests/ReplicationTestRun.java",0,1,0,1,1
"java/testing/org/apache/derbyTesting/functionTests/tests/replicationTests/ReplicationTestRun_Verify.java",0,1,0,1,1
"java/testing/org/apache/derbyTesting/functionTests/tests/replicationTests/ShutdownMaster.java",0,1,0,1,1
"java/testing/org/apache/derbyTesting/functionTests/tests/replicationTests/ShutdownMasterDb.java",0,1,0,1,1
"java/testing/org/apache/derbyTesting/functionTests/tests/replicationTests/ShutdownMasterServer.java",0,1,0,1,1
"java/testing/org/apache/derbyTesting/functionTests/tests/replicationTests/ShutdownMasterServerByOsKill.java",0,1,0,1,1
"java/testing/org/apache/derbyTesting/functionTests/tests/replicationTests/ShutdownMasterServerViaNwSrvCtrl.java",0,1,0,1,1
"java/testing/org/apache/derbyTesting/functionTests/tests/replicationTests/ShutdownSlave.java",0,1,0,1,1
"java/testing/org/apache/derbyTesting/functionTests/tests/replicationTests/ShutdownSlaveDb.java",0,1,0,1,1
"java/testing/org/apache/derbyTesting/functionTests/tests/replicationTests/ShutdownSlaveServer.java",0,1,0,1,1
"java/testing/org/apache/derbyTesting/functionTests/tests/replicationTests/ShutdownSlaveServerByOsKill.java",0,1,0,1,1
"java/testing/org/apache/derbyTesting/functionTests/tests/replicationTests/ShutdownSlaveServerViaNwSrvCtrl.java",0,1,0,1,1
"java/testing/org/apache/derbyTesting/functionTests/tests/replicationTests/SimplePerfTest.java",0,1,0,1,1
"java/testing/org/apache/derbyTesting/functionTests/tests/replicationTests/StandardTests.java",0,1,0,1,1
"java/testing/org/apache/derbyTesting/functionTests/tests/replicationTests/TestPostStartedMasterAndSlave_Failover.java",0,1,0,1,1
"java/testing/org/apache/derbyTesting/functionTests/tests/replicationTests/TestPostStartedMasterAndSlave_StopMaster.java",0,1,0,1,1
"java/testing/org/apache/derbyTesting/functionTests/tests/replicationTests/TestPostStartedMasterAndSlave_StopSlave.java",0,1,0,1,1
"java/testing/org/apache/derbyTesting/functionTests/tests/replicationTests/TestPostStoppedSlaveServer.java",0,1,0,1,1
"java/testing/org/apache/derbyTesting/functionTests/tests/replicationTests/TestPreInitSlave.java",0,1,0,1,1
"java/testing/org/apache/derbyTesting/functionTests/tests/replicationTests/TestPreStartedMaster.java",0,1,0,1,1
"java/testing/org/apache/derbyTesting/functionTests/tests/replicationTests/TestPreStartedMasterServer.java",0,1,0,1,1
"java/testing/org/apache/derbyTesting/functionTests/tests/replicationTests/TestPreStartedSlave.java",0,1,0,1,1
"java/testing/org/apache/derbyTesting/functionTests/tests/replicationTests/TestPreStartedSlaveServer.java",0,1,0,1,1
"java/testing/org/apache/derbyTesting/functionTests/tests/replicationTests/TestPreStoppedMaster.java",0,1,0,1,1
"java/testing/org/apache/derbyTesting/functionTests/tests/replicationTests/TestPreStoppedMasterServer.java",0,1,0,1,1
"java/testing/org/apache/derbyTesting/functionTests/tests/replicationTests/TestPreStoppedSlave.java",0,1,0,1,1
"java/testing/org/apache/derbyTesting/functionTests/tests/replicationTests/TestPreStoppedSlaveServer.java",0,1,0,1,1
"java/testing/org/apache/derbyTesting/functionTests/tests/replicationTests/Utils.java",0,0.977272727272727,1,1,2
"java/testing/org/apache/derbyTesting/functionTests/tests/store/BackupPathTests.java",0,0.953125,1,1,2
"java/testing/org/apache/derbyTesting/functionTests/tests/store/BackupRestoreTest.java",0,1,0,1,1
"java/testing/org/apache/derbyTesting/functionTests/tests/store/BaseTest.java",0,0.619433198380567,2,2,4
"java/testing/org/apache/derbyTesting/functionTests/tests/store/Beetle6038.java",0,0.857142857142857,0,2,2
"java/testing/org/apache/derbyTesting/functionTests/tests/store/BootAllTest.java",0,0.578947368421053,0,2,2
"java/testing/org/apache/derbyTesting/functionTests/tests/store/ClobReclamationTest.java",0,1,0,1,1
"java/testing/org/apache/derbyTesting/functionTests/tests/store/Derby3625Test.java",0,1,0,1,1
"java/testing/org/apache/derbyTesting/functionTests/tests/store/Derby3980DeadlockTest.java",0,1,0,1,1
"java/testing/org/apache/derbyTesting/functionTests/tests/store/EncryptionAESTest.java",0,1,0,1,1
"java/testing/org/apache/derbyTesting/functionTests/tests/store/EncryptionKeyAESTest.java",0,1,0,1,1
"java/testing/org/apache/derbyTesting/functionTests/tests/store/EncryptionKeyBlowfishTest.java",0,1,0,1,1
"java/testing/org/apache/derbyTesting/functionTests/tests/store/EncryptionKeyDESTest.java",0,1,0,1,1
"java/testing/org/apache/derbyTesting/functionTests/tests/store/EncryptionKeyTest.java",0,0.998505231689088,1,1,2
"java/testing/org/apache/derbyTesting/functionTests/tests/store/EncryptionTest.java",0,0.92,0,2,2
"java/testing/org/apache/derbyTesting/functionTests/tests/store/IndexSplitDeadlockTest.java",0,1,0,1,1
"java/testing/org/apache/derbyTesting/functionTests/tests/store/LiveLockTest.java",0,1,0,1,1
"java/testing/org/apache/derbyTesting/functionTests/tests/store/LogChecksumRecovery.java",0,0.925,0,2,2
"java/testing/org/apache/derbyTesting/functionTests/tests/store/LogChecksumRecovery1.java",0,0.923076923076923,0,2,2
"java/testing/org/apache/derbyTesting/functionTests/tests/store/LogChecksumSetup.java",0,0.977186311787072,1,1,2
"java/testing/org/apache/derbyTesting/functionTests/tests/store/LogDeviceTest.java",0,1,0,1,1
"java/testing/org/apache/derbyTesting/functionTests/tests/store/MaxLogNumber.java",0,0.972222222222222,1,1,2
"java/testing/org/apache/derbyTesting/functionTests/tests/store/MaxLogNumberRecovery.java",0,0.942307692307692,0,2,2
"java/testing/org/apache/derbyTesting/functionTests/tests/store/OSReadOnlyTest.java",0,1,0,1,1
"java/testing/org/apache/derbyTesting/functionTests/tests/store/OfflineBackupTest.java",0,1,0,1,1
"java/testing/org/apache/derbyTesting/functionTests/tests/store/OnlineBackup.java",0,0.950819672131147,1,1,2
"java/testing/org/apache/derbyTesting/functionTests/tests/store/OnlineBackupTest1.java",0,0.973415132924335,1,1,2
"java/testing/org/apache/derbyTesting/functionTests/tests/store/OnlineBackupTest3.java",0,0.975563909774436,1,1,2
"java/testing/org/apache/derbyTesting/functionTests/tests/store/OnlineCompressTest.java",0,0.612966601178782,1,3,4
"java/testing/org/apache/derbyTesting/functionTests/tests/store/PositionedStoreStreamTest.java",0,1,0,1,1
"java/testing/org/apache/derbyTesting/functionTests/tests/store/ReEncryptCrashRecovery.java",0,0.989913544668588,1,1,2
"java/testing/org/apache/derbyTesting/functionTests/tests/store/RecoveryAfterBackup.java",0,0.838983050847458,2,3,5
"java/testing/org/apache/derbyTesting/functionTests/tests/store/RecoveryAfterBackupSetup.java",0,0.906666666666667,1,2,3
"java/testing/org/apache/derbyTesting/functionTests/tests/store/StoreBaseTest.java",0,1,0,1,1
"java/testing/org/apache/derbyTesting/functionTests/tests/store/StreamingColumnTest.java",0,1,0,1,1
"java/testing/org/apache/derbyTesting/functionTests/tests/store/TestDiskHashtable.java",0,0.965909090909091,2,1,3
"java/testing/org/apache/derbyTesting/functionTests/tests/store/TestDurabilityProperty.java",0,0.968115942028986,2,1,3
"java/testing/org/apache/derbyTesting/functionTests/tests/store/TurnsReadOnly.java",0,0.944954128440367,0,2,2
"java/testing/org/apache/derbyTesting/functionTests/tests/store/_Suite.java",0,0.714285714285714,2,4,6
"java/testing/org/apache/derbyTesting/functionTests/tests/store/backupRestore1.java",0,0.940559440559441,0,2,2
"java/testing/org/apache/derbyTesting/functionTests/tests/store/bootLock.java",0,0.950819672131147,1,1,2
"java/testing/org/apache/derbyTesting/functionTests/tests/store/bootLock1.java",0,0.897727272727273,0,2,2
"java/testing/org/apache/derbyTesting/functionTests/tests/store/checkPoint.java",0,0.974683544303797,1,1,2
"java/testing/org/apache/derbyTesting/functionTests/tests/store/col_rec1.java",0,1,0,1,1
"java/testing/org/apache/derbyTesting/functionTests/tests/store/col_rec2.java",0,1,0,1,1
"java/testing/org/apache/derbyTesting/functionTests/tests/store/dropcrash.java",0,0.968253968253968,1,1,2
"java/testing/org/apache/derbyTesting/functionTests/tests/store/dropcrash2.java",0,0.918918918918919,0,2,2
"java/testing/org/apache/derbyTesting/functionTests/tests/store/oc_rec1.java",0,0.933333333333333,0,2,2
"java/testing/org/apache/derbyTesting/functionTests/tests/store/oc_rec2.java",0,0.943396226415094,0,2,2
"java/testing/org/apache/derbyTesting/functionTests/tests/store/oc_rec3.java",0,0.944444444444444,0,2,2
"java/testing/org/apache/derbyTesting/functionTests/tests/store/oc_rec4.java",0,0.941747572815534,0,2,2
"java/testing/org/apache/derbyTesting/functionTests/tests/storetests/st_derby1939.java",0,0.926108374384236,0,2,2
"java/testing/org/apache/derbyTesting/functionTests/tests/storetests/st_derby715.java",0,0.978798586572438,1,1,2
"java/testing/org/apache/derbyTesting/functionTests/tests/storetests/st_reclaim_longcol.java",0,0.985714285714286,1,1,2
"java/testing/org/apache/derbyTesting/functionTests/tests/tools/IJRunScriptTest.java",0,0.951807228915663,1,1,2
"java/testing/org/apache/derbyTesting/functionTests/tests/tools/ImportExportBaseTest.java",0,1,0,1,1
"java/testing/org/apache/derbyTesting/functionTests/tests/tools/ImportExportBinaryDataTest.java",0,0.8225,1,2,3
"java/testing/org/apache/derbyTesting/functionTests/tests/tools/ImportExportIJTest.java",0,1,0,1,1
"java/testing/org/apache/derbyTesting/functionTests/tests/tools/ImportExportLobTest.java",0,0.831460674157303,2,2,4
"java/testing/org/apache/derbyTesting/functionTests/tests/tools/ImportExportProcedureTest.java",0,0.920869208692087,1,2,3
"java/testing/org/apache/derbyTesting/functionTests/tests/tools/ImportExportTest.java",0,0.63716814159292,3,2,5
"java/testing/org/apache/derbyTesting/functionTests/tests/tools/SysinfoAPITest.java",0,0.985,2,1,3
"java/testing/org/apache/derbyTesting/functionTests/tests/tools/SysinfoCPCheckTest.java",0,0.975609756097561,1,1,2
"java/testing/org/apache/derbyTesting/functionTests/tests/tools/SysinfoLocaleTest.java",0,0.967078189300412,1,1,2
"java/testing/org/apache/derbyTesting/functionTests/tests/tools/ToolScripts.java",0,0.67,1,2,3
"java/testing/org/apache/derbyTesting/functionTests/tests/tools/_Suite.java",0,0.794520547945205,3,2,5
"java/testing/org/apache/derbyTesting/functionTests/tests/tools/dblook_test.java",0,0.935297515886771,5,1,6
"java/testing/org/apache/derbyTesting/functionTests/tests/tools/dblook_test_territory.java",0,1,0,1,1
"java/testing/org/apache/derbyTesting/functionTests/tests/tools/derbyrunjartest.java",0,0.615384615384615,1,2,3
"java/testing/org/apache/derbyTesting/functionTests/tests/upgradeTests/BasicSetup.java",0,0.698564593301435,1,2,3
"java/testing/org/apache/derbyTesting/functionTests/tests/upgradeTests/Changes10_1.java",0,1,0,1,1
"java/testing/org/apache/derbyTesting/functionTests/tests/upgradeTests/Changes10_2.java",0,0.995967741935484,1,1,2
"java/testing/org/apache/derbyTesting/functionTests/tests/upgradeTests/Changes10_3.java",0,0.334020618556701,2,4,6
"java/testing/org/apache/derbyTesting/functionTests/tests/upgradeTests/Changes10_4.java",0,0.418333333333333,0,5,5
"java/testing/org/apache/derbyTesting/functionTests/tests/upgradeTests/Changes10_5.java",0,0.493023255813954,0,3,3
"java/testing/org/apache/derbyTesting/functionTests/tests/upgradeTests/PhaseChanger.java",0,0.812154696132597,0,3,3
"java/testing/org/apache/derbyTesting/functionTests/tests/upgradeTests/UpgradeChange.java",0,1,0,1,1
"java/testing/org/apache/derbyTesting/functionTests/tests/upgradeTests/UpgradeRun.java",0,0.659340659340659,3,4,7
"java/testing/org/apache/derbyTesting/functionTests/tests/upgradeTests/_Suite.java",0,0.561688311688312,0,3,3
"java/testing/org/apache/derbyTesting/functionTests/util/BigDecimalHandler.java",0,0.931034482758621,2,1,3
"java/testing/org/apache/derbyTesting/functionTests/util/CanonTestCase.java",0,0.919463087248322,0,2,2
"java/testing/org/apache/derbyTesting/functionTests/util/DbFile.java",0,0.96319018404908,1,1,2
"java/testing/org/apache/derbyTesting/functionTests/util/DerbyJUnitTest.java",0,0.656474820143885,1,2,3
"java/testing/org/apache/derbyTesting/functionTests/util/ExecProcUtil.java",0,1,0,1,1
"java/testing/org/apache/derbyTesting/functionTests/util/ExtendingInterface.java",0,0.823529411764706,0,2,2
"java/testing/org/apache/derbyTesting/functionTests/util/FTFileUtil.java",0,0.688442211055276,0,3,3
"java/testing/org/apache/derbyTesting/functionTests/util/Formatters.java",0,0.953125,1,1,2
"java/testing/org/apache/derbyTesting/functionTests/util/HarnessJavaTest.java",0,1,0,1,1
"java/testing/org/apache/derbyTesting/functionTests/util/IjTestCase.java",0,0.966386554621849,1,1,2
"java/testing/org/apache/derbyTesting/functionTests/util/JDBCTestDisplayUtil.java",0,0.965317919075145,1,1,2
"java/testing/org/apache/derbyTesting/functionTests/util/JarUtil.java",0,1,0,1,1
"java/testing/org/apache/derbyTesting/functionTests/util/Jdbc20Test.java",0,0.866666666666667,0,2,2
"java/testing/org/apache/derbyTesting/functionTests/util/ManyMethods.java",0,0.989708404802744,1,1,2
"java/testing/org/apache/derbyTesting/functionTests/util/NoMethodInterface.java",0,0.785714285714286,0,2,2
"java/testing/org/apache/derbyTesting/functionTests/util/PrivilegedFileOpsForTests.java",0,0.695804195804196,0,3,3
"java/testing/org/apache/derbyTesting/functionTests/util/ProcedureTest.java",0,0.847908745247148,5,2,7
"java/testing/org/apache/derbyTesting/functionTests/util/PropertyUtil.java",0,0.866666666666667,0,2,2
"java/testing/org/apache/derbyTesting/functionTests/util/ProtocolTestGrammar.java",0,1,0,1,1
"java/testing/org/apache/derbyTesting/functionTests/util/SQLStateConstants.java",0,0.951149425287356,4,1,5
"java/testing/org/apache/derbyTesting/functionTests/util/SQLToJUnit.java",0,0.980872226472839,2,1,3
"java/testing/org/apache/derbyTesting/functionTests/util/ScriptTestCase.java",0,0.610810810810811,1,4,5
"java/testing/org/apache/derbyTesting/functionTests/util/SecurityCheck.java",0,0.950769230769231,2,1,3
"java/testing/org/apache/derbyTesting/functionTests/util/ShortHolder.java",0,0.894736842105263,0,2,2
"java/testing/org/apache/derbyTesting/functionTests/util/SimpleProcedureTest.java",0,0.932584269662921,0,2,2
"java/testing/org/apache/derbyTesting/functionTests/util/StatParser.java",0,0.931818181818182,0,2,2
"java/testing/org/apache/derbyTesting/functionTests/util/StaticInitializers/DMLInStaticInitializer.java",0,0.86046511627907,0,3,3
"java/testing/org/apache/derbyTesting/functionTests/util/StaticInitializers/InsertInStaticInitializer.java",0,0.865168539325843,0,3,3
"java/testing/org/apache/derbyTesting/functionTests/util/SubClass.java",0,0.901639344262295,0,2,2
"java/testing/org/apache/derbyTesting/functionTests/util/SubInterfaceClass.java",0,0.872340425531915,0,2,2
"java/testing/org/apache/derbyTesting/functionTests/util/SubSubClass.java",0,0.884615384615385,0,2,2
"java/testing/org/apache/derbyTesting/functionTests/util/T_Access.java",0,0.90625,0,2,2
"java/testing/org/apache/derbyTesting/functionTests/util/T_Authorize.java",0,0.963541666666667,1,1,2
"java/testing/org/apache/derbyTesting/functionTests/util/T_ConsistencyChecker.java",0,0.984313725490196,2,1,3
"java/testing/org/apache/derbyTesting/functionTests/util/TestInputStream.java",0,0.903225806451613,0,2,2
"java/testing/org/apache/derbyTesting/functionTests/util/TestPropertyInfo.java",0,0.966292134831461,1,1,2
"java/testing/org/apache/derbyTesting/functionTests/util/TestRoutines.java",0,0.497109826589595,1,2,3
"java/testing/org/apache/derbyTesting/functionTests/util/TestUtil.java",0,0.519587628865979,3,3,6
"java/testing/org/apache/derbyTesting/functionTests/util/ThreadDump.java",0,1,0,1,1
"java/testing/org/apache/derbyTesting/functionTests/util/Triggers.java",0,0.97196261682243,1,1,2
"java/testing/org/apache/derbyTesting/functionTests/util/UniqueRandomSequence.java",0,1,0,1,1
"java/testing/org/apache/derbyTesting/functionTests/util/corruptio/CorruptBaseStorageFactory.java",0,0.910071942446043,2,2,4
"java/testing/org/apache/derbyTesting/functionTests/util/corruptio/CorruptDiskStorageFactory.java",0,0.938144329896907,0,2,2
"java/testing/org/apache/derbyTesting/functionTests/util/corruptio/CorruptFile.java",0,0.958549222797927,2,1,3
"java/testing/org/apache/derbyTesting/functionTests/util/corruptio/CorruptRandomAccessFile.java",0,0.919270833333333,1,2,3
"java/testing/org/apache/derbyTesting/functionTests/util/corruptio/CorruptibleIo.java",0,0.951612903225806,1,1,2
"java/testing/org/apache/derbyTesting/functionTests/util/metadataHelperProcs.java",0,0.866666666666667,0,2,2
"java/testing/org/apache/derbyTesting/functionTests/util/streams/ByteAlphabet.java",0,0.980769230769231,1,1,2
"java/testing/org/apache/derbyTesting/functionTests/util/streams/CharAlphabet.java",0,0.911917098445596,0,2,2
"java/testing/org/apache/derbyTesting/functionTests/util/streams/LoopingAlphabetReader.java",0,0.995983935742972,1,1,2
"java/testing/org/apache/derbyTesting/functionTests/util/streams/LoopingAlphabetStream.java",0,0.850467289719626,0,2,2
"java/testing/org/apache/derbyTesting/functionTests/util/streams/ReadOnceByteArrayInputStream.java",0,0.737704918032787,0,2,2
"java/testing/org/apache/derbyTesting/functionTests/util/streams/StringReaderWithLength.java",0,0.578947368421053,0,2,2
"java/testing/org/apache/derbyTesting/junit/BaseJDBCTestCase.java",0,0.53230543318649,9,3,12
"java/testing/org/apache/derbyTesting/junit/BaseJDBCTestSetup.java",0,0.9375,0,2,2
"java/testing/org/apache/derbyTesting/junit/BaseTestCase.java",0,0.227655986509275,2,7,9
"java/testing/org/apache/derbyTesting/junit/BaseTestSetup.java",0,1,0,1,1
"java/testing/org/apache/derbyTesting/junit/BigDecimalHandler.java",0,1,0,1,1
"java/testing/org/apache/derbyTesting/junit/ChangeConfigurationSetup.java",0,1,0,1,1
"java/testing/org/apache/derbyTesting/junit/ChangeSSLSetup.java",0,1,0,1,1
"java/testing/org/apache/derbyTesting/junit/ChangeUserSetup.java",0,1,0,1,1
"java/testing/org/apache/derbyTesting/junit/CleanDatabaseTestSetup.java",0,0.80952380952381,0,3,3
"java/testing/org/apache/derbyTesting/junit/ConnectionPoolDataSourceConnector.java",0,1,0,1,1
"java/testing/org/apache/derbyTesting/junit/Connector.java",0,0.978494623655914,1,1,2
"java/testing/org/apache/derbyTesting/junit/ConnectorSetup.java",0,1,0,1,1
"java/testing/org/apache/derbyTesting/junit/DataSourceConnector.java",0,0.979591836734694,1,1,2
"java/testing/org/apache/derbyTesting/junit/DatabaseChangeSetup.java",0,1,0,1,1
"java/testing/org/apache/derbyTesting/junit/DatabasePropertyTestSetup.java",0,0.802777777777778,1,2,3
"java/testing/org/apache/derbyTesting/junit/Decorator.java",0,0.979487179487179,1,1,2
"java/testing/org/apache/derbyTesting/junit/Derby.java",0,0.912621359223301,0,2,2
"java/testing/org/apache/derbyTesting/junit/DriverManagerConnector.java",0,0.968354430379747,1,1,2
"java/testing/org/apache/derbyTesting/junit/DropDatabaseSetup.java",0,0.89051094890511,0,2,2
"java/testing/org/apache/derbyTesting/junit/EnvTest.java",0,1,0,1,1
"java/testing/org/apache/derbyTesting/junit/J2EEDataSource.java",0,0.861386138613861,0,2,2
"java/testing/org/apache/derbyTesting/junit/JAXPFinder.java",0,1,0,1,1
"java/testing/org/apache/derbyTesting/junit/JDBC.java",0,0.617521367521368,9,3,12
"java/testing/org/apache/derbyTesting/junit/JDBCClient.java",0,0.497777777777778,3,2,5
"java/testing/org/apache/derbyTesting/junit/JDBCClientSetup.java",0,1,0,1,1
"java/testing/org/apache/derbyTesting/junit/JDBCDataSource.java",0,0.932835820895522,2,2,4
"java/testing/org/apache/derbyTesting/junit/JDBCPerfTestCase.java",0,0.968911917098446,1,1,2
"java/testing/org/apache/derbyTesting/junit/NetworkServerControlWrapper.java",0,1,0,1,1
"java/testing/org/apache/derbyTesting/junit/NetworkServerTestSetup.java",0,0.465189873417722,3,4,7
"java/testing/org/apache/derbyTesting/junit/RuntimeStatisticsParser.java",0,0.412307692307692,4,4,8
"java/testing/org/apache/derbyTesting/junit/SQLUtilities.java",0,0.874251497005988,1,2,3
"java/testing/org/apache/derbyTesting/junit/SecurityManagerSetup.java",0,0.734793187347932,6,2,8
"java/testing/org/apache/derbyTesting/junit/ServerSetup.java",0,0.785714285714286,1,2,3
"java/testing/org/apache/derbyTesting/junit/SpawnedProcess.java",0,1,0,1,1
"java/testing/org/apache/derbyTesting/junit/SupportFilesSetup.java",0,0.774305555555556,2,2,4
"java/testing/org/apache/derbyTesting/junit/SystemPropertyTestSetup.java",0,0.81294964028777,1,2,3
"java/testing/org/apache/derbyTesting/junit/TestConfiguration.java",0,0.515445184736523,10,4,14
"java/testing/org/apache/derbyTesting/junit/Utilities.java",0,0.645299145299145,0,3,3
"java/testing/org/apache/derbyTesting/junit/XADataSourceConnector.java",0,1,0,1,1
"java/testing/org/apache/derbyTesting/junit/XATestUtil.java",0,0.927777777777778,2,1,3
"java/testing/org/apache/derbyTesting/junit/XML.java",0,0.504504504504504,0,3,3
"java/testing/org/apache/derbyTesting/perf/basic/_Suite.java",0,0.903846153846154,0,2,2
"java/testing/org/apache/derbyTesting/perf/basic/jdbc/BaseLoad100IdxTestSetup.java",0,0.988505747126437,1,1,2
"java/testing/org/apache/derbyTesting/perf/basic/jdbc/BaseLoad100TestSetup.java",0,1,0,1,1
"java/testing/org/apache/derbyTesting/perf/basic/jdbc/BlobAccessTest.java",0,1,0,1,1
"java/testing/org/apache/derbyTesting/perf/basic/jdbc/ClobAccessTest.java",0,1,0,1,1
"java/testing/org/apache/derbyTesting/perf/basic/jdbc/CountTest.java",0,1,0,1,1
"java/testing/org/apache/derbyTesting/perf/basic/jdbc/CoveredIdxScan.java",0,1,0,1,1
"java/testing/org/apache/derbyTesting/perf/basic/jdbc/HeapScan.java",0,1,0,1,1
"java/testing/org/apache/derbyTesting/perf/basic/jdbc/IndexScanTest.java",0,1,0,1,1
"java/testing/org/apache/derbyTesting/perf/basic/jdbc/SelectDistinctTest.java",0,1,0,1,1
"java/testing/org/apache/derbyTesting/perf/basic/jdbc/SortTest.java",0,1,0,1,1
"java/testing/org/apache/derbyTesting/perf/basic/jdbc/ValuesTest.java",0,1,0,1,1
"java/testing/org/apache/derbyTesting/perf/clients/BackToBackLoadGenerator.java",0,1,0,1,1
"java/testing/org/apache/derbyTesting/perf/clients/BankAccountFiller.java",0,1,0,1,1
"java/testing/org/apache/derbyTesting/perf/clients/BankTransactionClient.java",0,1,0,1,1
"java/testing/org/apache/derbyTesting/perf/clients/Client.java",0,1,0,1,1
"java/testing/org/apache/derbyTesting/perf/clients/DBFiller.java",0,1,0,1,1
"java/testing/org/apache/derbyTesting/perf/clients/IndexJoinClient.java",0,1,0,1,1
"java/testing/org/apache/derbyTesting/perf/clients/LoadGenerator.java",0,1,0,1,1
"java/testing/org/apache/derbyTesting/perf/clients/PoissonLoadGenerator.java",0,1,0,1,1
"java/testing/org/apache/derbyTesting/perf/clients/Runner.java",0,1,0,1,1
"java/testing/org/apache/derbyTesting/perf/clients/SingleRecordFiller.java",0,1,0,1,1
"java/testing/org/apache/derbyTesting/perf/clients/SingleRecordSelectClient.java",0,1,0,1,1
"java/testing/org/apache/derbyTesting/perf/clients/SingleRecordUpdateClient.java",0,1,0,1,1
"java/testing/org/apache/derbyTesting/perf/clients/WisconsinFiller.java",0,1,0,1,1
"java/testing/org/apache/derbyTesting/system/mailjdbc/MailJdbc.java",0,1,0,1,1
"java/testing/org/apache/derbyTesting/system/mailjdbc/tasks/Backup.java",0,1,0,1,1
"java/testing/org/apache/derbyTesting/system/mailjdbc/tasks/Browse.java",0,1,0,1,1
"java/testing/org/apache/derbyTesting/system/mailjdbc/tasks/Purge.java",0,1,0,1,1
"java/testing/org/apache/derbyTesting/system/mailjdbc/tasks/Refresh.java",0,1,0,1,1
"java/testing/org/apache/derbyTesting/system/mailjdbc/utils/DbTasks.java",0,0.88364434687157,1,2,3
"java/testing/org/apache/derbyTesting/system/mailjdbc/utils/LogFile.java",0,1,0,1,1
"java/testing/org/apache/derbyTesting/system/mailjdbc/utils/PerfTime.java",0,1,0,1,1
"java/testing/org/apache/derbyTesting/system/mailjdbc/utils/Statements.java",0,1,0,1,1
"java/testing/org/apache/derbyTesting/system/mailjdbc/utils/ThreadUtils.java",0,1,0,1,1
"java/testing/org/apache/derbyTesting/system/nstest/NsTest.java",0,0.998452012383901,1,1,2
"java/testing/org/apache/derbyTesting/system/nstest/init/DbSetup.java",0,1,0,1,1
"java/testing/org/apache/derbyTesting/system/nstest/init/Initializer.java",0,1,0,1,1
"java/testing/org/apache/derbyTesting/system/nstest/init/NWServerThread.java",0,1,0,1,1
"java/testing/org/apache/derbyTesting/system/nstest/tester/BackupRestoreReEncryptTester.java",0,1,0,1,1
"java/testing/org/apache/derbyTesting/system/nstest/tester/Tester1.java",0,1,0,1,1
"java/testing/org/apache/derbyTesting/system/nstest/tester/Tester2.java",0,1,0,1,1
"java/testing/org/apache/derbyTesting/system/nstest/tester/Tester3.java",0,1,0,1,1
"java/testing/org/apache/derbyTesting/system/nstest/tester/TesterObject.java",0,1,0,1,1
"java/testing/org/apache/derbyTesting/system/nstest/utils/DbUtil.java",0,1,0,1,1
"java/testing/org/apache/derbyTesting/system/nstest/utils/MemCheck.java",0,1,0,1,1
"java/testing/org/apache/derbyTesting/system/oe/client/Display.java",0,1,0,1,1
"java/testing/org/apache/derbyTesting/system/oe/client/Load.java",0,1,0,1,1
"java/testing/org/apache/derbyTesting/system/oe/client/MultiThreadSubmitter.java",0,1,0,1,1
"java/testing/org/apache/derbyTesting/system/oe/client/Operations.java",0,1,0,1,1
"java/testing/org/apache/derbyTesting/system/oe/client/Submitter.java",0,0.996357012750455,1,1,2
"java/testing/org/apache/derbyTesting/system/oe/direct/SimpleNonStandardOperations.java",0,1,0,1,1
"java/testing/org/apache/derbyTesting/system/oe/direct/Standard.java",0,1,0,1,1
"java/testing/org/apache/derbyTesting/system/oe/direct/StatementHelper.java",0,1,0,1,1
"java/testing/org/apache/derbyTesting/system/oe/load/SimpleInsert.java",0,1,0,1,1
"java/testing/org/apache/derbyTesting/system/oe/load/ThreadInsert.java",0,0.930131004366812,0,2,2
"java/testing/org/apache/derbyTesting/system/oe/model/Address.java",0,1,0,1,1
"java/testing/org/apache/derbyTesting/system/oe/model/Customer.java",0,1,0,1,1
"java/testing/org/apache/derbyTesting/system/oe/model/District.java",0,1,0,1,1
"java/testing/org/apache/derbyTesting/system/oe/model/Order.java",0,1,0,1,1
"java/testing/org/apache/derbyTesting/system/oe/model/OrderLine.java",0,1,0,1,1
"java/testing/org/apache/derbyTesting/system/oe/model/Warehouse.java",0,1,0,1,1
"java/testing/org/apache/derbyTesting/system/oe/routines/Data.java",0,1,0,1,1
"java/testing/org/apache/derbyTesting/system/oe/run/Checks.java",0,1,0,1,1
"java/testing/org/apache/derbyTesting/system/oe/run/DriverUtility.java",0,1,0,1,1
"java/testing/org/apache/derbyTesting/system/oe/run/Populate.java",0,1,0,1,1
"java/testing/org/apache/derbyTesting/system/oe/run/Schema.java",0,1,0,1,1
"java/testing/org/apache/derbyTesting/system/oe/test/OETest.java",0,1,0,1,1
"java/testing/org/apache/derbyTesting/system/oe/test/OperationsTester.java",0,1,0,1,1
"java/testing/org/apache/derbyTesting/system/oe/test/_Suite.java",0,1,0,1,1
"java/testing/org/apache/derbyTesting/system/oe/util/HandleCheckError.java",0,1,0,1,1
"java/testing/org/apache/derbyTesting/system/oe/util/OEChecks.java",0,1,0,1,1
"java/testing/org/apache/derbyTesting/system/oe/util/OERandom.java",0,1,0,1,1
"java/testing/org/apache/derbyTesting/system/optimizer/RunOptimizerTest.java",0,0.690058479532164,1,3,4
"java/testing/org/apache/derbyTesting/system/optimizer/StaticValues.java",0,1,0,1,1
"java/testing/org/apache/derbyTesting/system/optimizer/query/GenericQuery.java",0,0.92258064516129,1,2,3
"java/testing/org/apache/derbyTesting/system/optimizer/query/Query1.java",0,1,0,1,1
"java/testing/org/apache/derbyTesting/system/optimizer/query/Query2.java",0,1,0,1,1
"java/testing/org/apache/derbyTesting/system/optimizer/query/Query3.java",0,1,0,1,1
"java/testing/org/apache/derbyTesting/system/optimizer/query/Query4.java",0,1,0,1,1
"java/testing/org/apache/derbyTesting/system/optimizer/query/Query5.java",0,1,0,1,1
"java/testing/org/apache/derbyTesting/system/optimizer/query/Query6.java",0,1,0,1,1
"java/testing/org/apache/derbyTesting/system/optimizer/query/QueryList.java",0,1,0,1,1
"java/testing/org/apache/derbyTesting/system/optimizer/utils/DataUtils.java",0,0.895238095238095,0,2,2
"java/testing/org/apache/derbyTesting/system/optimizer/utils/TestUtils.java",0,1,0,1,1
"java/testing/org/apache/derbyTesting/system/optimizer/utils/TestViews.java",0,1,0,1,1
"java/testing/org/apache/derbyTesting/system/sttest/Sttest.java",0,0.863198458574181,0,2,2
"java/testing/org/apache/derbyTesting/system/sttest/tools/MemCheck.java",0,1,0,1,1
"java/testing/org/apache/derbyTesting/system/sttest/utils/CompressTable.java",0,1,0,1,1
"java/testing/org/apache/derbyTesting/system/sttest/utils/Datatypes.java",0,0.801775147928994,0,2,2
"java/testing/org/apache/derbyTesting/system/sttest/utils/Setup.java",0,1,0,1,1
"java/testing/org/apache/derbyTesting/system/sttest/utils/StStatus.java",0,1,0,1,1
"java/testing/org/apache/derbyTesting/unitTests/crypto/T_Cipher.java",0,0.944356120826709,2,1,3
"java/testing/org/apache/derbyTesting/unitTests/crypto/T_CipherBlowfish.java",0,1,0,1,1
"java/testing/org/apache/derbyTesting/unitTests/crypto/T_CipherCFB.java",0,1,0,1,1
"java/testing/org/apache/derbyTesting/unitTests/crypto/T_CipherDES.java",0,1,0,1,1
"java/testing/org/apache/derbyTesting/unitTests/crypto/T_CipherECB.java",0,1,0,1,1
"java/testing/org/apache/derbyTesting/unitTests/crypto/T_CipherOFB.java",0,1,0,1,1
"java/testing/org/apache/derbyTesting/unitTests/harness/BasicUnitTest.java",0,1,0,1,1
"java/testing/org/apache/derbyTesting/unitTests/harness/BasicUnitTestManager.java",0,1,0,1,1
"java/testing/org/apache/derbyTesting/unitTests/harness/T_Bomb.java",0,1,0,1,1
"java/testing/org/apache/derbyTesting/unitTests/harness/T_Bombable.java",0,1,0,1,1
"java/testing/org/apache/derbyTesting/unitTests/harness/T_Fail.java",0,1,0,1,1
"java/testing/org/apache/derbyTesting/unitTests/harness/T_Generic.java",0,0.990521327014218,1,1,2
"java/testing/org/apache/derbyTesting/unitTests/harness/T_MultiIterations.java",0,1,0,1,1
"java/testing/org/apache/derbyTesting/unitTests/harness/T_MultiThreadedIterations.java",0,1,0,1,1
"java/testing/org/apache/derbyTesting/unitTests/harness/UnitTest.java",0,1,0,1,1
"java/testing/org/apache/derbyTesting/unitTests/harness/UnitTestConstants.java",0,1,0,1,1
"java/testing/org/apache/derbyTesting/unitTests/harness/UnitTestMain.java",0,1,0,1,1
"java/testing/org/apache/derbyTesting/unitTests/harness/UnitTestManager.java",0,1,0,1,1
"java/testing/org/apache/derbyTesting/unitTests/junit/ArrayInputStreamTest.java",0,1,0,1,1
"java/testing/org/apache/derbyTesting/unitTests/junit/AssertFailureTest.java",0,0.736842105263158,0,2,2
"java/testing/org/apache/derbyTesting/unitTests/junit/BlockedByteArrayTest.java",0,1,0,1,1
"java/testing/org/apache/derbyTesting/unitTests/junit/CharacterStreamDescriptorTest.java",0,1,0,1,1
"java/testing/org/apache/derbyTesting/unitTests/junit/CompressedNumberTest.java",0,1,0,1,1
"java/testing/org/apache/derbyTesting/unitTests/junit/FormatableBitSetTest.java",0,1,0,1,1
"java/testing/org/apache/derbyTesting/unitTests/junit/InputStreamUtilTest.java",0,1,0,1,1
"java/testing/org/apache/derbyTesting/unitTests/junit/JDBCStatementCacheTest.java",0,1,0,1,1
"java/testing/org/apache/derbyTesting/unitTests/junit/PathUtilTest.java",0,1,0,1,1
"java/testing/org/apache/derbyTesting/unitTests/junit/ReaderToUTF8StreamTest.java",0,1,0,1,1
"java/testing/org/apache/derbyTesting/unitTests/junit/StatementKeyFactoryTest.java",0,1,0,1,1
"java/testing/org/apache/derbyTesting/unitTests/junit/SystemPrivilegesPermissionTest.java",0,0.578814627994956,0,2,2
"java/testing/org/apache/derbyTesting/unitTests/junit/UTF8UtilTest.java",0,1,0,1,1
"java/testing/org/apache/derbyTesting/unitTests/junit/VirtualFileTest.java",0,1,0,1,1
"java/testing/org/apache/derbyTesting/unitTests/junit/_Suite.java",0,0.859375,2,2,4
"java/testing/org/apache/derbyTesting/unitTests/lang/EmptyResultSetStatisticsFactory.java",0,1,0,1,1
"java/testing/org/apache/derbyTesting/unitTests/lang/T_Like.java",0,0.85,0,2,2
"java/testing/org/apache/derbyTesting/unitTests/services/D_T_DiagTestClass1.java",0,1,0,1,1
"java/testing/org/apache/derbyTesting/unitTests/services/MarkedLimitInputStream.java",0,1,0,1,1
"java/testing/org/apache/derbyTesting/unitTests/services/T_CacheException.java",0,1,0,1,1
"java/testing/org/apache/derbyTesting/unitTests/services/T_CacheService.java",0,1,0,1,1
"java/testing/org/apache/derbyTesting/unitTests/services/T_CacheUser.java",0,1,0,1,1
"java/testing/org/apache/derbyTesting/unitTests/services/T_Cacheable.java",0,1,0,1,1
"java/testing/org/apache/derbyTesting/unitTests/services/T_CachedInteger.java",0,1,0,1,1
"java/testing/org/apache/derbyTesting/unitTests/services/T_DaemonService.java",0,0.953703703703704,1,1,2
"java/testing/org/apache/derbyTesting/unitTests/services/T_DiagTestClass1.java",0,1,0,1,1
"java/testing/org/apache/derbyTesting/unitTests/services/T_DiagTestClass1Sub.java",0,1,0,1,1
"java/testing/org/apache/derbyTesting/unitTests/services/T_Diagnosticable.java",0,1,0,1,1
"java/testing/org/apache/derbyTesting/unitTests/services/T_Key.java",0,1,0,1,1
"java/testing/org/apache/derbyTesting/unitTests/services/T_L1.java",0,1,0,1,1
"java/testing/org/apache/derbyTesting/unitTests/services/T_L2.java",0,1,0,1,1
"java/testing/org/apache/derbyTesting/unitTests/services/T_LockFactory.java",0,0.986091794158554,1,1,2
"java/testing/org/apache/derbyTesting/unitTests/services/T_MarkedLimitInputStream.java",0,1,0,1,1
"java/testing/org/apache/derbyTesting/unitTests/services/T_Serviceable.java",0,1,0,1,1
"java/testing/org/apache/derbyTesting/unitTests/services/T_StandardException.java",0,1,0,1,1
"java/testing/org/apache/derbyTesting/unitTests/services/T_UUIDFactory.java",0,1,0,1,1
"java/testing/org/apache/derbyTesting/unitTests/services/T_User.java",0,0.974489795918367,1,1,2
"java/testing/org/apache/derbyTesting/unitTests/store/QualifierUtil.java",0,0.956204379562044,1,1,2
"java/testing/org/apache/derbyTesting/unitTests/store/T_AccessFactory.java",0,0.935056025611708,4,1,5
"java/testing/org/apache/derbyTesting/unitTests/store/T_AccessRow.java",0,1,0,1,1
"java/testing/org/apache/derbyTesting/unitTests/store/T_ColumnOrderingImpl.java",0,0.887323943661972,0,2,2
"java/testing/org/apache/derbyTesting/unitTests/store/T_Compensation.java",0,1,0,1,1
"java/testing/org/apache/derbyTesting/unitTests/store/T_FileSystemData.java",0,1,0,1,1
"java/testing/org/apache/derbyTesting/unitTests/store/T_Heap.java",0,1,0,1,1
"java/testing/org/apache/derbyTesting/unitTests/store/T_QualifierTest.java",0,0.988706945228684,3,1,4
"java/testing/org/apache/derbyTesting/unitTests/store/T_RawStoreFactory.java",0,0.984669811320755,1,1,2
"java/testing/org/apache/derbyTesting/unitTests/store/T_RawStoreRow.java",0,1,0,1,1
"java/testing/org/apache/derbyTesting/unitTests/store/T_RecoverBadLog.java",0,0.976541189307147,3,1,4
"java/testing/org/apache/derbyTesting/unitTests/store/T_RecoverFullLog.java",0,0.976958525345622,2,1,3
"java/testing/org/apache/derbyTesting/unitTests/store/T_Recovery.java",0,0.982889269127353,2,1,3
"java/testing/org/apache/derbyTesting/unitTests/store/T_RowSource.java",0,1,0,1,1
"java/testing/org/apache/derbyTesting/unitTests/store/T_SecondaryIndexRow.java",0,1,0,1,1
"java/testing/org/apache/derbyTesting/unitTests/store/T_SortController.java",0,0.989680082559339,2,1,3
"java/testing/org/apache/derbyTesting/unitTests/store/T_StoreCostResult.java",0,1,0,1,1
"java/testing/org/apache/derbyTesting/unitTests/store/T_StreamFile.java",0,1,0,1,1
"java/testing/org/apache/derbyTesting/unitTests/store/T_TWC.java",0,0.981818181818182,1,1,2
"java/testing/org/apache/derbyTesting/unitTests/store/T_Undoable.java",0,1,0,1,1
"java/testing/org/apache/derbyTesting/unitTests/store/T_Util.java",0,0.954545454545455,1,1,2
"java/testing/org/apache/derbyTesting/unitTests/store/T_XA.java",0,0.992236024844721,1,1,2
"java/testing/org/apache/derbyTesting/unitTests/store/T_b2i.java",0,0.995412844036697,1,1,2
"java/testing/org/apache/derbyTesting/unitTests/util/BitUtil.java",0,1,0,1,1
"java/testing/org/apache/derbyTesting/unitTests/util/MsgTrace.java",0,1,0,1,1
"java/tools/org/apache/derby/iapi/tools/i18n/LocalizedInput.java",0,0.795918367346939,0,3,3
"java/tools/org/apache/derby/iapi/tools/i18n/LocalizedOutput.java",0,0.869565217391304,0,2,2
"java/tools/org/apache/derby/iapi/tools/i18n/LocalizedResource.java",0,0.903409090909091,5,1,6
"java/tools/org/apache/derby/iapi/tools/run.java",0,0.956521739130435,1,1,2
"java/tools/org/apache/derby/impl/tools/dblook/DB_Alias.java",0,0.53960396039604,2,2,4
"java/tools/org/apache/derby/impl/tools/dblook/DB_Check.java",0,0.920353982300885,1,2,3
"java/tools/org/apache/derby/impl/tools/dblook/DB_GrantRevoke.java",0,0.933130699088146,3,1,4
"java/tools/org/apache/derby/impl/tools/dblook/DB_Index.java",0,0.931818181818182,2,1,3
"java/tools/org/apache/derby/impl/tools/dblook/DB_Jar.java",0,0.901960784313726,1,2,3
"java/tools/org/apache/derby/impl/tools/dblook/DB_Key.java",0,0.959409594095941,2,1,3
"java/tools/org/apache/derby/impl/tools/dblook/DB_Roles.java",0,0.994318181818182,1,1,2
"java/tools/org/apache/derby/impl/tools/dblook/DB_Schema.java",0,0.892857142857143,1,2,3
"java/tools/org/apache/derby/impl/tools/dblook/DB_Table.java",0,0.853658536585366,3,2,5
"java/tools/org/apache/derby/impl/tools/dblook/DB_Trigger.java",0,0.951351351351351,2,1,3
"java/tools/org/apache/derby/impl/tools/dblook/DB_View.java",0,0.897959183673469,1,2,3
"java/tools/org/apache/derby/impl/tools/dblook/Logs.java",0,0.964516129032258,2,1,3
"java/tools/org/apache/derby/impl/tools/ij/AsyncStatement.java",0,0.898305084745763,0,2,2
"java/tools/org/apache/derby/impl/tools/ij/AttributeHolder.java",0,0.956204379562044,1,1,2
"java/tools/org/apache/derby/impl/tools/ij/ConnectionEnv.java",0,0.935483870967742,2,1,3
"java/tools/org/apache/derby/impl/tools/ij/Main.java",0,0.755020080321285,2,2,4
"java/tools/org/apache/derby/impl/tools/ij/ParseException.java",0,0.972093023255814,1,1,2
"java/tools/org/apache/derby/impl/tools/ij/Session.java",0,0.868131868131868,4,1,5
"java/tools/org/apache/derby/impl/tools/ij/StatementFinder.java",0,0.69179600886918,1,3,4
"java/tools/org/apache/derby/impl/tools/ij/UCode_CharStream.java",0,0.985611510791367,1,1,2
"java/tools/org/apache/derby/impl/tools/ij/URLCheck.java",0,0.911602209944751,1,2,3
"java/tools/org/apache/derby/impl/tools/ij/ijConnectionResult.java",0,0.863636363636364,0,2,2
"java/tools/org/apache/derby/impl/tools/ij/ijException.java",0,0.904458598726115,3,1,4
"java/tools/org/apache/derby/impl/tools/ij/ijExceptionResult.java",0,0.869565217391304,0,2,2
"java/tools/org/apache/derby/impl/tools/ij/ijFatalException.java",0,0.894736842105263,0,2,2
"java/tools/org/apache/derby/impl/tools/ij/ijMultiResult.java",0,0.894736842105263,0,2,2
"java/tools/org/apache/derby/impl/tools/ij/ijMultipleResultSetResult.java",0,1,0,1,1
"java/tools/org/apache/derby/impl/tools/ij/ijResult.java",0,0.842857142857143,2,2,4
"java/tools/org/apache/derby/impl/tools/ij/ijResultImpl.java",0,0.771084337349398,0,4,4
"java/tools/org/apache/derby/impl/tools/ij/ijResultSetResult.java",0,1,0,1,1
"java/tools/org/apache/derby/impl/tools/ij/ijRowResult.java",0,0.886792452830189,0,2,2
"java/tools/org/apache/derby/impl/tools/ij/ijStatementResult.java",0,0.896551724137931,0,2,2
"java/tools/org/apache/derby/impl/tools/ij/ijTokenException.java",0,0.793103448275862,0,2,2
"java/tools/org/apache/derby/impl/tools/ij/ijVectorResult.java",0,0.872340425531915,0,2,2
"java/tools/org/apache/derby/impl/tools/ij/ijWarningResult.java",0,0.872340425531915,0,2,2
"java/tools/org/apache/derby/impl/tools/ij/mtTestCase.java",0,0.844311377245509,4,2,6
"java/tools/org/apache/derby/impl/tools/ij/mtTestSuite.java",0,0.967914438502674,1,1,2
"java/tools/org/apache/derby/impl/tools/ij/mtTester.java",0,0.904761904761905,2,1,3
"java/tools/org/apache/derby/impl/tools/ij/mtTime.java",0,0.86046511627907,0,2,2
"java/tools/org/apache/derby/impl/tools/ij/util.java",0,0.796966161026838,4,3,7
"java/tools/org/apache/derby/impl/tools/ij/utilMain.java",0,0.922509225092251,6,1,7
"java/tools/org/apache/derby/impl/tools/ij/xaAbstractHelper.java",0,0.890909090909091,0,2,2
"java/tools/org/apache/derby/impl/tools/ij/xaHelper.java",0,0.75867269984917,2,3,5
"java/tools/org/apache/derby/impl/tools/sysinfo/Main.java",0,0.69006309148265,5,3,8
"java/tools/org/apache/derby/impl/tools/sysinfo/ZipInfoProperties.java",0,0.903614457831325,1,2,3
"java/tools/org/apache/derby/tools/JDBCDisplayUtil.java",0,0.8078125,1,3,4
"java/tools/org/apache/derby/tools/SignatureChecker.java",0,1,0,1,1
"java/tools/org/apache/derby/tools/dblook.java",0,0.893011216566005,4,2,6
"java/tools/org/apache/derby/tools/ij.java",0,0.915966386554622,1,2,3
"java/tools/org/apache/derby/tools/sysinfo.java",0,0.855813953488372,0,2,2
"plugins/eclipse/org.apache.derby.ui/src/org/apache/derby/ui/DerbyPlugin.java",0,0.907692307692308,0,2,2
"plugins/eclipse/org.apache.derby.ui/src/org/apache/derby/ui/actions/IJAction.java",0,0.954545454545455,1,1,2
"plugins/eclipse/org.apache.derby.ui/src/org/apache/derby/ui/actions/StartAction.java",0,0.923076923076923,0,2,2
"plugins/eclipse/org.apache.derby.ui/src/org/apache/derby/ui/actions/StopAction.java",0,0.922077922077922,0,2,2
"plugins/eclipse/org.apache.derby.ui/src/org/apache/derby/ui/actions/SysInfoAction.java",0,0.9375,0,2,2
"plugins/eclipse/org.apache.derby.ui/src/org/apache/derby/ui/common/CommonNames.java",0,0.9,0,2,2
"plugins/eclipse/org.apache.derby.ui/src/org/apache/derby/ui/common/Messages.java",0,0.84,1,2,3
"plugins/eclipse/org.apache.derby.ui/src/org/apache/derby/ui/container/DerbyClasspathContainer.java",0,1,0,1,1
"plugins/eclipse/org.apache.derby.ui/src/org/apache/derby/ui/container/DerbyClasspathContainerInitializer.java",0,1,0,1,1
"plugins/eclipse/org.apache.derby.ui/src/org/apache/derby/ui/decorate/DerbyIsRunningDecorator.java",0,0.929411764705882,0,2,2
"plugins/eclipse/org.apache.derby.ui/src/org/apache/derby/ui/launch/IJDerbyLaunchConfigurationDelegate.java",0,0.8,0,2,2
"plugins/eclipse/org.apache.derby.ui/src/org/apache/derby/ui/launch/StartDerbyServerLaunchConfigurationDelegate.java",0,0.793103448275862,0,2,2
"plugins/eclipse/org.apache.derby.ui/src/org/apache/derby/ui/launch/StopDerbyServerLaunchConfigurationDelegate.java",0,0.8,0,2,2
"plugins/eclipse/org.apache.derby.ui/src/org/apache/derby/ui/launch/SysInfoDerbyLaunchConfigurationDelegate.java",0,0.8,0,2,2
"plugins/eclipse/org.apache.derby.ui/src/org/apache/derby/ui/nature/DerbyNature.java",0,0.872340425531915,0,2,2
"plugins/eclipse/org.apache.derby.ui/src/org/apache/derby/ui/popup/actions/AddDerbyNature.java",0,0.797619047619048,0,3,3
"plugins/eclipse/org.apache.derby.ui/src/org/apache/derby/ui/popup/actions/RemoveDerbyNature.java",0,0.844444444444444,1,2,3
"plugins/eclipse/org.apache.derby.ui/src/org/apache/derby/ui/properties/DerbyProperties.java",0,0.951219512195122,1,1,2
"plugins/eclipse/org.apache.derby.ui/src/org/apache/derby/ui/properties/DerbyPropertiesPage.java",0,0.972850678733032,1,1,2
"plugins/eclipse/org.apache.derby.ui/src/org/apache/derby/ui/util/DerbyServerUtils.java",0,0.973214285714286,1,1,2
"plugins/eclipse/org.apache.derby.ui/src/org/apache/derby/ui/util/DerbyUtils.java",0,0.958974358974359,2,1,3
"plugins/eclipse/org.apache.derby.ui/src/org/apache/derby/ui/util/Logger.java",0,0.833333333333333,0,2,2
"plugins/eclipse/org.apache.derby.ui/src/org/apache/derby/ui/util/SelectionUtil.java",0,0.918918918918919,0,2,2
"tools/l10n/LocCompare.java",0,1,0,1,1
