"Filename","X","LineOWN","LineMinor","LineMajor","LineNumDev"
"hbase-client/src/main/java/org/apache/hadoop/hbase/Abortable.java",0,0.577777777777778,0,2,2
"hbase-client/src/main/java/org/apache/hadoop/hbase/Chore.java",0,0.671328671328671,1,5,6
"hbase-client/src/main/java/org/apache/hadoop/hbase/ClusterId.java",0,0.893203883495146,1,2,3
"hbase-client/src/main/java/org/apache/hadoop/hbase/ClusterStatus.java",0,0.3725,5,3,8
"hbase-client/src/main/java/org/apache/hadoop/hbase/Coprocessor.java",0,0.642857142857143,1,3,4
"hbase-client/src/main/java/org/apache/hadoop/hbase/CoprocessorEnvironment.java",0,0.818181818181818,1,3,4
"hbase-client/src/main/java/org/apache/hadoop/hbase/HColumnDescriptor.java",0,0.292937399678973,7,6,13
"hbase-client/src/main/java/org/apache/hadoop/hbase/HRegionInfo.java",0,0.728155339805825,10,2,12
"hbase-client/src/main/java/org/apache/hadoop/hbase/HRegionLocation.java",0,0.488,1,4,5
"hbase-client/src/main/java/org/apache/hadoop/hbase/HTableDescriptor.java",0,0.295138888888889,10,6,16
"hbase-client/src/main/java/org/apache/hadoop/hbase/IpcProtocol.java",0,1,0,1,1
"hbase-client/src/main/java/org/apache/hadoop/hbase/MasterAdminProtocol.java",0,0.361111111111111,0,5,5
"hbase-client/src/main/java/org/apache/hadoop/hbase/MasterMonitorProtocol.java",0,1,0,1,1
"hbase-client/src/main/java/org/apache/hadoop/hbase/MasterProtocol.java",0,1,0,1,1
"hbase-client/src/main/java/org/apache/hadoop/hbase/RegionLoad.java",0,0.733009708737864,1,2,3
"hbase-client/src/main/java/org/apache/hadoop/hbase/RegionTransition.java",0,0.942028985507246,2,1,3
"hbase-client/src/main/java/org/apache/hadoop/hbase/RemoteExceptionHandler.java",0,0.528925619834711,1,2,3
"hbase-client/src/main/java/org/apache/hadoop/hbase/Server.java",0,1,0,1,1
"hbase-client/src/main/java/org/apache/hadoop/hbase/ServerLoad.java",0,0.749174917491749,1,2,3
"hbase-client/src/main/java/org/apache/hadoop/hbase/ServerName.java",0,0.943661971830986,3,1,4
"hbase-client/src/main/java/org/apache/hadoop/hbase/Stoppable.java",0,0.526315789473684,0,2,2
"hbase-client/src/main/java/org/apache/hadoop/hbase/catalog/CatalogTracker.java",0,0.895833333333333,5,2,7
"hbase-client/src/main/java/org/apache/hadoop/hbase/catalog/MetaReader.java",0,0.86437908496732,4,2,6
"hbase-client/src/main/java/org/apache/hadoop/hbase/client/AbstractClientScanner.java",0,0.896103896103896,1,2,3
"hbase-client/src/main/java/org/apache/hadoop/hbase/client/Action.java",0,0.636363636363636,3,2,5
"hbase-client/src/main/java/org/apache/hadoop/hbase/client/AdminProtocol.java",0,0.971428571428571,1,1,2
"hbase-client/src/main/java/org/apache/hadoop/hbase/client/Append.java",0,0.610169491525424,1,2,3
"hbase-client/src/main/java/org/apache/hadoop/hbase/client/Attributes.java",0,0.941176470588235,2,1,3
"hbase-client/src/main/java/org/apache/hadoop/hbase/client/ClientProtocol.java",0,0.972972972972973,1,1,2
"hbase-client/src/main/java/org/apache/hadoop/hbase/client/ClientScanner.java",0,0.866004962779156,2,2,4
"hbase-client/src/main/java/org/apache/hadoop/hbase/client/ClusterStatusListener.java",0,1,0,1,1
"hbase-client/src/main/java/org/apache/hadoop/hbase/client/ConnectionUtils.java",0,0.671641791044776,0,3,3
"hbase-client/src/main/java/org/apache/hadoop/hbase/client/Delete.java",0,0.464539007092199,2,3,5
"hbase-client/src/main/java/org/apache/hadoop/hbase/client/Get.java",0,0.530120481927711,3,4,7
"hbase-client/src/main/java/org/apache/hadoop/hbase/client/HBaseAdmin.java",0,0.405385190725505,15,4,19
"hbase-client/src/main/java/org/apache/hadoop/hbase/client/HConnection.java",0,0.454128440366972,5,6,11
"hbase-client/src/main/java/org/apache/hadoop/hbase/client/HConnectionManager.java",0,0.543597800471328,15,3,18
"hbase-client/src/main/java/org/apache/hadoop/hbase/client/HTable.java",0,0.395315826827537,7,5,12
"hbase-client/src/main/java/org/apache/hadoop/hbase/client/HTableFactory.java",0,0.918367346938776,2,1,3
"hbase-client/src/main/java/org/apache/hadoop/hbase/client/HTableInterface.java",0,0.585895117540687,6,4,10
"hbase-client/src/main/java/org/apache/hadoop/hbase/client/HTableInterfaceFactory.java",0,0.942307692307692,2,1,3
"hbase-client/src/main/java/org/apache/hadoop/hbase/client/HTableMultiplexer.java",0,0.976909413854352,2,1,3
"hbase-client/src/main/java/org/apache/hadoop/hbase/client/HTablePool.java",0,0.714808043875686,5,4,9
"hbase-client/src/main/java/org/apache/hadoop/hbase/client/HTableUtil.java",0,0.948905109489051,2,1,3
"hbase-client/src/main/java/org/apache/hadoop/hbase/client/Increment.java",0,0.524528301886792,3,2,5
"hbase-client/src/main/java/org/apache/hadoop/hbase/client/IsolationLevel.java",0,0.915254237288136,0,2,2
"hbase-client/src/main/java/org/apache/hadoop/hbase/client/MasterAdminKeepAliveConnection.java",0,1,0,1,1
"hbase-client/src/main/java/org/apache/hadoop/hbase/client/MasterMonitorKeepAliveConnection.java",0,1,0,1,1
"hbase-client/src/main/java/org/apache/hadoop/hbase/client/MetaScanner.java",0,0.786240786240786,8,1,9
"hbase-client/src/main/java/org/apache/hadoop/hbase/client/MultiAction.java",0,0.782608695652174,2,3,5
"hbase-client/src/main/java/org/apache/hadoop/hbase/client/MultiResponse.java",0,0.894117647058824,2,2,4
"hbase-client/src/main/java/org/apache/hadoop/hbase/client/MultiServerCallable.java",0,1,0,1,1
"hbase-client/src/main/java/org/apache/hadoop/hbase/client/Mutation.java",0,0.853448275862069,6,1,7
"hbase-client/src/main/java/org/apache/hadoop/hbase/client/NoServerForRegionException.java",0,0.977777777777778,1,1,2
"hbase-client/src/main/java/org/apache/hadoop/hbase/client/Operation.java",0,0.973451327433628,1,1,2
"hbase-client/src/main/java/org/apache/hadoop/hbase/client/OperationWithAttributes.java",0,0.953703703703704,2,1,3
"hbase-client/src/main/java/org/apache/hadoop/hbase/client/Put.java",0,0.590909090909091,2,3,5
"hbase-client/src/main/java/org/apache/hadoop/hbase/client/RegionOfflineException.java",0,0.794871794871795,3,2,5
"hbase-client/src/main/java/org/apache/hadoop/hbase/client/Result.java",0,0.454166666666667,5,3,8
"hbase-client/src/main/java/org/apache/hadoop/hbase/client/ResultScanner.java",0,0.759259259259259,0,3,3
"hbase-client/src/main/java/org/apache/hadoop/hbase/client/RetriesExhaustedException.java",0,0.648648648648649,2,3,5
"hbase-client/src/main/java/org/apache/hadoop/hbase/client/RetriesExhaustedWithDetailsException.java",0,0.638418079096045,3,4,7
"hbase-client/src/main/java/org/apache/hadoop/hbase/client/Row.java",0,0.970588235294118,1,1,2
"hbase-client/src/main/java/org/apache/hadoop/hbase/client/RowMutations.java",0,1,0,1,1
"hbase-client/src/main/java/org/apache/hadoop/hbase/client/Scan.java",0,0.425106990014265,3,6,9
"hbase-client/src/main/java/org/apache/hadoop/hbase/client/ScannerCallable.java",0,0.403785488958991,2,5,7
"hbase-client/src/main/java/org/apache/hadoop/hbase/client/ScannerTimeoutException.java",0,0.795454545454545,1,2,3
"hbase-client/src/main/java/org/apache/hadoop/hbase/client/ServerCallable.java",0,0.543795620437956,2,3,5
"hbase-client/src/main/java/org/apache/hadoop/hbase/client/UnmodifyableHColumnDescriptor.java",0,0.645833333333333,1,4,5
"hbase-client/src/main/java/org/apache/hadoop/hbase/client/UnmodifyableHRegionInfo.java",0,0.886792452830189,0,2,2
"hbase-client/src/main/java/org/apache/hadoop/hbase/client/UnmodifyableHTableDescriptor.java",0,0.748031496062992,1,3,4
"hbase-client/src/main/java/org/apache/hadoop/hbase/client/WrongRowIOException.java",0,1,0,1,1
"hbase-client/src/main/java/org/apache/hadoop/hbase/client/ZooKeeperKeepAliveConnection.java",0,1,0,1,1
"hbase-client/src/main/java/org/apache/hadoop/hbase/client/coprocessor/AggregationClient.java",0,0.577777777777778,2,2,4
"hbase-client/src/main/java/org/apache/hadoop/hbase/client/coprocessor/Batch.java",0,0.824324324324324,0,3,3
"hbase-client/src/main/java/org/apache/hadoop/hbase/client/coprocessor/LongColumnInterpreter.java",0,0.676470588235294,2,2,4
"hbase-client/src/main/java/org/apache/hadoop/hbase/client/coprocessor/SecureBulkLoadClient.java",0,0.988571428571429,1,1,2
"hbase-client/src/main/java/org/apache/hadoop/hbase/client/coprocessor/package-info.java",0,0.52212389380531,1,2,3
"hbase-client/src/main/java/org/apache/hadoop/hbase/client/metrics/ScanMetrics.java",0,0.591549295774648,1,2,3
"hbase-client/src/main/java/org/apache/hadoop/hbase/client/package-info.java",0,0.904761904761905,1,2,3
"hbase-client/src/main/java/org/apache/hadoop/hbase/client/replication/ReplicationAdmin.java",0,0.770334928229665,3,2,5
"hbase-client/src/main/java/org/apache/hadoop/hbase/coprocessor/ColumnInterpreter.java",0,0.573033707865168,1,2,3
"hbase-client/src/main/java/org/apache/hadoop/hbase/exceptions/AccessDeniedException.java",0,0.578947368421053,1,2,3
"hbase-client/src/main/java/org/apache/hadoop/hbase/exceptions/CallerDisconnectedException.java",0,0.9375,2,1,3
"hbase-client/src/main/java/org/apache/hadoop/hbase/exceptions/ClockOutOfSyncException.java",0,0.810810810810811,1,2,3
"hbase-client/src/main/java/org/apache/hadoop/hbase/exceptions/ConstraintException.java",0,0.914893617021277,2,1,3
"hbase-client/src/main/java/org/apache/hadoop/hbase/exceptions/CoprocessorException.java",0,0.907407407407407,1,2,3
"hbase-client/src/main/java/org/apache/hadoop/hbase/exceptions/CorruptHFileException.java",0,0.918918918918919,0,2,2
"hbase-client/src/main/java/org/apache/hadoop/hbase/exceptions/CorruptedSnapshotException.java",0,0.982142857142857,1,1,2
"hbase-client/src/main/java/org/apache/hadoop/hbase/exceptions/DeserializationException.java",0,0.511627906976744,1,2,3
"hbase-client/src/main/java/org/apache/hadoop/hbase/exceptions/DoNotRetryIOException.java",0,0.779661016949153,2,3,5
"hbase-client/src/main/java/org/apache/hadoop/hbase/exceptions/DroppedSnapshotException.java",0,0.804347826086957,0,3,3
"hbase-client/src/main/java/org/apache/hadoop/hbase/exceptions/ExportSnapshotException.java",0,0.976744186046512,1,1,2
"hbase-client/src/main/java/org/apache/hadoop/hbase/exceptions/FailedLogCloseException.java",0,0.804347826086957,1,3,4
"hbase-client/src/main/java/org/apache/hadoop/hbase/exceptions/FailedSanityCheckException.java",0,0.959183673469388,1,1,2
"hbase-client/src/main/java/org/apache/hadoop/hbase/exceptions/FileSystemVersionException.java",0,0.976744186046512,1,1,2
"hbase-client/src/main/java/org/apache/hadoop/hbase/exceptions/HBaseException.java",0,0.5,1,2,3
"hbase-client/src/main/java/org/apache/hadoop/hbase/exceptions/HBaseIOException.java",0,0.9375,0,2,2
"hbase-client/src/main/java/org/apache/hadoop/hbase/exceptions/HBaseSnapshotException.java",0,0.986842105263158,1,1,2
"hbase-client/src/main/java/org/apache/hadoop/hbase/exceptions/InvalidFamilyOperationException.java",0,0.944444444444444,0,2,2
"hbase-client/src/main/java/org/apache/hadoop/hbase/exceptions/InvalidHFileException.java",0,0.906976744186046,1,2,3
"hbase-client/src/main/java/org/apache/hadoop/hbase/exceptions/LeaseException.java",0,0.80952380952381,1,2,3
"hbase-client/src/main/java/org/apache/hadoop/hbase/exceptions/LockTimeoutException.java",0,0.972972972972973,1,1,2
"hbase-client/src/main/java/org/apache/hadoop/hbase/exceptions/MasterNotRunningException.java",0,0.649122807017544,0,3,3
"hbase-client/src/main/java/org/apache/hadoop/hbase/exceptions/NoSuchColumnFamilyException.java",0,0.878048780487805,2,2,4
"hbase-client/src/main/java/org/apache/hadoop/hbase/exceptions/NotAllMetaRegionsOnlineException.java",0,0.844444444444444,1,2,3
"hbase-client/src/main/java/org/apache/hadoop/hbase/exceptions/NotServingRegionException.java",0,0.678571428571429,0,3,3
"hbase-client/src/main/java/org/apache/hadoop/hbase/exceptions/OrphanHLogAfterSplitException.java",0,0.857142857142857,0,3,3
"hbase-client/src/main/java/org/apache/hadoop/hbase/exceptions/OutOfOrderScannerNextException.java",0,0.973684210526316,1,1,2
"hbase-client/src/main/java/org/apache/hadoop/hbase/exceptions/PleaseHoldException.java",0,0.555555555555556,1,3,4
"hbase-client/src/main/java/org/apache/hadoop/hbase/exceptions/RegionAlreadyInTransitionException.java",0,0.692307692307692,0,4,4
"hbase-client/src/main/java/org/apache/hadoop/hbase/exceptions/RegionException.java",0,0.934782608695652,2,1,3
"hbase-client/src/main/java/org/apache/hadoop/hbase/exceptions/RegionMovedException.java",0,0.753246753246753,1,3,4
"hbase-client/src/main/java/org/apache/hadoop/hbase/exceptions/RegionOpeningException.java",0,1,0,1,1
"hbase-client/src/main/java/org/apache/hadoop/hbase/exceptions/RegionServerRunningException.java",0,0.934782608695652,0,2,2
"hbase-client/src/main/java/org/apache/hadoop/hbase/exceptions/RegionServerStoppedException.java",0,0.742857142857143,0,3,3
"hbase-client/src/main/java/org/apache/hadoop/hbase/exceptions/RegionTooBusyException.java",0,0.978723404255319,1,1,2
"hbase-client/src/main/java/org/apache/hadoop/hbase/exceptions/RestoreSnapshotException.java",0,0.976744186046512,1,1,2
"hbase-client/src/main/java/org/apache/hadoop/hbase/exceptions/ServerNotRunningYetException.java",0,0.71875,0,4,4
"hbase-client/src/main/java/org/apache/hadoop/hbase/exceptions/SnapshotCreationException.java",0,0.981481481481482,1,1,2
"hbase-client/src/main/java/org/apache/hadoop/hbase/exceptions/SnapshotDoesNotExistException.java",0,0.977777777777778,1,1,2
"hbase-client/src/main/java/org/apache/hadoop/hbase/exceptions/SnapshotExistsException.java",0,0.975,1,1,2
"hbase-client/src/main/java/org/apache/hadoop/hbase/exceptions/TableExistsException.java",0,0.714285714285714,0,3,3
"hbase-client/src/main/java/org/apache/hadoop/hbase/exceptions/TableInfoMissingException.java",0,0.978723404255319,1,1,2
"hbase-client/src/main/java/org/apache/hadoop/hbase/exceptions/TableNotDisabledException.java",0,0.679245283018868,0,3,3
"hbase-client/src/main/java/org/apache/hadoop/hbase/exceptions/TableNotEnabledException.java",0,0.849056603773585,0,3,3
"hbase-client/src/main/java/org/apache/hadoop/hbase/exceptions/TableNotFoundException.java",0,0.82051282051282,1,2,3
"hbase-client/src/main/java/org/apache/hadoop/hbase/exceptions/TablePartiallyOpenException.java",0,0.92156862745098,1,2,3
"hbase-client/src/main/java/org/apache/hadoop/hbase/exceptions/UnknownProtocolException.java",0,0.956521739130435,1,1,2
"hbase-client/src/main/java/org/apache/hadoop/hbase/exceptions/UnknownRegionException.java",0,0.571428571428571,2,2,4
"hbase-client/src/main/java/org/apache/hadoop/hbase/exceptions/UnknownScannerException.java",0,0.75,1,2,3
"hbase-client/src/main/java/org/apache/hadoop/hbase/exceptions/UnknownSnapshotException.java",0,0.976190476190476,1,1,2
"hbase-client/src/main/java/org/apache/hadoop/hbase/exceptions/WrongRegionException.java",0,0.934782608695652,0,2,2
"hbase-client/src/main/java/org/apache/hadoop/hbase/exceptions/YouAreDeadException.java",0,0.736842105263158,0,3,3
"hbase-client/src/main/java/org/apache/hadoop/hbase/exceptions/ZooKeeperConnectionException.java",0,0.905660377358491,1,2,3
"hbase-client/src/main/java/org/apache/hadoop/hbase/executor/EventType.java",0,0.974576271186441,1,1,2
"hbase-client/src/main/java/org/apache/hadoop/hbase/executor/ExecutorType.java",0,1,0,1,1
"hbase-client/src/main/java/org/apache/hadoop/hbase/filter/BinaryComparator.java",0,0.5,4,3,7
"hbase-client/src/main/java/org/apache/hadoop/hbase/filter/BinaryPrefixComparator.java",0,0.877777777777778,5,1,6
"hbase-client/src/main/java/org/apache/hadoop/hbase/filter/BitComparator.java",0,0.871212121212121,3,2,5
"hbase-client/src/main/java/org/apache/hadoop/hbase/filter/ByteArrayComparable.java",0,0.530612244897959,3,4,7
"hbase-client/src/main/java/org/apache/hadoop/hbase/filter/ColumnCountGetFilter.java",0,0.666666666666667,3,3,6
"hbase-client/src/main/java/org/apache/hadoop/hbase/filter/ColumnPaginationFilter.java",0,0.765957446808511,4,2,6
"hbase-client/src/main/java/org/apache/hadoop/hbase/filter/ColumnPrefixFilter.java",0,0.564285714285714,2,2,4
"hbase-client/src/main/java/org/apache/hadoop/hbase/filter/ColumnRangeFilter.java",0,0.885964912280702,2,2,4
"hbase-client/src/main/java/org/apache/hadoop/hbase/filter/CompareFilter.java",0,0.418994413407821,5,4,9
"hbase-client/src/main/java/org/apache/hadoop/hbase/filter/DependentColumnFilter.java",0,0.4,5,4,9
"hbase-client/src/main/java/org/apache/hadoop/hbase/filter/FamilyFilter.java",0,0.961240310077519,2,1,3
"hbase-client/src/main/java/org/apache/hadoop/hbase/filter/Filter.java",0,0.529182879377432,4,2,6
"hbase-client/src/main/java/org/apache/hadoop/hbase/filter/FilterBase.java",0,0.607734806629834,3,3,6
"hbase-client/src/main/java/org/apache/hadoop/hbase/filter/FilterList.java",0,0.749354005167959,6,3,9
"hbase-client/src/main/java/org/apache/hadoop/hbase/filter/FilterWrapper.java",0,0.619354838709677,1,2,3
"hbase-client/src/main/java/org/apache/hadoop/hbase/filter/FirstKeyOnlyFilter.java",0,0.415929203539823,2,3,5
"hbase-client/src/main/java/org/apache/hadoop/hbase/filter/FirstKeyValueMatchingQualifiersFilter.java",0,0.548387096774194,0,3,3
"hbase-client/src/main/java/org/apache/hadoop/hbase/filter/FuzzyRowFilter.java",0,0.807228915662651,1,2,3
"hbase-client/src/main/java/org/apache/hadoop/hbase/filter/InclusiveStopFilter.java",0,0.428571428571429,3,3,6
"hbase-client/src/main/java/org/apache/hadoop/hbase/filter/IncompatibleFilterException.java",0,0.477272727272727,0,3,3
"hbase-client/src/main/java/org/apache/hadoop/hbase/filter/InvalidRowFilterException.java",0,0.711111111111111,0,2,2
"hbase-client/src/main/java/org/apache/hadoop/hbase/filter/KeyOnlyFilter.java",0,0.465346534653465,3,3,6
"hbase-client/src/main/java/org/apache/hadoop/hbase/filter/MultipleColumnPrefixFilter.java",0,0.853535353535353,1,2,3
"hbase-client/src/main/java/org/apache/hadoop/hbase/filter/NullComparator.java",0,0.561224489795918,3,2,5
"hbase-client/src/main/java/org/apache/hadoop/hbase/filter/PageFilter.java",0,0.435483870967742,5,2,7
"hbase-client/src/main/java/org/apache/hadoop/hbase/filter/ParseConstants.java",0,0.992395437262357,1,1,2
"hbase-client/src/main/java/org/apache/hadoop/hbase/filter/ParseFilter.java",0,0.984971098265896,2,1,3
"hbase-client/src/main/java/org/apache/hadoop/hbase/filter/PrefixFilter.java",0,0.487603305785124,3,3,6
"hbase-client/src/main/java/org/apache/hadoop/hbase/filter/QualifierFilter.java",0,0.5078125,3,2,5
"hbase-client/src/main/java/org/apache/hadoop/hbase/filter/RandomRowFilter.java",0,0.664429530201342,2,2,4
"hbase-client/src/main/java/org/apache/hadoop/hbase/filter/RegexStringComparator.java",0,0.476744186046512,5,3,8
"hbase-client/src/main/java/org/apache/hadoop/hbase/filter/RowFilter.java",0,0.475524475524476,2,2,4
"hbase-client/src/main/java/org/apache/hadoop/hbase/filter/SingleColumnValueExcludeFilter.java",0,0.856353591160221,2,2,4
"hbase-client/src/main/java/org/apache/hadoop/hbase/filter/SingleColumnValueFilter.java",0,0.445876288659794,6,4,10
"hbase-client/src/main/java/org/apache/hadoop/hbase/filter/SkipFilter.java",0,0.445945945945946,5,3,8
"hbase-client/src/main/java/org/apache/hadoop/hbase/filter/SubstringComparator.java",0,0.513513513513513,5,2,7
"hbase-client/src/main/java/org/apache/hadoop/hbase/filter/TimestampsFilter.java",0,0.442528735632184,2,3,5
"hbase-client/src/main/java/org/apache/hadoop/hbase/filter/ValueFilter.java",0,0.806451612903226,2,2,4
"hbase-client/src/main/java/org/apache/hadoop/hbase/filter/WhileMatchFilter.java",0,0.503311258278146,5,2,7
"hbase-client/src/main/java/org/apache/hadoop/hbase/filter/package-info.java",0,0.911764705882353,0,2,2
"hbase-client/src/main/java/org/apache/hadoop/hbase/ipc/BlockingRpcCallback.java",0,0.986301369863014,1,1,2
"hbase-client/src/main/java/org/apache/hadoop/hbase/ipc/CoprocessorRpcChannel.java",0,0.826666666666667,0,3,3
"hbase-client/src/main/java/org/apache/hadoop/hbase/ipc/FatalConnectionException.java",0,1,0,1,1
"hbase-client/src/main/java/org/apache/hadoop/hbase/ipc/HBaseClient.java",0,0.751696065128901,6,3,9
"hbase-client/src/main/java/org/apache/hadoop/hbase/ipc/HBaseClientRPC.java",0,0.888157894736842,2,2,4
"hbase-client/src/main/java/org/apache/hadoop/hbase/ipc/IPCUtil.java",0,1,0,1,1
"hbase-client/src/main/java/org/apache/hadoop/hbase/ipc/MasterCoprocessorRpcChannel.java",0,0.938271604938272,2,1,3
"hbase-client/src/main/java/org/apache/hadoop/hbase/ipc/PayloadCarryingRpcController.java",0,1,0,1,1
"hbase-client/src/main/java/org/apache/hadoop/hbase/ipc/ProtobufRpcClientEngine.java",0,0.626506024096386,1,3,4
"hbase-client/src/main/java/org/apache/hadoop/hbase/ipc/ReflectionCache.java",0,1,0,1,1
"hbase-client/src/main/java/org/apache/hadoop/hbase/ipc/RegionCoprocessorRpcChannel.java",0,0.922330097087379,0,2,2
"hbase-client/src/main/java/org/apache/hadoop/hbase/ipc/RemoteWithExtrasException.java",0,1,0,1,1
"hbase-client/src/main/java/org/apache/hadoop/hbase/ipc/RpcClientEngine.java",0,0.55,0,5,5
"hbase-client/src/main/java/org/apache/hadoop/hbase/ipc/ServerRpcController.java",0,1,0,1,1
"hbase-client/src/main/java/org/apache/hadoop/hbase/master/RegionState.java",0,0.973063973063973,2,1,3
"hbase-client/src/main/java/org/apache/hadoop/hbase/protobuf/ProtobufUtil.java",0,0.785089974293059,10,2,12
"hbase-client/src/main/java/org/apache/hadoop/hbase/protobuf/RequestConverter.java",0,0.81259842519685,4,3,7
"hbase-client/src/main/java/org/apache/hadoop/hbase/protobuf/ResponseConverter.java",0,0.790035587188612,1,3,4
"hbase-client/src/main/java/org/apache/hadoop/hbase/regionserver/BloomType.java",0,1,0,1,1
"hbase-client/src/main/java/org/apache/hadoop/hbase/regionserver/RegionOpeningState.java",0,1,0,1,1
"hbase-client/src/main/java/org/apache/hadoop/hbase/replication/ReplicationPeer.java",0,0.640776699029126,1,3,4
"hbase-client/src/main/java/org/apache/hadoop/hbase/replication/ReplicationStateImpl.java",0,0.975903614457831,1,1,2
"hbase-client/src/main/java/org/apache/hadoop/hbase/replication/ReplicationStateInterface.java",0,0.957446808510638,1,1,2
"hbase-client/src/main/java/org/apache/hadoop/hbase/replication/ReplicationZookeeper.java",0,0.495119787045253,1,4,5
"hbase-client/src/main/java/org/apache/hadoop/hbase/security/AuthMethod.java",0,0.985294117647059,1,1,2
"hbase-client/src/main/java/org/apache/hadoop/hbase/security/HBaseSaslRpcClient.java",0,0.916666666666667,0,2,2
"hbase-client/src/main/java/org/apache/hadoop/hbase/security/KerberosInfo.java",0,0.923076923076923,1,2,3
"hbase-client/src/main/java/org/apache/hadoop/hbase/security/SaslStatus.java",0,0.733333333333333,0,2,2
"hbase-client/src/main/java/org/apache/hadoop/hbase/security/SaslUtil.java",0,0.4375,0,3,3
"hbase-client/src/main/java/org/apache/hadoop/hbase/security/SecureBulkLoadUtil.java",0,0.675,1,2,3
"hbase-client/src/main/java/org/apache/hadoop/hbase/security/TokenInfo.java",0,0.894736842105263,0,3,3
"hbase-client/src/main/java/org/apache/hadoop/hbase/security/User.java",0,0.612293144208038,2,2,4
"hbase-client/src/main/java/org/apache/hadoop/hbase/security/access/Permission.java",0,0.989949748743719,1,1,2
"hbase-client/src/main/java/org/apache/hadoop/hbase/security/access/TablePermission.java",0,0.960912052117264,1,1,2
"hbase-client/src/main/java/org/apache/hadoop/hbase/security/access/UserPermission.java",0,0.826347305389222,0,2,2
"hbase-client/src/main/java/org/apache/hadoop/hbase/security/token/AuthenticationTokenIdentifier.java",0,0.978260869565217,1,1,2
"hbase-client/src/main/java/org/apache/hadoop/hbase/security/token/AuthenticationTokenSelector.java",0,0.962962962962963,1,1,2
"hbase-client/src/main/java/org/apache/hadoop/hbase/snapshot/ClientSnapshotDescriptionUtils.java",0,1,0,1,1
"hbase-client/src/main/java/org/apache/hadoop/hbase/util/HasThread.java",0,0.98,1,1,2
"hbase-client/src/main/java/org/apache/hadoop/hbase/util/PoolMap.java",0,0.944567627494457,3,1,4
"hbase-client/src/main/java/org/apache/hadoop/hbase/util/Sleeper.java",0,0.914529914529915,2,2,4
"hbase-client/src/main/java/org/apache/hadoop/hbase/util/Writables.java",0,0.850299401197605,1,3,4
"hbase-client/src/main/java/org/apache/hadoop/hbase/zookeeper/EmptyWatcher.java",0,0.735294117647059,2,3,5
"hbase-client/src/main/java/org/apache/hadoop/hbase/zookeeper/HQuorumPeer.java",0,0.368098159509202,1,5,6
"hbase-client/src/main/java/org/apache/hadoop/hbase/zookeeper/MasterAddressTracker.java",0,0.983425414364641,1,1,2
"hbase-client/src/main/java/org/apache/hadoop/hbase/zookeeper/MetaNodeTracker.java",0,1,0,1,1
"hbase-client/src/main/java/org/apache/hadoop/hbase/zookeeper/MetaRegionTracker.java",0,0.940217391304348,1,2,3
"hbase-client/src/main/java/org/apache/hadoop/hbase/zookeeper/RecoverableZooKeeper.java",0,0.669642857142857,5,4,9
"hbase-client/src/main/java/org/apache/hadoop/hbase/zookeeper/ZKAssign.java",0,0.707165109034268,4,4,8
"hbase-client/src/main/java/org/apache/hadoop/hbase/zookeeper/ZKClusterId.java",0,0.8,1,2,3
"hbase-client/src/main/java/org/apache/hadoop/hbase/zookeeper/ZKConfig.java",0,0.934065934065934,4,1,5
"hbase-client/src/main/java/org/apache/hadoop/hbase/zookeeper/ZKLeaderManager.java",0,0.939226519337017,2,1,3
"hbase-client/src/main/java/org/apache/hadoop/hbase/zookeeper/ZKTable.java",0,0.611979166666667,3,3,6
"hbase-client/src/main/java/org/apache/hadoop/hbase/zookeeper/ZKTableReadOnly.java",0,0.886792452830189,2,2,4
"hbase-client/src/main/java/org/apache/hadoop/hbase/zookeeper/ZKUtil.java",0,0.642267473858008,11,2,13
"hbase-client/src/main/java/org/apache/hadoop/hbase/zookeeper/ZooKeeperListener.java",0,0.975609756097561,1,1,2
"hbase-client/src/main/java/org/apache/hadoop/hbase/zookeeper/ZooKeeperNodeTracker.java",0,0.807228915662651,0,2,2
"hbase-client/src/main/java/org/apache/hadoop/hbase/zookeeper/ZooKeeperWatcher.java",0,0.753246753246753,9,2,11
"hbase-client/src/test/java/org/apache/hadoop/hbase/client/TestAttributes.java",0,0.982035928143713,1,1,2
"hbase-client/src/test/java/org/apache/hadoop/hbase/client/TestGet.java",0,0.809090909090909,1,3,4
"hbase-client/src/test/java/org/apache/hadoop/hbase/client/TestIncrement.java",0,1,0,1,1
"hbase-client/src/test/java/org/apache/hadoop/hbase/client/TestOperation.java",0,0.637096774193548,1,2,3
"hbase-client/src/test/java/org/apache/hadoop/hbase/client/TestPutDotHas.java",0,1,0,1,1
"hbase-client/src/test/java/org/apache/hadoop/hbase/client/TestScan.java",0,0.891891891891892,1,2,3
"hbase-client/src/test/java/org/apache/hadoop/hbase/client/TestSnapshotFromAdmin.java",0,1,0,1,1
"hbase-client/src/test/java/org/apache/hadoop/hbase/ipc/TestIPCUtil.java",0,1,0,1,1
"hbase-client/src/test/java/org/apache/hadoop/hbase/ipc/TestPayloadCarryingRpcController.java",0,1,0,1,1
"hbase-common/src/main/java/org/apache/hadoop/hbase/Cell.java",0,1,0,1,1
"hbase-common/src/main/java/org/apache/hadoop/hbase/CellComparator.java",0,0.870646766169154,0,2,2
"hbase-common/src/main/java/org/apache/hadoop/hbase/CellScannable.java",0,1,0,1,1
"hbase-common/src/main/java/org/apache/hadoop/hbase/CellScanner.java",0,1,0,1,1
"hbase-common/src/main/java/org/apache/hadoop/hbase/CellUtil.java",0,1,0,1,1
"hbase-common/src/main/java/org/apache/hadoop/hbase/CompoundConfiguration.java",0,0.896969696969697,0,2,2
"hbase-common/src/main/java/org/apache/hadoop/hbase/HBaseConfiguration.java",0,0.54375,2,6,8
"hbase-common/src/main/java/org/apache/hadoop/hbase/HConstants.java",0,0.351190476190476,14,5,19
"hbase-common/src/main/java/org/apache/hadoop/hbase/KeyValue.java",0,0.487718049127803,9,3,12
"hbase-common/src/main/java/org/apache/hadoop/hbase/KeyValueTestUtil.java",0,0.887700534759358,0,2,2
"hbase-common/src/main/java/org/apache/hadoop/hbase/KeyValueUtil.java",0,1,0,1,1
"hbase-common/src/main/java/org/apache/hadoop/hbase/VersionAnnotation.java",0,1,0,1,1
"hbase-common/src/main/java/org/apache/hadoop/hbase/codec/BaseDecoder.java",0,1,0,1,1
"hbase-common/src/main/java/org/apache/hadoop/hbase/codec/BaseEncoder.java",0,1,0,1,1
"hbase-common/src/main/java/org/apache/hadoop/hbase/codec/CellCodec.java",0,1,0,1,1
"hbase-common/src/main/java/org/apache/hadoop/hbase/codec/Codec.java",0,1,0,1,1
"hbase-common/src/main/java/org/apache/hadoop/hbase/codec/CodecException.java",0,1,0,1,1
"hbase-common/src/main/java/org/apache/hadoop/hbase/codec/KeyValueCodec.java",0,1,0,1,1
"hbase-common/src/main/java/org/apache/hadoop/hbase/io/ByteBufferOutputStream.java",0,0.941605839416058,0,2,2
"hbase-common/src/main/java/org/apache/hadoop/hbase/io/CellOutputStream.java",0,0.945454545454545,0,2,2
"hbase-common/src/main/java/org/apache/hadoop/hbase/io/HeapSize.java",0,0.76,0,2,2
"hbase-common/src/main/java/org/apache/hadoop/hbase/io/ImmutableBytesWritable.java",0,0.496350364963504,2,3,5
"hbase-common/src/main/java/org/apache/hadoop/hbase/io/TimeRange.java",0,0.754098360655738,0,3,3
"hbase-common/src/main/java/org/apache/hadoop/hbase/io/compress/Compression.java",0,0.599552572706935,3,4,7
"hbase-common/src/main/java/org/apache/hadoop/hbase/io/compress/ReusableStreamGzipCodec.java",0,0.683937823834197,2,2,4
"hbase-common/src/main/java/org/apache/hadoop/hbase/io/encoding/BufferedDataBlockEncoder.java",0,0.938666666666667,1,2,3
"hbase-common/src/main/java/org/apache/hadoop/hbase/io/encoding/CompressionState.java",0,0.983050847457627,1,1,2
"hbase-common/src/main/java/org/apache/hadoop/hbase/io/encoding/CopyKeyDataBlockEncoder.java",0,0.979591836734694,1,1,2
"hbase-common/src/main/java/org/apache/hadoop/hbase/io/encoding/DataBlockEncoder.java",0,0.980295566502463,2,1,3
"hbase-common/src/main/java/org/apache/hadoop/hbase/io/encoding/DataBlockEncoding.java",0,0.854922279792746,0,3,3
"hbase-common/src/main/java/org/apache/hadoop/hbase/io/encoding/DiffKeyDeltaEncoder.java",0,0.990925589836661,1,1,2
"hbase-common/src/main/java/org/apache/hadoop/hbase/io/encoding/EncodedDataBlock.java",0,0.97196261682243,3,1,4
"hbase-common/src/main/java/org/apache/hadoop/hbase/io/encoding/EncoderBufferTooSmallException.java",0,0.903225806451613,0,2,2
"hbase-common/src/main/java/org/apache/hadoop/hbase/io/encoding/FastDiffDeltaEncoder.java",0,0.994515539305302,1,1,2
"hbase-common/src/main/java/org/apache/hadoop/hbase/io/encoding/HFileBlockDecodingContext.java",0,0.792452830188679,1,2,3
"hbase-common/src/main/java/org/apache/hadoop/hbase/io/encoding/HFileBlockDefaultDecodingContext.java",0,0.836065573770492,1,2,3
"hbase-common/src/main/java/org/apache/hadoop/hbase/io/encoding/HFileBlockDefaultEncodingContext.java",0,0.959183673469388,3,1,4
"hbase-common/src/main/java/org/apache/hadoop/hbase/io/encoding/HFileBlockEncodingContext.java",0,0.918604651162791,1,2,3
"hbase-common/src/main/java/org/apache/hadoop/hbase/io/encoding/PrefixKeyDeltaEncoder.java",0,0.984771573604061,1,1,2
"hbase-common/src/main/java/org/apache/hadoop/hbase/io/hfile/BlockType.java",0,0.694063926940639,1,3,4
"hbase-common/src/main/java/org/apache/hadoop/hbase/util/Addressing.java",0,1,0,1,1
"hbase-common/src/main/java/org/apache/hadoop/hbase/util/ArrayUtils.java",0,1,0,1,1
"hbase-common/src/main/java/org/apache/hadoop/hbase/util/ByteBufferArray.java",0,1,0,1,1
"hbase-common/src/main/java/org/apache/hadoop/hbase/util/ByteBufferUtils.java",0,0.914660831509847,0,2,2
"hbase-common/src/main/java/org/apache/hadoop/hbase/util/ByteRange.java",0,1,0,1,1
"hbase-common/src/main/java/org/apache/hadoop/hbase/util/ByteRangeTool.java",0,0.815384615384615,0,2,2
"hbase-common/src/main/java/org/apache/hadoop/hbase/util/Bytes.java",0,0.573234984193888,6,4,10
"hbase-common/src/main/java/org/apache/hadoop/hbase/util/ClassSize.java",0,0.599388379204893,2,3,5
"hbase-common/src/main/java/org/apache/hadoop/hbase/util/Classes.java",0,0.939759036144578,0,2,2
"hbase-common/src/main/java/org/apache/hadoop/hbase/util/CollectionUtils.java",0,1,0,1,1
"hbase-common/src/main/java/org/apache/hadoop/hbase/util/DefaultEnvironmentEdge.java",0,0.878048780487805,0,2,2
"hbase-common/src/main/java/org/apache/hadoop/hbase/util/DrainBarrier.java",0,1,0,1,1
"hbase-common/src/main/java/org/apache/hadoop/hbase/util/EnvironmentEdge.java",0,0.875,0,2,2
"hbase-common/src/main/java/org/apache/hadoop/hbase/util/EnvironmentEdgeManager.java",0,0.911392405063291,1,2,3
"hbase-common/src/main/java/org/apache/hadoop/hbase/util/Hash.java",0,0.978102189781022,2,1,3
"hbase-common/src/main/java/org/apache/hadoop/hbase/util/IncrementingEnvironmentEdge.java",0,0.578125,1,2,3
"hbase-common/src/main/java/org/apache/hadoop/hbase/util/IterableUtils.java",0,0.560975609756098,1,2,3
"hbase-common/src/main/java/org/apache/hadoop/hbase/util/JVM.java",0,0.725961538461538,0,3,3
"hbase-common/src/main/java/org/apache/hadoop/hbase/util/JenkinsHash.java",0,0.609195402298851,1,2,3
"hbase-common/src/main/java/org/apache/hadoop/hbase/util/MD5Hash.java",0,1,0,1,1
"hbase-common/src/main/java/org/apache/hadoop/hbase/util/Methods.java",0,0.942028985507246,0,2,2
"hbase-common/src/main/java/org/apache/hadoop/hbase/util/MurmurHash.java",0,0.978260869565217,1,1,2
"hbase-common/src/main/java/org/apache/hadoop/hbase/util/Pair.java",0,0.614814814814815,0,4,4
"hbase-common/src/main/java/org/apache/hadoop/hbase/util/PairOfSameType.java",0,1,0,1,1
"hbase-common/src/main/java/org/apache/hadoop/hbase/util/ReflectionUtils.java",0,1,0,1,1
"hbase-common/src/main/java/org/apache/hadoop/hbase/util/RetryCounter.java",0,0.811594202898551,1,2,3
"hbase-common/src/main/java/org/apache/hadoop/hbase/util/RetryCounterFactory.java",0,1,0,1,1
"hbase-common/src/main/java/org/apache/hadoop/hbase/util/SoftValueSortedMap.java",0,0.418685121107266,3,4,7
"hbase-common/src/main/java/org/apache/hadoop/hbase/util/Strings.java",0,0.991379310344828,1,1,2
"hbase-common/src/main/java/org/apache/hadoop/hbase/util/Threads.java",0,0.914634146341463,1,2,3
"hbase-common/src/main/java/org/apache/hadoop/hbase/util/Triple.java",0,1,0,1,1
"hbase-common/src/main/java/org/apache/hadoop/hbase/util/VersionInfo.java",0,0.793103448275862,2,2,4
"hbase-common/src/main/java/org/apache/hadoop/hbase/util/test/LoadTestDataGenerator.java",0,1,0,1,1
"hbase-common/src/main/java/org/apache/hadoop/hbase/util/test/LoadTestKVGenerator.java",0,0.761904761904762,2,2,4
"hbase-common/src/main/java/org/apache/hadoop/hbase/util/test/RedundantKVGenerator.java",0,0.674242424242424,1,2,3
"hbase-common/src/test/java/org/apache/hadoop/hbase/ClassFinder.java",0,1,0,1,1
"hbase-common/src/test/java/org/apache/hadoop/hbase/ClassTestFinder.java",0,1,0,1,1
"hbase-common/src/test/java/org/apache/hadoop/hbase/HBaseCommonTestingUtility.java",0,0.987179487179487,1,1,2
"hbase-common/src/test/java/org/apache/hadoop/hbase/IntegrationTests.java",0,1,0,1,1
"hbase-common/src/test/java/org/apache/hadoop/hbase/LargeTests.java",0,0.973684210526316,1,1,2
"hbase-common/src/test/java/org/apache/hadoop/hbase/MediumTests.java",0,0.972972972972973,1,1,2
"hbase-common/src/test/java/org/apache/hadoop/hbase/ResourceChecker.java",0,0.904109589041096,0,2,2
"hbase-common/src/test/java/org/apache/hadoop/hbase/ResourceCheckerJUnitListener.java",0,0.683229813664596,1,2,3
"hbase-common/src/test/java/org/apache/hadoop/hbase/SmallTests.java",0,0.970588235294118,1,1,2
"hbase-common/src/test/java/org/apache/hadoop/hbase/TestClassFinder.java",0,0.94300518134715,0,2,2
"hbase-common/src/test/java/org/apache/hadoop/hbase/TestCompoundConfiguration.java",0,0.738255033557047,0,2,2
"hbase-common/src/test/java/org/apache/hadoop/hbase/TestKeyValue.java",0,0.5,3,4,7
"hbase-common/src/test/java/org/apache/hadoop/hbase/Waiter.java",0,1,0,1,1
"hbase-common/src/test/java/org/apache/hadoop/hbase/codec/TestCellCodec.java",0,1,0,1,1
"hbase-common/src/test/java/org/apache/hadoop/hbase/codec/TestKeyValueCodec.java",0,1,0,1,1
"hbase-common/src/test/java/org/apache/hadoop/hbase/util/EnvironmentEdgeManagerTestHelper.java",0,1,0,1,1
"hbase-common/src/test/java/org/apache/hadoop/hbase/util/TestByteRange.java",0,1,0,1,1
"hbase-common/src/test/java/org/apache/hadoop/hbase/util/TestBytes.java",0,0.524625267665953,3,5,8
"hbase-common/src/test/java/org/apache/hadoop/hbase/util/TestDrainBarrier.java",0,1,0,1,1
"hbase-common/src/test/java/org/apache/hadoop/hbase/util/TestEnvironmentEdgeManager.java",0,0.911764705882353,3,1,4
"hbase-common/src/test/java/org/apache/hadoop/hbase/util/TestLoadTestKVGenerator.java",0,0.828947368421053,2,3,5
"hbase-common/src/test/java/org/apache/hadoop/hbase/util/TestThreads.java",0,0.948051948051948,0,2,2
"hbase-examples/src/main/java/org/apache/hadoop/hbase/coprocessor/example/BulkDeleteEndpoint.java",0,0.993103448275862,2,1,3
"hbase-examples/src/main/java/org/apache/hadoop/hbase/coprocessor/example/RowCountEndpoint.java",0,0.99390243902439,1,1,2
"hbase-examples/src/main/java/org/apache/hadoop/hbase/coprocessor/example/ZooKeeperScanPolicyObserver.java",0,0.918803418803419,2,2,4
"hbase-examples/src/main/java/org/apache/hadoop/hbase/coprocessor/example/generated/BulkDeleteProtos.java",0,1,0,1,1
"hbase-examples/src/main/java/org/apache/hadoop/hbase/coprocessor/example/generated/ExampleProtos.java",0,1,0,1,1
"hbase-examples/src/main/java/org/apache/hadoop/hbase/mapreduce/IndexBuilder.java",0,0.927631578947368,3,1,4
"hbase-examples/src/main/java/org/apache/hadoop/hbase/mapreduce/SampleUploader.java",0,0.72108843537415,0,2,2
"hbase-examples/src/main/java/org/apache/hadoop/hbase/thrift/DemoClient.java",0,0.976401179941003,2,1,3
"hbase-examples/src/main/java/org/apache/hadoop/hbase/thrift/generated/AlreadyExists.java",0,1,0,1,1
"hbase-examples/src/main/java/org/apache/hadoop/hbase/thrift/generated/BatchMutation.java",0,1,0,1,1
"hbase-examples/src/main/java/org/apache/hadoop/hbase/thrift/generated/ColumnDescriptor.java",0,1,0,1,1
"hbase-examples/src/main/java/org/apache/hadoop/hbase/thrift/generated/Hbase.java",0,1,0,1,1
"hbase-examples/src/main/java/org/apache/hadoop/hbase/thrift/generated/IOError.java",0,1,0,1,1
"hbase-examples/src/main/java/org/apache/hadoop/hbase/thrift/generated/IllegalArgument.java",0,1,0,1,1
"hbase-examples/src/main/java/org/apache/hadoop/hbase/thrift/generated/Mutation.java",0,1,0,1,1
"hbase-examples/src/main/java/org/apache/hadoop/hbase/thrift/generated/TCell.java",0,1,0,1,1
"hbase-examples/src/main/java/org/apache/hadoop/hbase/thrift/generated/TIncrement.java",0,1,0,1,1
"hbase-examples/src/main/java/org/apache/hadoop/hbase/thrift/generated/TRegionInfo.java",0,1,0,1,1
"hbase-examples/src/main/java/org/apache/hadoop/hbase/thrift/generated/TRowResult.java",0,1,0,1,1
"hbase-examples/src/main/java/org/apache/hadoop/hbase/thrift/generated/TScan.java",0,1,0,1,1
"hbase-examples/src/test/java/org/apache/hadoop/hbase/coprocessor/example/TestBulkDeleteProtocol.java",0,0.966216216216216,1,1,2
"hbase-examples/src/test/java/org/apache/hadoop/hbase/coprocessor/example/TestRowCountEndpoint.java",0,0.963302752293578,1,1,2
"hbase-examples/src/test/java/org/apache/hadoop/hbase/coprocessor/example/TestZooKeeperScanPolicyObserver.java",0,0.962406015037594,1,1,2
"hbase-examples/thrift2/DemoClient.java",0,0.98876404494382,1,1,2
"hbase-hadoop-compat/src/main/java/org/apache/hadoop/hbase/CompatibilityFactory.java",0,1,0,1,1
"hbase-hadoop-compat/src/main/java/org/apache/hadoop/hbase/CompatibilitySingletonFactory.java",0,0.888888888888889,1,2,3
"hbase-hadoop-compat/src/main/java/org/apache/hadoop/hbase/ipc/MetricsHBaseServerSource.java",0,1,0,1,1
"hbase-hadoop-compat/src/main/java/org/apache/hadoop/hbase/ipc/MetricsHBaseServerSourceFactory.java",0,1,0,1,1
"hbase-hadoop-compat/src/main/java/org/apache/hadoop/hbase/ipc/MetricsHBaseServerWrapper.java",0,1,0,1,1
"hbase-hadoop-compat/src/main/java/org/apache/hadoop/hbase/master/MetricsMasterSource.java",0,0.513761467889908,0,3,3
"hbase-hadoop-compat/src/main/java/org/apache/hadoop/hbase/master/MetricsMasterSourceFactory.java",0,0.857142857142857,0,2,2
"hbase-hadoop-compat/src/main/java/org/apache/hadoop/hbase/master/MetricsMasterWrapper.java",0,0.851063829787234,0,2,2
"hbase-hadoop-compat/src/main/java/org/apache/hadoop/hbase/metrics/BaseSource.java",0,0.495652173913044,0,3,3
"hbase-hadoop-compat/src/main/java/org/apache/hadoop/hbase/metrics/MBeanSource.java",0,0.973684210526316,1,1,2
"hbase-hadoop-compat/src/main/java/org/apache/hadoop/hbase/regionserver/MetricsRegionAggregateSource.java",0,0.548387096774194,1,2,3
"hbase-hadoop-compat/src/main/java/org/apache/hadoop/hbase/regionserver/MetricsRegionServerSource.java",0,1,0,1,1
"hbase-hadoop-compat/src/main/java/org/apache/hadoop/hbase/regionserver/MetricsRegionServerSourceFactory.java",0,0.731707317073171,0,2,2
"hbase-hadoop-compat/src/main/java/org/apache/hadoop/hbase/regionserver/MetricsRegionServerWrapper.java",0,1,0,1,1
"hbase-hadoop-compat/src/main/java/org/apache/hadoop/hbase/regionserver/MetricsRegionSource.java",0,0.532258064516129,0,2,2
"hbase-hadoop-compat/src/main/java/org/apache/hadoop/hbase/regionserver/MetricsRegionWrapper.java",0,1,0,1,1
"hbase-hadoop-compat/src/main/java/org/apache/hadoop/hbase/regionserver/wal/MetricsWALSource.java",0,1,0,1,1
"hbase-hadoop-compat/src/main/java/org/apache/hadoop/hbase/replication/regionserver/MetricsReplicationSource.java",0,0.770833333333333,0,3,3
"hbase-hadoop-compat/src/main/java/org/apache/hadoop/hbase/rest/MetricsRESTSource.java",0,0.877551020408163,0,2,2
"hbase-hadoop-compat/src/main/java/org/apache/hadoop/hbase/thrift/MetricsThriftServerSource.java",0,0.961538461538462,1,1,2
"hbase-hadoop-compat/src/main/java/org/apache/hadoop/hbase/thrift/MetricsThriftServerSourceFactory.java",0,0.621621621621622,0,3,3
"hbase-hadoop-compat/src/main/java/org/apache/hadoop/metrics2/MetricHistogram.java",0,0.813953488372093,0,2,2
"hbase-hadoop-compat/src/main/java/org/apache/hadoop/metrics2/MetricsExecutor.java",0,0.9375,0,2,2
"hbase-hadoop-compat/src/test/java/org/apache/hadoop/hbase/HadoopShims.java",0,1,0,1,1
"hbase-hadoop-compat/src/test/java/org/apache/hadoop/hbase/master/TestMetricsMasterSourceFactory.java",0,0.805555555555556,1,2,3
"hbase-hadoop-compat/src/test/java/org/apache/hadoop/hbase/regionserver/TestMetricsRegionServerSourceFactory.java",0,0.805555555555556,1,2,3
"hbase-hadoop-compat/src/test/java/org/apache/hadoop/hbase/regionserver/wal/TestMetricsHLogSource.java",0,1,0,1,1
"hbase-hadoop-compat/src/test/java/org/apache/hadoop/hbase/replication/regionserver/TestMetricsReplicationSourceFactory.java",0,0.857142857142857,0,2,2
"hbase-hadoop-compat/src/test/java/org/apache/hadoop/hbase/rest/TestMetricsRESTSource.java",0,0.810810810810811,0,3,3
"hbase-hadoop-compat/src/test/java/org/apache/hadoop/hbase/test/MetricsAssertHelper.java",0,0.825806451612903,0,2,2
"hbase-hadoop-compat/src/test/java/org/apache/hadoop/hbase/thrift/TestMetricsThriftServerSourceFactory.java",0,0.783783783783784,0,3,3
"hbase-hadoop1-compat/src/main/java/org/apache/hadoop/hbase/ipc/MetricsHBaseServerSourceFactoryImpl.java",0,1,0,1,1
"hbase-hadoop1-compat/src/main/java/org/apache/hadoop/hbase/ipc/MetricsHBaseServerSourceImpl.java",0,1,0,1,1
"hbase-hadoop1-compat/src/main/java/org/apache/hadoop/hbase/mapreduce/JobUtil.java",0,1,0,1,1
"hbase-hadoop1-compat/src/main/java/org/apache/hadoop/hbase/master/MetricsMasterSourceFactoryImpl.java",0,0.783783783783784,0,2,2
"hbase-hadoop1-compat/src/main/java/org/apache/hadoop/hbase/master/MetricsMasterSourceImpl.java",0,0.522388059701492,0,3,3
"hbase-hadoop1-compat/src/main/java/org/apache/hadoop/hbase/metrics/BaseSourceImpl.java",0,0.543478260869565,0,3,3
"hbase-hadoop1-compat/src/main/java/org/apache/hadoop/hbase/metrics/MBeanSourceImpl.java",0,1,0,1,1
"hbase-hadoop1-compat/src/main/java/org/apache/hadoop/hbase/regionserver/MetricsRegionAggregateSourceImpl.java",0,1,0,1,1
"hbase-hadoop1-compat/src/main/java/org/apache/hadoop/hbase/regionserver/MetricsRegionServerSourceFactoryImpl.java",0,1,0,1,1
"hbase-hadoop1-compat/src/main/java/org/apache/hadoop/hbase/regionserver/MetricsRegionServerSourceImpl.java",0,1,0,1,1
"hbase-hadoop1-compat/src/main/java/org/apache/hadoop/hbase/regionserver/MetricsRegionSourceImpl.java",0,0.958823529411765,1,1,2
"hbase-hadoop1-compat/src/main/java/org/apache/hadoop/hbase/regionserver/wal/MetricsWALSourceImpl.java",0,1,0,1,1
"hbase-hadoop1-compat/src/main/java/org/apache/hadoop/hbase/replication/regionserver/MetricsReplicationSourceImpl.java",0,0.666666666666667,0,3,3
"hbase-hadoop1-compat/src/main/java/org/apache/hadoop/hbase/rest/MetricsRESTSourceImpl.java",0,0.929292929292929,0,2,2
"hbase-hadoop1-compat/src/main/java/org/apache/hadoop/hbase/thrift/MetricsThriftServerSourceFactoryImpl.java",0,0.884615384615385,0,2,2
"hbase-hadoop1-compat/src/main/java/org/apache/hadoop/hbase/thrift/MetricsThriftServerSourceImpl.java",0,0.918367346938776,0,2,2
"hbase-hadoop1-compat/src/main/java/org/apache/hadoop/metrics2/impl/JmxCacheBuster.java",0,0.961538461538462,1,1,2
"hbase-hadoop1-compat/src/main/java/org/apache/hadoop/metrics2/lib/DynamicMetricsRegistry.java",0,0.795045045045045,1,2,3
"hbase-hadoop1-compat/src/main/java/org/apache/hadoop/metrics2/lib/MetricMutableHistogram.java",0,0.991735537190083,1,1,2
"hbase-hadoop1-compat/src/main/java/org/apache/hadoop/metrics2/lib/MetricMutableQuantiles.java",0,0.985611510791367,1,1,2
"hbase-hadoop1-compat/src/main/java/org/apache/hadoop/metrics2/lib/MetricsExecutorImpl.java",0,0.984848484848485,1,1,2
"hbase-hadoop1-compat/src/main/java/org/apache/hadoop/metrics2/util/MetricQuantile.java",0,1,0,1,1
"hbase-hadoop1-compat/src/main/java/org/apache/hadoop/metrics2/util/MetricSampleQuantiles.java",0,1,0,1,1
"hbase-hadoop1-compat/src/test/java/org/apache/hadoop/hbase/HadoopShimsImpl.java",0,1,0,1,1
"hbase-hadoop1-compat/src/test/java/org/apache/hadoop/hbase/master/TestMetricsMasterSourceImpl.java",0,0.75,0,2,2
"hbase-hadoop1-compat/src/test/java/org/apache/hadoop/hbase/metrics/TestBaseSourceImpl.java",0,0.934065934065934,0,2,2
"hbase-hadoop1-compat/src/test/java/org/apache/hadoop/hbase/regionserver/TestMetricsRegionServerSourceImpl.java",0,0.647058823529412,0,2,2
"hbase-hadoop1-compat/src/test/java/org/apache/hadoop/hbase/regionserver/TestMetricsRegionSourceImpl.java",0,1,0,1,1
"hbase-hadoop1-compat/src/test/java/org/apache/hadoop/hbase/regionserver/wal/TestMetricsWALSourceImpl.java",0,1,0,1,1
"hbase-hadoop1-compat/src/test/java/org/apache/hadoop/hbase/replication/regionserver/TestReplicationMetricsSourceImpl.java",0,0.794871794871795,1,2,3
"hbase-hadoop1-compat/src/test/java/org/apache/hadoop/hbase/rest/TestRESTMetricsSourceImpl.java",0,0.75,0,3,3
"hbase-hadoop1-compat/src/test/java/org/apache/hadoop/hbase/test/MetricsAssertHelperImpl.java",0,0.885321100917431,0,2,2
"hbase-hadoop1-compat/src/test/java/org/apache/hadoop/hbase/thrift/TestThriftServerMetricsSourceFactoryImpl.java",0,0.818181818181818,0,2,2
"hbase-hadoop2-compat/src/main/java/org/apache/hadoop/hbase/ipc/MetricsHBaseServerSourceFactoryImpl.java",0,1,0,1,1
"hbase-hadoop2-compat/src/main/java/org/apache/hadoop/hbase/ipc/MetricsHBaseServerSourceImpl.java",0,1,0,1,1
"hbase-hadoop2-compat/src/main/java/org/apache/hadoop/hbase/mapreduce/JobUtil.java",0,1,0,1,1
"hbase-hadoop2-compat/src/main/java/org/apache/hadoop/hbase/master/MetricsMasterSourceFactoryImpl.java",0,0.783783783783784,0,2,2
"hbase-hadoop2-compat/src/main/java/org/apache/hadoop/hbase/master/MetricsMasterSourceImpl.java",0,0.492424242424242,0,3,3
"hbase-hadoop2-compat/src/main/java/org/apache/hadoop/hbase/metrics/BaseSourceImpl.java",0,0.494318181818182,0,3,3
"hbase-hadoop2-compat/src/main/java/org/apache/hadoop/hbase/metrics/MBeanSourceImpl.java",0,1,0,1,1
"hbase-hadoop2-compat/src/main/java/org/apache/hadoop/hbase/regionserver/MetricsRegionAggregateSourceImpl.java",0,1,0,1,1
"hbase-hadoop2-compat/src/main/java/org/apache/hadoop/hbase/regionserver/MetricsRegionServerSourceFactoryImpl.java",0,1,0,1,1
"hbase-hadoop2-compat/src/main/java/org/apache/hadoop/hbase/regionserver/MetricsRegionServerSourceImpl.java",0,1,0,1,1
"hbase-hadoop2-compat/src/main/java/org/apache/hadoop/hbase/regionserver/MetricsRegionSourceImpl.java",0,0.951807228915663,1,1,2
"hbase-hadoop2-compat/src/main/java/org/apache/hadoop/hbase/regionserver/wal/MetricsWALSourceImpl.java",0,1,0,1,1
"hbase-hadoop2-compat/src/main/java/org/apache/hadoop/hbase/replication/regionserver/MetricsReplicationSourceImpl.java",0,0.651162790697674,0,3,3
"hbase-hadoop2-compat/src/main/java/org/apache/hadoop/hbase/rest/MetricsRESTSourceImpl.java",0,0.919191919191919,0,2,2
"hbase-hadoop2-compat/src/main/java/org/apache/hadoop/hbase/thrift/MetricsThriftServerSourceFactoryImpl.java",0,0.862745098039216,0,2,2
"hbase-hadoop2-compat/src/main/java/org/apache/hadoop/hbase/thrift/MetricsThriftServerSourceImpl.java",0,0.898989898989899,0,2,2
"hbase-hadoop2-compat/src/main/java/org/apache/hadoop/metrics2/impl/JmxCacheBuster.java",0,0.962025316455696,1,1,2
"hbase-hadoop2-compat/src/main/java/org/apache/hadoop/metrics2/lib/DynamicMetricsRegistry.java",0,0.84981684981685,1,2,3
"hbase-hadoop2-compat/src/main/java/org/apache/hadoop/metrics2/lib/MetricMutableQuantiles.java",0,0.987261146496815,1,1,2
"hbase-hadoop2-compat/src/main/java/org/apache/hadoop/metrics2/lib/MetricsExecutorImpl.java",0,0.984848484848485,1,1,2
"hbase-hadoop2-compat/src/main/java/org/apache/hadoop/metrics2/lib/MutableHistogram.java",0,0.992424242424242,1,1,2
"hbase-hadoop2-compat/src/main/java/org/apache/hadoop/metrics2/util/MetricQuantile.java",0,1,0,1,1
"hbase-hadoop2-compat/src/main/java/org/apache/hadoop/metrics2/util/MetricSampleQuantiles.java",0,1,0,1,1
"hbase-hadoop2-compat/src/test/java/org/apache/hadoop/hbase/HadoopShimsImpl.java",0,1,0,1,1
"hbase-hadoop2-compat/src/test/java/org/apache/hadoop/hbase/master/TestMetricsMasterSourceImpl.java",0,0.75,0,2,2
"hbase-hadoop2-compat/src/test/java/org/apache/hadoop/hbase/metrics/TestBaseSourceImpl.java",0,0.928571428571429,0,2,2
"hbase-hadoop2-compat/src/test/java/org/apache/hadoop/hbase/regionserver/TestMetricsRegionServerSourceImpl.java",0,0.66,0,2,2
"hbase-hadoop2-compat/src/test/java/org/apache/hadoop/hbase/regionserver/TestMetricsRegionSourceImpl.java",0,1,0,1,1
"hbase-hadoop2-compat/src/test/java/org/apache/hadoop/hbase/regionserver/wal/TestMetricsWALSourceImpl.java",0,1,0,1,1
"hbase-hadoop2-compat/src/test/java/org/apache/hadoop/hbase/replication/regionserver/TestMetricsReplicationSourceImpl.java",0,0.783783783783784,0,2,2
"hbase-hadoop2-compat/src/test/java/org/apache/hadoop/hbase/rest/TestMetricsRESTSourceImpl.java",0,0.75,0,3,3
"hbase-hadoop2-compat/src/test/java/org/apache/hadoop/hbase/test/MetricsAssertHelperImpl.java",0,0.894957983193277,0,2,2
"hbase-hadoop2-compat/src/test/java/org/apache/hadoop/hbase/thrift/TestMetricsThriftServerSourceFactoryImpl.java",0,0.8,0,2,2
"hbase-it/src/test/java/org/apache/hadoop/hbase/ClusterManager.java",0,1,0,1,1
"hbase-it/src/test/java/org/apache/hadoop/hbase/DistributedHBaseCluster.java",0,0.982935153583618,2,1,3
"hbase-it/src/test/java/org/apache/hadoop/hbase/HBaseClusterManager.java",0,1,0,1,1
"hbase-it/src/test/java/org/apache/hadoop/hbase/IngestIntegrationTestBase.java",0,1,0,1,1
"hbase-it/src/test/java/org/apache/hadoop/hbase/IntegrationTestDataIngestWithChaosMonkey.java",0,1,0,1,1
"hbase-it/src/test/java/org/apache/hadoop/hbase/IntegrationTestLazyCfLoading.java",0,1,0,1,1
"hbase-it/src/test/java/org/apache/hadoop/hbase/IntegrationTestManyRegions.java",0,1,0,1,1
"hbase-it/src/test/java/org/apache/hadoop/hbase/IntegrationTestRebalanceAndKillServersTargeted.java",0,1,0,1,1
"hbase-it/src/test/java/org/apache/hadoop/hbase/IntegrationTestingUtility.java",0,0.928057553956835,0,2,2
"hbase-it/src/test/java/org/apache/hadoop/hbase/IntegrationTestsDriver.java",0,1,0,1,1
"hbase-it/src/test/java/org/apache/hadoop/hbase/mapreduce/IntegrationTestImportTsv.java",0,0.508021390374332,0,3,3
"hbase-it/src/test/java/org/apache/hadoop/hbase/test/IntegrationTestBigLinkedList.java",0,1,0,1,1
"hbase-it/src/test/java/org/apache/hadoop/hbase/test/IntegrationTestLoadAndVerify.java",0,1,0,1,1
"hbase-it/src/test/java/org/apache/hadoop/hbase/util/ChaosMonkey.java",0,1,0,1,1
"hbase-prefix-tree/src/main/java/org/apache/hadoop/hbase/codec/prefixtree/PrefixTreeBlockMeta.java",0,0.995243757431629,1,1,2
"hbase-prefix-tree/src/main/java/org/apache/hadoop/hbase/codec/prefixtree/PrefixTreeCodec.java",0,0.933014354066986,0,2,2
"hbase-prefix-tree/src/main/java/org/apache/hadoop/hbase/codec/prefixtree/PrefixTreeSeeker.java",0,0.902325581395349,0,2,2
"hbase-prefix-tree/src/main/java/org/apache/hadoop/hbase/codec/prefixtree/decode/ArraySearcherPool.java",0,0.984126984126984,1,1,2
"hbase-prefix-tree/src/main/java/org/apache/hadoop/hbase/codec/prefixtree/decode/DecoderFactory.java",0,0.966292134831461,1,1,2
"hbase-prefix-tree/src/main/java/org/apache/hadoop/hbase/codec/prefixtree/decode/PrefixTreeArrayReversibleScanner.java",0,0.979166666666667,1,1,2
"hbase-prefix-tree/src/main/java/org/apache/hadoop/hbase/codec/prefixtree/decode/PrefixTreeArrayScanner.java",0,0.964426877470356,1,1,2
"hbase-prefix-tree/src/main/java/org/apache/hadoop/hbase/codec/prefixtree/decode/PrefixTreeArraySearcher.java",0,0.960493827160494,1,1,2
"hbase-prefix-tree/src/main/java/org/apache/hadoop/hbase/codec/prefixtree/decode/PrefixTreeCell.java",0,0.969543147208122,1,1,2
"hbase-prefix-tree/src/main/java/org/apache/hadoop/hbase/codec/prefixtree/decode/column/ColumnNodeReader.java",0,0.961538461538462,1,1,2
"hbase-prefix-tree/src/main/java/org/apache/hadoop/hbase/codec/prefixtree/decode/column/ColumnReader.java",0,0.980769230769231,1,1,2
"hbase-prefix-tree/src/main/java/org/apache/hadoop/hbase/codec/prefixtree/decode/row/RowNodeReader.java",0,0.98501872659176,1,1,2
"hbase-prefix-tree/src/main/java/org/apache/hadoop/hbase/codec/prefixtree/decode/timestamp/MvccVersionDecoder.java",0,0.947368421052632,0,2,2
"hbase-prefix-tree/src/main/java/org/apache/hadoop/hbase/codec/prefixtree/decode/timestamp/TimestampDecoder.java",0,0.947368421052632,0,2,2
"hbase-prefix-tree/src/main/java/org/apache/hadoop/hbase/codec/prefixtree/encode/EncoderFactory.java",0,0.982142857142857,1,1,2
"hbase-prefix-tree/src/main/java/org/apache/hadoop/hbase/codec/prefixtree/encode/EncoderPool.java",0,0.96875,1,1,2
"hbase-prefix-tree/src/main/java/org/apache/hadoop/hbase/codec/prefixtree/encode/PrefixTreeEncoder.java",0,0.959514170040486,1,1,2
"hbase-prefix-tree/src/main/java/org/apache/hadoop/hbase/codec/prefixtree/encode/ThreadLocalEncoderPool.java",0,0.984375,1,1,2
"hbase-prefix-tree/src/main/java/org/apache/hadoop/hbase/codec/prefixtree/encode/column/ColumnNodeWriter.java",0,0.961832061068702,1,1,2
"hbase-prefix-tree/src/main/java/org/apache/hadoop/hbase/codec/prefixtree/encode/column/ColumnSectionWriter.java",0,0.975124378109453,1,1,2
"hbase-prefix-tree/src/main/java/org/apache/hadoop/hbase/codec/prefixtree/encode/other/CellTypeEncoder.java",0,0.985294117647059,1,1,2
"hbase-prefix-tree/src/main/java/org/apache/hadoop/hbase/codec/prefixtree/encode/other/LongEncoder.java",0,0.989071038251366,1,1,2
"hbase-prefix-tree/src/main/java/org/apache/hadoop/hbase/codec/prefixtree/encode/row/RowNodeWriter.java",0,0.978947368421053,1,1,2
"hbase-prefix-tree/src/main/java/org/apache/hadoop/hbase/codec/prefixtree/encode/row/RowSectionWriter.java",0,0.977168949771689,1,1,2
"hbase-prefix-tree/src/main/java/org/apache/hadoop/hbase/codec/prefixtree/encode/tokenize/TokenDepthComparator.java",0,0.984375,1,1,2
"hbase-prefix-tree/src/main/java/org/apache/hadoop/hbase/codec/prefixtree/encode/tokenize/Tokenizer.java",0,0.99581589958159,1,1,2
"hbase-prefix-tree/src/main/java/org/apache/hadoop/hbase/codec/prefixtree/encode/tokenize/TokenizerNode.java",0,0.998417721518987,1,1,2
"hbase-prefix-tree/src/main/java/org/apache/hadoop/hbase/codec/prefixtree/encode/tokenize/TokenizerRowSearchPosition.java",0,0.973684210526316,1,1,2
"hbase-prefix-tree/src/main/java/org/apache/hadoop/hbase/codec/prefixtree/encode/tokenize/TokenizerRowSearchResult.java",0,0.986301369863014,1,1,2
"hbase-prefix-tree/src/main/java/org/apache/hadoop/hbase/codec/prefixtree/scanner/CellScannerPosition.java",0,1,0,1,1
"hbase-prefix-tree/src/main/java/org/apache/hadoop/hbase/codec/prefixtree/scanner/CellSearcher.java",0,0.936363636363636,0,2,2
"hbase-prefix-tree/src/main/java/org/apache/hadoop/hbase/codec/prefixtree/scanner/ReversibleCellScanner.java",0,0.8,0,2,2
"hbase-prefix-tree/src/main/java/org/apache/hadoop/hbase/util/byterange/ByteRangeSet.java",0,0.983333333333333,1,1,2
"hbase-prefix-tree/src/main/java/org/apache/hadoop/hbase/util/byterange/impl/ByteRangeHashSet.java",0,0.964912280701754,1,1,2
"hbase-prefix-tree/src/main/java/org/apache/hadoop/hbase/util/byterange/impl/ByteRangeTreeSet.java",0,0.962962962962963,1,1,2
"hbase-prefix-tree/src/main/java/org/apache/hadoop/hbase/util/vint/UFIntTool.java",0,0.991379310344828,1,1,2
"hbase-prefix-tree/src/main/java/org/apache/hadoop/hbase/util/vint/UVIntTool.java",0,0.991304347826087,1,1,2
"hbase-prefix-tree/src/main/java/org/apache/hadoop/hbase/util/vint/UVLongTool.java",0,0.991150442477876,1,1,2
"hbase-prefix-tree/src/test/java/org/apache/hadoop/hbase/codec/keyvalue/TestKeyValueTool.java",0,0.963636363636364,1,1,2
"hbase-prefix-tree/src/test/java/org/apache/hadoop/hbase/codec/prefixtree/PrefixTreeTestConstants.java",0,0.962962962962963,1,1,2
"hbase-prefix-tree/src/test/java/org/apache/hadoop/hbase/codec/prefixtree/blockmeta/TestBlockMeta.java",0,0.975609756097561,1,1,2
"hbase-prefix-tree/src/test/java/org/apache/hadoop/hbase/codec/prefixtree/builder/TestTokenizer.java",0,0.945945945945946,0,2,2
"hbase-prefix-tree/src/test/java/org/apache/hadoop/hbase/codec/prefixtree/builder/TestTokenizerData.java",0,0.928571428571429,0,2,2
"hbase-prefix-tree/src/test/java/org/apache/hadoop/hbase/codec/prefixtree/builder/TestTreeDepth.java",0,0.976470588235294,1,1,2
"hbase-prefix-tree/src/test/java/org/apache/hadoop/hbase/codec/prefixtree/builder/data/TestTokenizerDataBasic.java",0,0.96078431372549,1,1,2
"hbase-prefix-tree/src/test/java/org/apache/hadoop/hbase/codec/prefixtree/builder/data/TestTokenizerDataEdgeCase.java",0,0.962264150943396,1,1,2
"hbase-prefix-tree/src/test/java/org/apache/hadoop/hbase/codec/prefixtree/column/TestColumnBuilder.java",0,0.941666666666667,0,2,2
"hbase-prefix-tree/src/test/java/org/apache/hadoop/hbase/codec/prefixtree/column/TestColumnData.java",0,0.933333333333333,0,2,2
"hbase-prefix-tree/src/test/java/org/apache/hadoop/hbase/codec/prefixtree/column/data/TestColumnDataRandom.java",0,0.934426229508197,0,2,2
"hbase-prefix-tree/src/test/java/org/apache/hadoop/hbase/codec/prefixtree/column/data/TestColumnDataSimple.java",0,0.961538461538462,1,1,2
"hbase-prefix-tree/src/test/java/org/apache/hadoop/hbase/codec/prefixtree/row/BaseTestRowData.java",0,0.925925925925926,0,2,2
"hbase-prefix-tree/src/test/java/org/apache/hadoop/hbase/codec/prefixtree/row/TestPrefixTreeSearcher.java",0,0.921465968586387,0,2,2
"hbase-prefix-tree/src/test/java/org/apache/hadoop/hbase/codec/prefixtree/row/TestRowData.java",0,0.814432989690722,0,2,2
"hbase-prefix-tree/src/test/java/org/apache/hadoop/hbase/codec/prefixtree/row/TestRowEncoder.java",0,0.940860215053763,0,2,2
"hbase-prefix-tree/src/test/java/org/apache/hadoop/hbase/codec/prefixtree/row/data/TestRowDataComplexQualifiers.java",0,0.955223880597015,1,1,2
"hbase-prefix-tree/src/test/java/org/apache/hadoop/hbase/codec/prefixtree/row/data/TestRowDataDeeper.java",0,0.916666666666667,0,2,2
"hbase-prefix-tree/src/test/java/org/apache/hadoop/hbase/codec/prefixtree/row/data/TestRowDataDifferentTimestamps.java",0,0.968085106382979,1,1,2
"hbase-prefix-tree/src/test/java/org/apache/hadoop/hbase/codec/prefixtree/row/data/TestRowDataEmpty.java",0,0.953488372093023,1,1,2
"hbase-prefix-tree/src/test/java/org/apache/hadoop/hbase/codec/prefixtree/row/data/TestRowDataExerciseFInts.java",0,0.956140350877193,1,1,2
"hbase-prefix-tree/src/test/java/org/apache/hadoop/hbase/codec/prefixtree/row/data/TestRowDataMultiFamilies.java",0,0.966666666666667,1,1,2
"hbase-prefix-tree/src/test/java/org/apache/hadoop/hbase/codec/prefixtree/row/data/TestRowDataNub.java",0,0.949152542372881,0,2,2
"hbase-prefix-tree/src/test/java/org/apache/hadoop/hbase/codec/prefixtree/row/data/TestRowDataNumberStrings.java",0,0.950819672131147,1,1,2
"hbase-prefix-tree/src/test/java/org/apache/hadoop/hbase/codec/prefixtree/row/data/TestRowDataQualifierByteOrdering.java",0,0.96551724137931,1,1,2
"hbase-prefix-tree/src/test/java/org/apache/hadoop/hbase/codec/prefixtree/row/data/TestRowDataRandomKeyValues.java",0,0.952380952380952,1,1,2
"hbase-prefix-tree/src/test/java/org/apache/hadoop/hbase/codec/prefixtree/row/data/TestRowDataSearcherRowMiss.java",0,0.894308943089431,0,2,2
"hbase-prefix-tree/src/test/java/org/apache/hadoop/hbase/codec/prefixtree/row/data/TestRowDataSimple.java",0,0.875,0,2,2
"hbase-prefix-tree/src/test/java/org/apache/hadoop/hbase/codec/prefixtree/row/data/TestRowDataSingleQualifier.java",0,0.942307692307692,0,2,2
"hbase-prefix-tree/src/test/java/org/apache/hadoop/hbase/codec/prefixtree/row/data/TestRowDataTrivial.java",0,0.917808219178082,0,2,2
"hbase-prefix-tree/src/test/java/org/apache/hadoop/hbase/codec/prefixtree/row/data/TestRowDataUrls.java",0,0.959183673469388,1,1,2
"hbase-prefix-tree/src/test/java/org/apache/hadoop/hbase/codec/prefixtree/row/data/TestRowDataUrlsExample.java",0,0.952380952380952,1,1,2
"hbase-prefix-tree/src/test/java/org/apache/hadoop/hbase/codec/prefixtree/timestamp/TestTimestampData.java",0,0.911111111111111,0,2,2
"hbase-prefix-tree/src/test/java/org/apache/hadoop/hbase/codec/prefixtree/timestamp/TestTimestampEncoder.java",0,0.956521739130435,1,1,2
"hbase-prefix-tree/src/test/java/org/apache/hadoop/hbase/codec/prefixtree/timestamp/data/TestTimestampDataBasic.java",0,0.962962962962963,1,1,2
"hbase-prefix-tree/src/test/java/org/apache/hadoop/hbase/codec/prefixtree/timestamp/data/TestTimestampDataNumbers.java",0,0.964285714285714,1,1,2
"hbase-prefix-tree/src/test/java/org/apache/hadoop/hbase/codec/prefixtree/timestamp/data/TestTimestampDataRepeats.java",0,0.961538461538462,1,1,2
"hbase-prefix-tree/src/test/java/org/apache/hadoop/hbase/util/bytes/TestByteRange.java",0,0.970588235294118,1,1,2
"hbase-prefix-tree/src/test/java/org/apache/hadoop/hbase/util/comparator/ByteArrayComparator.java",0,0.96875,1,1,2
"hbase-prefix-tree/src/test/java/org/apache/hadoop/hbase/util/number/NumberFormatter.java",0,0.96969696969697,1,1,2
"hbase-prefix-tree/src/test/java/org/apache/hadoop/hbase/util/number/RandomNumberUtils.java",0,0.970588235294118,1,1,2
"hbase-prefix-tree/src/test/java/org/apache/hadoop/hbase/util/vint/TestFIntTool.java",0,0.983739837398374,1,1,2
"hbase-prefix-tree/src/test/java/org/apache/hadoop/hbase/util/vint/TestVIntTool.java",0,0.97979797979798,1,1,2
"hbase-prefix-tree/src/test/java/org/apache/hadoop/hbase/util/vint/TestVLongTool.java",0,0.971698113207547,1,1,2
"hbase-protocol/src/main/java/org/apache/hadoop/hbase/protobuf/generated/AccessControlProtos.java",0,0.6,1,2,3
"hbase-protocol/src/main/java/org/apache/hadoop/hbase/protobuf/generated/AdminProtos.java",0,0.867032290559069,3,2,5
"hbase-protocol/src/main/java/org/apache/hadoop/hbase/protobuf/generated/AggregateProtos.java",0,1,0,1,1
"hbase-protocol/src/main/java/org/apache/hadoop/hbase/protobuf/generated/AuthenticationProtos.java",0,1,0,1,1
"hbase-protocol/src/main/java/org/apache/hadoop/hbase/protobuf/generated/ClientProtos.java",0,0.764749813293503,3,3,6
"hbase-protocol/src/main/java/org/apache/hadoop/hbase/protobuf/generated/ClusterIdProtos.java",0,1,0,1,1
"hbase-protocol/src/main/java/org/apache/hadoop/hbase/protobuf/generated/ClusterStatusProtos.java",0,0.979241877256318,2,1,3
"hbase-protocol/src/main/java/org/apache/hadoop/hbase/protobuf/generated/ComparatorProtos.java",0,1,0,1,1
"hbase-protocol/src/main/java/org/apache/hadoop/hbase/protobuf/generated/ErrorHandlingProtos.java",0,1,0,1,1
"hbase-protocol/src/main/java/org/apache/hadoop/hbase/protobuf/generated/FSProtos.java",0,1,0,1,1
"hbase-protocol/src/main/java/org/apache/hadoop/hbase/protobuf/generated/FilterProtos.java",0,0.843435525391996,0,2,2
"hbase-protocol/src/main/java/org/apache/hadoop/hbase/protobuf/generated/HBaseProtos.java",0,0.729576045490535,1,3,4
"hbase-protocol/src/main/java/org/apache/hadoop/hbase/protobuf/generated/HFileProtos.java",0,0.642817526344981,0,2,2
"hbase-protocol/src/main/java/org/apache/hadoop/hbase/protobuf/generated/LoadBalancerProtos.java",0,1,0,1,1
"hbase-protocol/src/main/java/org/apache/hadoop/hbase/protobuf/generated/MapReduceProtos.java",0,1,0,1,1
"hbase-protocol/src/main/java/org/apache/hadoop/hbase/protobuf/generated/MasterAdminProtos.java",0,0.694287805088029,1,3,4
"hbase-protocol/src/main/java/org/apache/hadoop/hbase/protobuf/generated/MasterMonitorProtos.java",0,1,0,1,1
"hbase-protocol/src/main/java/org/apache/hadoop/hbase/protobuf/generated/MasterProtos.java",0,1,0,1,1
"hbase-protocol/src/main/java/org/apache/hadoop/hbase/protobuf/generated/MultiRowMutation.java",0,0.964527027027027,1,1,2
"hbase-protocol/src/main/java/org/apache/hadoop/hbase/protobuf/generated/MultiRowMutationProcessorProtos.java",0,1,0,1,1
"hbase-protocol/src/main/java/org/apache/hadoop/hbase/protobuf/generated/RPCProtos.java",0,1,0,1,1
"hbase-protocol/src/main/java/org/apache/hadoop/hbase/protobuf/generated/RegionServerStatusProtos.java",0,0.797619047619048,0,2,2
"hbase-protocol/src/main/java/org/apache/hadoop/hbase/protobuf/generated/RowProcessorProtos.java",0,1,0,1,1
"hbase-protocol/src/main/java/org/apache/hadoop/hbase/protobuf/generated/SecureBulkLoadProtos.java",0,1,0,1,1
"hbase-protocol/src/main/java/org/apache/hadoop/hbase/protobuf/generated/Tracing.java",0,1,0,1,1
"hbase-protocol/src/main/java/org/apache/hadoop/hbase/protobuf/generated/ZooKeeperProtos.java",0,0.85198432975643,1,2,3
"hbase-server/src/main/java/org/apache/hadoop/hbase/BaseConfigurable.java",0,1,0,1,1
"hbase-server/src/main/java/org/apache/hadoop/hbase/DaemonThreadFactory.java",0,0.979591836734694,1,1,2
"hbase-server/src/main/java/org/apache/hadoop/hbase/HDFSBlocksDistribution.java",0,0.966804979253112,1,1,2
"hbase-server/src/main/java/org/apache/hadoop/hbase/HealthCheckChore.java",0,0.989473684210526,1,1,2
"hbase-server/src/main/java/org/apache/hadoop/hbase/HealthChecker.java",0,0.976923076923077,1,1,2
"hbase-server/src/main/java/org/apache/hadoop/hbase/HealthReport.java",0,0.934782608695652,0,2,2
"hbase-server/src/main/java/org/apache/hadoop/hbase/InterProcessLock.java",0,1,0,1,1
"hbase-server/src/main/java/org/apache/hadoop/hbase/InterProcessReadWriteLock.java",0,1,0,1,1
"hbase-server/src/main/java/org/apache/hadoop/hbase/LocalHBaseCluster.java",0,0.538293216630197,6,2,8
"hbase-server/src/main/java/org/apache/hadoop/hbase/RegionServerStatusProtocol.java",0,1,0,1,1
"hbase-server/src/main/java/org/apache/hadoop/hbase/SplitLogCounters.java",0,0.565217391304348,0,2,2
"hbase-server/src/main/java/org/apache/hadoop/hbase/SplitLogTask.java",0,0.994219653179191,1,1,2
"hbase-server/src/main/java/org/apache/hadoop/hbase/TableDescriptors.java",0,0.972602739726027,1,1,2
"hbase-server/src/main/java/org/apache/hadoop/hbase/ZNodeClearer.java",0,1,0,1,1
"hbase-server/src/main/java/org/apache/hadoop/hbase/backup/HFileArchiver.java",0,0.818577648766328,3,2,5
"hbase-server/src/main/java/org/apache/hadoop/hbase/backup/example/HFileArchiveManager.java",0,0.988165680473373,2,1,3
"hbase-server/src/main/java/org/apache/hadoop/hbase/backup/example/HFileArchiveTableMonitor.java",0,1,0,1,1
"hbase-server/src/main/java/org/apache/hadoop/hbase/backup/example/LongTermArchivingHFileCleaner.java",0,0.924528301886792,0,2,2
"hbase-server/src/main/java/org/apache/hadoop/hbase/backup/example/TableHFileArchiveTracker.java",0,0.99625468164794,1,1,2
"hbase-server/src/main/java/org/apache/hadoop/hbase/backup/example/ZKTableArchiveClient.java",0,0.993548387096774,1,1,2
"hbase-server/src/main/java/org/apache/hadoop/hbase/catalog/MetaEditor.java",0,0.522768670309654,2,4,6
"hbase-server/src/main/java/org/apache/hadoop/hbase/catalog/MetaMigrationConvertingToPB.java",0,0.995475113122172,1,1,2
"hbase-server/src/main/java/org/apache/hadoop/hbase/client/coprocessor/BigDecimalColumnInterpreter.java",0,1,0,1,1
"hbase-server/src/main/java/org/apache/hadoop/hbase/client/coprocessor/RowProcessorClient.java",0,0.56,0,2,2
"hbase-server/src/main/java/org/apache/hadoop/hbase/codec/MessageCodec.java",0,1,0,1,1
"hbase-server/src/main/java/org/apache/hadoop/hbase/constraint/BaseConstraint.java",0,0.933333333333333,0,2,2
"hbase-server/src/main/java/org/apache/hadoop/hbase/constraint/Constraint.java",0,0.925925925925926,2,1,3
"hbase-server/src/main/java/org/apache/hadoop/hbase/constraint/ConstraintProcessor.java",0,0.978021978021978,1,1,2
"hbase-server/src/main/java/org/apache/hadoop/hbase/constraint/Constraints.java",0,0.995192307692308,1,1,2
"hbase-server/src/main/java/org/apache/hadoop/hbase/constraint/package-info.java",0,0.996212121212121,1,1,2
"hbase-server/src/main/java/org/apache/hadoop/hbase/coprocessor/AggregateImplementation.java",0,0.656488549618321,2,3,5
"hbase-server/src/main/java/org/apache/hadoop/hbase/coprocessor/BaseMasterObserver.java",0,0.413294797687861,2,4,6
"hbase-server/src/main/java/org/apache/hadoop/hbase/coprocessor/BaseRegionObserver.java",0,0.495024875621891,5,5,10
"hbase-server/src/main/java/org/apache/hadoop/hbase/coprocessor/BaseRowProcessorEndpoint.java",0,0.684563758389262,2,2,4
"hbase-server/src/main/java/org/apache/hadoop/hbase/coprocessor/CoprocessorClassLoader.java",0,0.901408450704225,1,2,3
"hbase-server/src/main/java/org/apache/hadoop/hbase/coprocessor/CoprocessorHost.java",0,0.575308641975309,5,3,8
"hbase-server/src/main/java/org/apache/hadoop/hbase/coprocessor/CoprocessorService.java",0,1,0,1,1
"hbase-server/src/main/java/org/apache/hadoop/hbase/coprocessor/MasterCoprocessorEnvironment.java",0,0.84375,0,2,2
"hbase-server/src/main/java/org/apache/hadoop/hbase/coprocessor/MasterObserver.java",0,0.432300163132137,3,3,6
"hbase-server/src/main/java/org/apache/hadoop/hbase/coprocessor/MultiRowMutationEndpoint.java",0,0.657718120805369,2,2,4
"hbase-server/src/main/java/org/apache/hadoop/hbase/coprocessor/ObserverContext.java",0,0.946902654867257,0,2,2
"hbase-server/src/main/java/org/apache/hadoop/hbase/coprocessor/RegionCoprocessorEnvironment.java",0,0.761904761904762,0,3,3
"hbase-server/src/main/java/org/apache/hadoop/hbase/coprocessor/RegionObserver.java",0,0.478215767634855,5,5,10
"hbase-server/src/main/java/org/apache/hadoop/hbase/coprocessor/RegionServerCoprocessorEnvironment.java",0,1,0,1,1
"hbase-server/src/main/java/org/apache/hadoop/hbase/coprocessor/RegionServerObserver.java",0,1,0,1,1
"hbase-server/src/main/java/org/apache/hadoop/hbase/coprocessor/WALCoprocessorEnvironment.java",0,0.84375,0,2,2
"hbase-server/src/main/java/org/apache/hadoop/hbase/coprocessor/WALObserver.java",0,0.873239436619718,0,3,3
"hbase-server/src/main/java/org/apache/hadoop/hbase/coprocessor/package-info.java",0,0.91958041958042,1,2,3
"hbase-server/src/main/java/org/apache/hadoop/hbase/errorhandling/ForeignException.java",0,0.95360824742268,1,1,2
"hbase-server/src/main/java/org/apache/hadoop/hbase/errorhandling/ForeignExceptionDispatcher.java",0,0.949579831932773,0,2,2
"hbase-server/src/main/java/org/apache/hadoop/hbase/errorhandling/ForeignExceptionListener.java",0,1,0,1,1
"hbase-server/src/main/java/org/apache/hadoop/hbase/errorhandling/ForeignExceptionSnare.java",0,1,0,1,1
"hbase-server/src/main/java/org/apache/hadoop/hbase/errorhandling/TimeoutException.java",0,0.985074626865672,1,1,2
"hbase-server/src/main/java/org/apache/hadoop/hbase/errorhandling/TimeoutExceptionInjector.java",0,1,0,1,1
"hbase-server/src/main/java/org/apache/hadoop/hbase/executor/EventHandler.java",0,0.801801801801802,4,3,7
"hbase-server/src/main/java/org/apache/hadoop/hbase/executor/ExecutorService.java",0,0.534818941504178,3,2,5
"hbase-server/src/main/java/org/apache/hadoop/hbase/fs/HFileSystem.java",0,0.447089947089947,4,3,7
"hbase-server/src/main/java/org/apache/hadoop/hbase/io/DataInputInputStream.java",0,1,0,1,1
"hbase-server/src/main/java/org/apache/hadoop/hbase/io/DataOutputOutputStream.java",0,1,0,1,1
"hbase-server/src/main/java/org/apache/hadoop/hbase/io/DoubleOutputStream.java",0,0.960526315789474,1,1,2
"hbase-server/src/main/java/org/apache/hadoop/hbase/io/FileLink.java",0,0.997802197802198,1,1,2
"hbase-server/src/main/java/org/apache/hadoop/hbase/io/HFileLink.java",0,0.749326145552561,2,2,4
"hbase-server/src/main/java/org/apache/hadoop/hbase/io/HLogLink.java",0,1,0,1,1
"hbase-server/src/main/java/org/apache/hadoop/hbase/io/HalfStoreFileReader.java",0,0.718654434250764,4,3,7
"hbase-server/src/main/java/org/apache/hadoop/hbase/io/Reference.java",0,0.894495412844037,2,2,4
"hbase-server/src/main/java/org/apache/hadoop/hbase/io/WritableWithSize.java",0,0.921052631578947,0,2,2
"hbase-server/src/main/java/org/apache/hadoop/hbase/io/hfile/AbstractHFileReader.java",0,0.806179775280899,5,2,7
"hbase-server/src/main/java/org/apache/hadoop/hbase/io/hfile/AbstractHFileWriter.java",0,0.881040892193309,7,1,8
"hbase-server/src/main/java/org/apache/hadoop/hbase/io/hfile/BlockCache.java",0,0.47244094488189,0,4,4
"hbase-server/src/main/java/org/apache/hadoop/hbase/io/hfile/BlockCacheColumnFamilySummary.java",0,0.991902834008097,1,1,2
"hbase-server/src/main/java/org/apache/hadoop/hbase/io/hfile/BlockCacheKey.java",0,0.66,2,2,4
"hbase-server/src/main/java/org/apache/hadoop/hbase/io/hfile/BlockWithScanInfo.java",0,1,0,1,1
"hbase-server/src/main/java/org/apache/hadoop/hbase/io/hfile/BoundedRangeFileInputStream.java",0,1,0,1,1
"hbase-server/src/main/java/org/apache/hadoop/hbase/io/hfile/CacheConfig.java",0,0.755868544600939,5,2,7
"hbase-server/src/main/java/org/apache/hadoop/hbase/io/hfile/CacheStats.java",0,0.55607476635514,0,3,3
"hbase-server/src/main/java/org/apache/hadoop/hbase/io/hfile/Cacheable.java",0,0.90625,1,2,3
"hbase-server/src/main/java/org/apache/hadoop/hbase/io/hfile/CacheableDeserializer.java",0,0.685185185185185,0,2,2
"hbase-server/src/main/java/org/apache/hadoop/hbase/io/hfile/CacheableDeserializerIdManager.java",0,1,0,1,1
"hbase-server/src/main/java/org/apache/hadoop/hbase/io/hfile/CachedBlock.java",0,0.8828125,2,2,4
"hbase-server/src/main/java/org/apache/hadoop/hbase/io/hfile/CachedBlockQueue.java",0,0.853211009174312,1,2,3
"hbase-server/src/main/java/org/apache/hadoop/hbase/io/hfile/ChecksumUtil.java",0,0.995708154506438,1,1,2
"hbase-server/src/main/java/org/apache/hadoop/hbase/io/hfile/CombinedBlockCache.java",0,1,0,1,1
"hbase-server/src/main/java/org/apache/hadoop/hbase/io/hfile/DoubleBlockCache.java",0,0.868571428571429,2,2,4
"hbase-server/src/main/java/org/apache/hadoop/hbase/io/hfile/FixedFileTrailer.java",0,0.574660633484163,3,3,6
"hbase-server/src/main/java/org/apache/hadoop/hbase/io/hfile/HFile.java",0,0.56,10,3,13
"hbase-server/src/main/java/org/apache/hadoop/hbase/io/hfile/HFileBlock.java",0,0.468682505399568,8,2,10
"hbase-server/src/main/java/org/apache/hadoop/hbase/io/hfile/HFileBlockIndex.java",0,0.937106918238994,5,1,6
"hbase-server/src/main/java/org/apache/hadoop/hbase/io/hfile/HFileDataBlockEncoder.java",0,0.915254237288136,2,2,4
"hbase-server/src/main/java/org/apache/hadoop/hbase/io/hfile/HFileDataBlockEncoderImpl.java",0,0.971731448763251,4,1,5
"hbase-server/src/main/java/org/apache/hadoop/hbase/io/hfile/HFilePrettyPrinter.java",0,0.650334075723831,3,3,6
"hbase-server/src/main/java/org/apache/hadoop/hbase/io/hfile/HFileReaderV2.java",0,0.477493380406002,4,3,7
"hbase-server/src/main/java/org/apache/hadoop/hbase/io/hfile/HFileScanner.java",0,0.816326530612245,0,2,2
"hbase-server/src/main/java/org/apache/hadoop/hbase/io/hfile/HFileWriterV2.java",0,0.684426229508197,4,4,8
"hbase-server/src/main/java/org/apache/hadoop/hbase/io/hfile/InlineBlockWriter.java",0,0.931506849315068,0,2,2
"hbase-server/src/main/java/org/apache/hadoop/hbase/io/hfile/LruBlockCache.java",0,0.693287037037037,9,2,11
"hbase-server/src/main/java/org/apache/hadoop/hbase/io/hfile/NoOpDataBlockEncoder.java",0,0.963302752293578,3,1,4
"hbase-server/src/main/java/org/apache/hadoop/hbase/io/hfile/SimpleBlockCache.java",0,0.525179856115108,1,5,6
"hbase-server/src/main/java/org/apache/hadoop/hbase/io/hfile/bucket/BucketAllocator.java",0,1,0,1,1
"hbase-server/src/main/java/org/apache/hadoop/hbase/io/hfile/bucket/BucketAllocatorException.java",0,1,0,1,1
"hbase-server/src/main/java/org/apache/hadoop/hbase/io/hfile/bucket/BucketCache.java",0,1,0,1,1
"hbase-server/src/main/java/org/apache/hadoop/hbase/io/hfile/bucket/BucketCacheStats.java",0,1,0,1,1
"hbase-server/src/main/java/org/apache/hadoop/hbase/io/hfile/bucket/ByteBufferIOEngine.java",0,1,0,1,1
"hbase-server/src/main/java/org/apache/hadoop/hbase/io/hfile/bucket/CacheFullException.java",0,1,0,1,1
"hbase-server/src/main/java/org/apache/hadoop/hbase/io/hfile/bucket/CachedEntryQueue.java",0,1,0,1,1
"hbase-server/src/main/java/org/apache/hadoop/hbase/io/hfile/bucket/FileIOEngine.java",0,1,0,1,1
"hbase-server/src/main/java/org/apache/hadoop/hbase/io/hfile/bucket/IOEngine.java",0,1,0,1,1
"hbase-server/src/main/java/org/apache/hadoop/hbase/io/hfile/bucket/UniqueIndexMap.java",0,1,0,1,1
"hbase-server/src/main/java/org/apache/hadoop/hbase/io/hfile/slab/SingleSizeCache.java",0,0.768156424581006,3,2,5
"hbase-server/src/main/java/org/apache/hadoop/hbase/io/hfile/slab/Slab.java",0,0.925925925925926,0,2,2
"hbase-server/src/main/java/org/apache/hadoop/hbase/io/hfile/slab/SlabCache.java",0,0.812206572769953,2,3,5
"hbase-server/src/main/java/org/apache/hadoop/hbase/io/hfile/slab/SlabItemActionWatcher.java",0,0.91304347826087,0,2,2
"hbase-server/src/main/java/org/apache/hadoop/hbase/ipc/Delayable.java",0,0.616438356164384,0,2,2
"hbase-server/src/main/java/org/apache/hadoop/hbase/ipc/HBaseRPCErrorHandler.java",0,0.885714285714286,1,2,3
"hbase-server/src/main/java/org/apache/hadoop/hbase/ipc/HBaseServer.java",0,0.79647577092511,7,2,9
"hbase-server/src/main/java/org/apache/hadoop/hbase/ipc/HBaseServerRPC.java",0,0.886178861788618,0,2,2
"hbase-server/src/main/java/org/apache/hadoop/hbase/ipc/MetricsHBaseServer.java",0,0.985507246376812,1,1,2
"hbase-server/src/main/java/org/apache/hadoop/hbase/ipc/MetricsHBaseServerWrapperImpl.java",0,1,0,1,1
"hbase-server/src/main/java/org/apache/hadoop/hbase/ipc/ProtobufRpcServerEngine.java",0,0.940397350993378,2,2,4
"hbase-server/src/main/java/org/apache/hadoop/hbase/ipc/RequestContext.java",0,0.936170212765957,0,2,2
"hbase-server/src/main/java/org/apache/hadoop/hbase/ipc/ResponseFlag.java",0,1,0,1,1
"hbase-server/src/main/java/org/apache/hadoop/hbase/ipc/RpcCallContext.java",0,0.935483870967742,0,2,2
"hbase-server/src/main/java/org/apache/hadoop/hbase/ipc/RpcServer.java",0,0.578947368421053,1,3,4
"hbase-server/src/main/java/org/apache/hadoop/hbase/ipc/RpcServerEngine.java",0,0.676470588235294,0,3,3
"hbase-server/src/main/java/org/apache/hadoop/hbase/ipc/Status.java",0,1,0,1,1
"hbase-server/src/main/java/org/apache/hadoop/hbase/mapred/Driver.java",0,0.925,0,2,2
"hbase-server/src/main/java/org/apache/hadoop/hbase/mapred/GroupingTableMap.java",0,0.987096774193548,2,1,3
"hbase-server/src/main/java/org/apache/hadoop/hbase/mapred/HRegionPartitioner.java",0,0.977777777777778,1,1,2
"hbase-server/src/main/java/org/apache/hadoop/hbase/mapred/IdentityTableMap.java",0,0.986666666666667,1,1,2
"hbase-server/src/main/java/org/apache/hadoop/hbase/mapred/IdentityTableReduce.java",0,0.983333333333333,1,1,2
"hbase-server/src/main/java/org/apache/hadoop/hbase/mapred/RowCounter.java",0,0.967479674796748,1,1,2
"hbase-server/src/main/java/org/apache/hadoop/hbase/mapred/TableInputFormat.java",0,0.975609756097561,1,1,2
"hbase-server/src/main/java/org/apache/hadoop/hbase/mapred/TableInputFormatBase.java",0,0.984042553191489,1,1,2
"hbase-server/src/main/java/org/apache/hadoop/hbase/mapred/TableMap.java",0,0.947368421052632,2,1,3
"hbase-server/src/main/java/org/apache/hadoop/hbase/mapred/TableMapReduceUtil.java",0,0.602941176470588,1,3,4
"hbase-server/src/main/java/org/apache/hadoop/hbase/mapred/TableOutputFormat.java",0,0.961904761904762,1,1,2
"hbase-server/src/main/java/org/apache/hadoop/hbase/mapred/TableRecordReader.java",0,1,0,1,1
"hbase-server/src/main/java/org/apache/hadoop/hbase/mapred/TableRecordReaderImpl.java",0,0.73469387755102,3,2,5
"hbase-server/src/main/java/org/apache/hadoop/hbase/mapred/TableReduce.java",0,0.947368421052632,2,1,3
"hbase-server/src/main/java/org/apache/hadoop/hbase/mapred/TableSplit.java",0,0.888,0,2,2
"hbase-server/src/main/java/org/apache/hadoop/hbase/mapred/package-info.java",0,0.910569105691057,0,2,2
"hbase-server/src/main/java/org/apache/hadoop/hbase/mapreduce/CellCounter.java",0,0.916349809885932,0,2,2
"hbase-server/src/main/java/org/apache/hadoop/hbase/mapreduce/CopyTable.java",0,0.736625514403292,2,3,5
"hbase-server/src/main/java/org/apache/hadoop/hbase/mapreduce/Driver.java",0,0.631578947368421,0,4,4
"hbase-server/src/main/java/org/apache/hadoop/hbase/mapreduce/Export.java",0,0.878453038674033,2,2,4
"hbase-server/src/main/java/org/apache/hadoop/hbase/mapreduce/GroupingTableMapper.java",0,0.988700564971751,2,1,3
"hbase-server/src/main/java/org/apache/hadoop/hbase/mapreduce/HFileOutputFormat.java",0,0.4875,3,4,7
"hbase-server/src/main/java/org/apache/hadoop/hbase/mapreduce/HLogInputFormat.java",0,0.977777777777778,2,1,3
"hbase-server/src/main/java/org/apache/hadoop/hbase/mapreduce/HRegionPartitioner.java",0,0.540740740740741,0,2,2
"hbase-server/src/main/java/org/apache/hadoop/hbase/mapreduce/IdentityTableMapper.java",0,1,0,1,1
"hbase-server/src/main/java/org/apache/hadoop/hbase/mapreduce/IdentityTableReducer.java",0,0.951219512195122,1,1,2
"hbase-server/src/main/java/org/apache/hadoop/hbase/mapreduce/Import.java",0,0.334792122538293,1,4,5
"hbase-server/src/main/java/org/apache/hadoop/hbase/mapreduce/ImportTsv.java",0,0.497777777777778,2,3,5
"hbase-server/src/main/java/org/apache/hadoop/hbase/mapreduce/KeyValueSerialization.java",0,1,0,1,1
"hbase-server/src/main/java/org/apache/hadoop/hbase/mapreduce/KeyValueSortReducer.java",0,1,0,1,1
"hbase-server/src/main/java/org/apache/hadoop/hbase/mapreduce/LoadIncrementalHFiles.java",0,0.395674300254453,8,3,11
"hbase-server/src/main/java/org/apache/hadoop/hbase/mapreduce/MultiTableInputFormat.java",0,1,0,1,1
"hbase-server/src/main/java/org/apache/hadoop/hbase/mapreduce/MultiTableInputFormatBase.java",0,0.818181818181818,0,2,2
"hbase-server/src/main/java/org/apache/hadoop/hbase/mapreduce/MultiTableOutputFormat.java",0,0.885542168674699,1,2,3
"hbase-server/src/main/java/org/apache/hadoop/hbase/mapreduce/MultithreadedTableMapper.java",0,0.822742474916388,2,2,4
"hbase-server/src/main/java/org/apache/hadoop/hbase/mapreduce/MutationSerialization.java",0,0.927083333333333,0,2,2
"hbase-server/src/main/java/org/apache/hadoop/hbase/mapreduce/PutCombiner.java",0,0.958904109589041,1,1,2
"hbase-server/src/main/java/org/apache/hadoop/hbase/mapreduce/PutSortReducer.java",0,0.577777777777778,1,3,4
"hbase-server/src/main/java/org/apache/hadoop/hbase/mapreduce/ResultSerialization.java",0,0.988372093023256,1,1,2
"hbase-server/src/main/java/org/apache/hadoop/hbase/mapreduce/RowCounter.java",0,0.345549738219895,2,4,6
"hbase-server/src/main/java/org/apache/hadoop/hbase/mapreduce/SimpleTotalOrderPartitioner.java",0,0.654929577464789,0,2,2
"hbase-server/src/main/java/org/apache/hadoop/hbase/mapreduce/TableInputFormat.java",0,0.516746411483254,1,3,4
"hbase-server/src/main/java/org/apache/hadoop/hbase/mapreduce/TableInputFormatBase.java",0,0.466666666666667,3,3,6
"hbase-server/src/main/java/org/apache/hadoop/hbase/mapreduce/TableMapReduceUtil.java",0,0.518341307814992,2,6,8
"hbase-server/src/main/java/org/apache/hadoop/hbase/mapreduce/TableMapper.java",0,1,0,1,1
"hbase-server/src/main/java/org/apache/hadoop/hbase/mapreduce/TableOutputCommitter.java",0,1,0,1,1
"hbase-server/src/main/java/org/apache/hadoop/hbase/mapreduce/TableOutputFormat.java",0,0.602803738317757,3,3,6
"hbase-server/src/main/java/org/apache/hadoop/hbase/mapreduce/TableRecordReader.java",0,0.993377483443709,1,1,2
"hbase-server/src/main/java/org/apache/hadoop/hbase/mapreduce/TableRecordReaderImpl.java",0,0.479591836734694,3,3,6
"hbase-server/src/main/java/org/apache/hadoop/hbase/mapreduce/TableReducer.java",0,0.957446808510638,1,1,2
"hbase-server/src/main/java/org/apache/hadoop/hbase/mapreduce/TableSplit.java",0,0.377551020408163,0,3,3
"hbase-server/src/main/java/org/apache/hadoop/hbase/mapreduce/TsvImporterMapper.java",0,0.948863636363636,0,2,2
"hbase-server/src/main/java/org/apache/hadoop/hbase/mapreduce/WALPlayer.java",0,0.987096774193548,2,1,3
"hbase-server/src/main/java/org/apache/hadoop/hbase/mapreduce/hadoopbackport/JarFinder.java",0,1,0,1,1
"hbase-server/src/main/java/org/apache/hadoop/hbase/mapreduce/package-info.java",0,0.552147239263804,0,2,2
"hbase-server/src/main/java/org/apache/hadoop/hbase/mapreduce/replication/VerifyReplication.java",0,0.759878419452888,1,2,3
"hbase-server/src/main/java/org/apache/hadoop/hbase/master/ActiveMasterManager.java",0,0.762962962962963,2,2,4
"hbase-server/src/main/java/org/apache/hadoop/hbase/master/AssignCallable.java",0,0.979166666666667,1,1,2
"hbase-server/src/main/java/org/apache/hadoop/hbase/master/AssignmentManager.java",0,0.34368932038835,11,4,15
"hbase-server/src/main/java/org/apache/hadoop/hbase/master/BulkAssigner.java",0,0.901639344262295,0,2,2
"hbase-server/src/main/java/org/apache/hadoop/hbase/master/BulkReOpen.java",0,0.89,2,2,4
"hbase-server/src/main/java/org/apache/hadoop/hbase/master/CatalogJanitor.java",0,0.573008849557522,3,3,6
"hbase-server/src/main/java/org/apache/hadoop/hbase/master/ClusterStatusPublisher.java",0,1,0,1,1
"hbase-server/src/main/java/org/apache/hadoop/hbase/master/DeadServer.java",0,0.459302325581395,2,3,5
"hbase-server/src/main/java/org/apache/hadoop/hbase/master/GeneralBulkAssigner.java",0,0.970338983050847,1,1,2
"hbase-server/src/main/java/org/apache/hadoop/hbase/master/HMaster.java",0,0.475867269984917,17,5,22
"hbase-server/src/main/java/org/apache/hadoop/hbase/master/HMasterCommandLine.java",0,0.748987854251012,6,2,8
"hbase-server/src/main/java/org/apache/hadoop/hbase/master/LoadBalancer.java",0,0.940594059405941,3,1,4
"hbase-server/src/main/java/org/apache/hadoop/hbase/master/MasterCoprocessorHost.java",0,0.383512544802867,4,4,8
"hbase-server/src/main/java/org/apache/hadoop/hbase/master/MasterDumpServlet.java",0,0.932773109243697,2,1,3
"hbase-server/src/main/java/org/apache/hadoop/hbase/master/MasterFileSystem.java",0,0.54531490015361,9,4,13
"hbase-server/src/main/java/org/apache/hadoop/hbase/master/MasterServices.java",0,0.352941176470588,4,5,9
"hbase-server/src/main/java/org/apache/hadoop/hbase/master/MasterStatusServlet.java",0,0.771186440677966,1,2,3
"hbase-server/src/main/java/org/apache/hadoop/hbase/master/MetricsMaster.java",0,0.532608695652174,0,4,4
"hbase-server/src/main/java/org/apache/hadoop/hbase/master/MetricsMasterWrapperImpl.java",0,0.702970297029703,1,2,3
"hbase-server/src/main/java/org/apache/hadoop/hbase/master/OfflineCallback.java",0,1,0,1,1
"hbase-server/src/main/java/org/apache/hadoop/hbase/master/RegionPlan.java",0,0.978102189781022,1,1,2
"hbase-server/src/main/java/org/apache/hadoop/hbase/master/RegionStates.java",0,0.996415770609319,1,1,2
"hbase-server/src/main/java/org/apache/hadoop/hbase/master/ServerManager.java",0,0.550488599348534,10,4,14
"hbase-server/src/main/java/org/apache/hadoop/hbase/master/SnapshotSentinel.java",0,1,0,1,1
"hbase-server/src/main/java/org/apache/hadoop/hbase/master/SplitLogManager.java",0,0.730023273855702,8,2,10
"hbase-server/src/main/java/org/apache/hadoop/hbase/master/TableLockManager.java",0,0.997416020671835,1,1,2
"hbase-server/src/main/java/org/apache/hadoop/hbase/master/UnAssignCallable.java",0,0.978723404255319,1,1,2
"hbase-server/src/main/java/org/apache/hadoop/hbase/master/balancer/BalancerChore.java",0,0.811320754716981,0,2,2
"hbase-server/src/main/java/org/apache/hadoop/hbase/master/balancer/BaseLoadBalancer.java",0,1,0,1,1
"hbase-server/src/main/java/org/apache/hadoop/hbase/master/balancer/ClusterLoadState.java",0,1,0,1,1
"hbase-server/src/main/java/org/apache/hadoop/hbase/master/balancer/ClusterStatusChore.java",0,1,0,1,1
"hbase-server/src/main/java/org/apache/hadoop/hbase/master/balancer/DefaultLoadBalancer.java",0,0.970786516853933,2,1,3
"hbase-server/src/main/java/org/apache/hadoop/hbase/master/balancer/LoadBalancerFactory.java",0,0.978260869565217,1,1,2
"hbase-server/src/main/java/org/apache/hadoop/hbase/master/balancer/RegionInfoComparator.java",0,1,0,1,1
"hbase-server/src/main/java/org/apache/hadoop/hbase/master/balancer/RegionLocationFinder.java",0,0.994791666666667,1,1,2
"hbase-server/src/main/java/org/apache/hadoop/hbase/master/balancer/ServerAndLoad.java",0,1,0,1,1
"hbase-server/src/main/java/org/apache/hadoop/hbase/master/balancer/StochasticLoadBalancer.java",0,0.986486486486487,2,1,3
"hbase-server/src/main/java/org/apache/hadoop/hbase/master/cleaner/BaseHFileCleanerDelegate.java",0,0.981132075471698,1,1,2
"hbase-server/src/main/java/org/apache/hadoop/hbase/master/cleaner/BaseLogCleanerDelegate.java",0,0.431034482758621,0,3,3
"hbase-server/src/main/java/org/apache/hadoop/hbase/master/cleaner/CleanerChore.java",0,0.680933852140078,1,3,4
"hbase-server/src/main/java/org/apache/hadoop/hbase/master/cleaner/FileCleanerDelegate.java",0,0.975,1,1,2
"hbase-server/src/main/java/org/apache/hadoop/hbase/master/cleaner/HFileCleaner.java",0,0.765625,1,2,3
"hbase-server/src/main/java/org/apache/hadoop/hbase/master/cleaner/HFileLinkCleaner.java",0,1,0,1,1
"hbase-server/src/main/java/org/apache/hadoop/hbase/master/cleaner/LogCleaner.java",0,0.964912280701754,1,1,2
"hbase-server/src/main/java/org/apache/hadoop/hbase/master/cleaner/TimeToLiveHFileCleaner.java",0,0.904255319148936,3,1,4
"hbase-server/src/main/java/org/apache/hadoop/hbase/master/cleaner/TimeToLiveLogCleaner.java",0,0.623376623376623,0,4,4
"hbase-server/src/main/java/org/apache/hadoop/hbase/master/handler/ClosedRegionHandler.java",0,0.915094339622642,4,1,5
"hbase-server/src/main/java/org/apache/hadoop/hbase/master/handler/CreateTableHandler.java",0,0.370656370656371,4,4,8
"hbase-server/src/main/java/org/apache/hadoop/hbase/master/handler/DeleteTableHandler.java",0,0.513513513513513,4,5,9
"hbase-server/src/main/java/org/apache/hadoop/hbase/master/handler/DisableTableHandler.java",0,0.603448275862069,6,2,8
"hbase-server/src/main/java/org/apache/hadoop/hbase/master/handler/DispatchMergingRegionHandler.java",0,1,0,1,1
"hbase-server/src/main/java/org/apache/hadoop/hbase/master/handler/EnableTableHandler.java",0,0.477124183006536,2,5,7
"hbase-server/src/main/java/org/apache/hadoop/hbase/master/handler/MergedRegionHandler.java",0,1,0,1,1
"hbase-server/src/main/java/org/apache/hadoop/hbase/master/handler/MetaServerShutdownHandler.java",0,0.612903225806452,1,2,3
"hbase-server/src/main/java/org/apache/hadoop/hbase/master/handler/ModifyTableHandler.java",0,0.710526315789474,3,3,6
"hbase-server/src/main/java/org/apache/hadoop/hbase/master/handler/OpenedRegionHandler.java",0,0.644295302013423,5,2,7
"hbase-server/src/main/java/org/apache/hadoop/hbase/master/handler/ServerShutdownHandler.java",0,0.348101265822785,5,4,9
"hbase-server/src/main/java/org/apache/hadoop/hbase/master/handler/SplitRegionHandler.java",0,0.793388429752066,2,3,5
"hbase-server/src/main/java/org/apache/hadoop/hbase/master/handler/TableAddFamilyHandler.java",0,0.727272727272727,3,3,6
"hbase-server/src/main/java/org/apache/hadoop/hbase/master/handler/TableDeleteFamilyHandler.java",0,0.681818181818182,2,4,6
"hbase-server/src/main/java/org/apache/hadoop/hbase/master/handler/TableEventHandler.java",0,0.538793103448276,3,3,6
"hbase-server/src/main/java/org/apache/hadoop/hbase/master/handler/TableModifyFamilyHandler.java",0,0.75609756097561,2,3,5
"hbase-server/src/main/java/org/apache/hadoop/hbase/master/handler/TotesHRegionInfo.java",0,0.567567567567568,0,2,2
"hbase-server/src/main/java/org/apache/hadoop/hbase/master/snapshot/CloneSnapshotHandler.java",0,0.915584415584416,2,2,4
"hbase-server/src/main/java/org/apache/hadoop/hbase/master/snapshot/DisabledTableSnapshotHandler.java",0,0.851063829787234,3,2,5
"hbase-server/src/main/java/org/apache/hadoop/hbase/master/snapshot/EnabledTableSnapshotHandler.java",0,0.92156862745098,1,2,3
"hbase-server/src/main/java/org/apache/hadoop/hbase/master/snapshot/MasterSnapshotVerifier.java",0,0.938325991189427,3,1,4
"hbase-server/src/main/java/org/apache/hadoop/hbase/master/snapshot/RestoreSnapshotHandler.java",0,0.929936305732484,2,1,3
"hbase-server/src/main/java/org/apache/hadoop/hbase/master/snapshot/SnapshotFileCache.java",0,0.957654723127036,1,1,2
"hbase-server/src/main/java/org/apache/hadoop/hbase/master/snapshot/SnapshotHFileCleaner.java",0,0.980769230769231,1,1,2
"hbase-server/src/main/java/org/apache/hadoop/hbase/master/snapshot/SnapshotLogCleaner.java",0,0.970588235294118,1,1,2
"hbase-server/src/main/java/org/apache/hadoop/hbase/master/snapshot/SnapshotManager.java",0,0.947712418300654,3,1,4
"hbase-server/src/main/java/org/apache/hadoop/hbase/master/snapshot/TakeSnapshotHandler.java",0,0.845283018867925,2,2,4
"hbase-server/src/main/java/org/apache/hadoop/hbase/metrics/ExactCounterMetric.java",0,1,0,1,1
"hbase-server/src/main/java/org/apache/hadoop/hbase/metrics/HBaseInfo.java",0,0.764705882352941,0,2,2
"hbase-server/src/main/java/org/apache/hadoop/hbase/metrics/MetricsMBeanBase.java",0,0.617283950617284,1,3,4
"hbase-server/src/main/java/org/apache/hadoop/hbase/metrics/MetricsRate.java",0,0.876404494382023,0,2,2
"hbase-server/src/main/java/org/apache/hadoop/hbase/metrics/MetricsString.java",0,1,0,1,1
"hbase-server/src/main/java/org/apache/hadoop/hbase/metrics/PersistentMetricsTimeVaryingRate.java",0,0.99290780141844,1,1,2
"hbase-server/src/main/java/org/apache/hadoop/hbase/metrics/file/TimeStampingFileContext.java",0,1,0,1,1
"hbase-server/src/main/java/org/apache/hadoop/hbase/metrics/histogram/MetricsHistogram.java",0,0.916666666666667,0,2,2
"hbase-server/src/main/java/org/apache/hadoop/hbase/monitoring/LogMonitoring.java",0,0.948453608247423,2,1,3
"hbase-server/src/main/java/org/apache/hadoop/hbase/monitoring/MemoryBoundedLogMessageBuffer.java",0,0.96551724137931,1,1,2
"hbase-server/src/main/java/org/apache/hadoop/hbase/monitoring/MonitoredRPCHandler.java",0,1,0,1,1
"hbase-server/src/main/java/org/apache/hadoop/hbase/monitoring/MonitoredRPCHandlerImpl.java",0,1,0,1,1
"hbase-server/src/main/java/org/apache/hadoop/hbase/monitoring/MonitoredTask.java",0,0.576923076923077,0,2,2
"hbase-server/src/main/java/org/apache/hadoop/hbase/monitoring/MonitoredTaskImpl.java",0,0.533333333333333,0,2,2
"hbase-server/src/main/java/org/apache/hadoop/hbase/monitoring/StateDumpServlet.java",0,0.952380952380952,1,1,2
"hbase-server/src/main/java/org/apache/hadoop/hbase/monitoring/TaskMonitor.java",0,0.887387387387387,0,2,2
"hbase-server/src/main/java/org/apache/hadoop/hbase/monitoring/ThreadMonitoring.java",0,0.938775510204082,0,2,2
"hbase-server/src/main/java/org/apache/hadoop/hbase/procedure/Procedure.java",0,0.978891820580475,1,1,2
"hbase-server/src/main/java/org/apache/hadoop/hbase/procedure/ProcedureCoordinator.java",0,0.988805970149254,1,1,2
"hbase-server/src/main/java/org/apache/hadoop/hbase/procedure/ProcedureCoordinatorRpcs.java",0,1,0,1,1
"hbase-server/src/main/java/org/apache/hadoop/hbase/procedure/ProcedureMember.java",0,0.974137931034483,1,1,2
"hbase-server/src/main/java/org/apache/hadoop/hbase/procedure/ProcedureMemberRpcs.java",0,1,0,1,1
"hbase-server/src/main/java/org/apache/hadoop/hbase/procedure/Subprocedure.java",0,0.996978851963746,1,1,2
"hbase-server/src/main/java/org/apache/hadoop/hbase/procedure/SubprocedureFactory.java",0,1,0,1,1
"hbase-server/src/main/java/org/apache/hadoop/hbase/procedure/ZKProcedureCoordinatorRpcs.java",0,0.936329588014981,0,2,2
"hbase-server/src/main/java/org/apache/hadoop/hbase/procedure/ZKProcedureMemberRpcs.java",0,0.923295454545455,1,2,3
"hbase-server/src/main/java/org/apache/hadoop/hbase/procedure/ZKProcedureUtil.java",0,0.996491228070175,1,1,2
"hbase-server/src/main/java/org/apache/hadoop/hbase/protobuf/ReplicationProtbufUtil.java",0,1,0,1,1
"hbase-server/src/main/java/org/apache/hadoop/hbase/regionserver/BaseRowProcessor.java",0,0.843137254901961,0,2,2
"hbase-server/src/main/java/org/apache/hadoop/hbase/regionserver/ChangedReadersObserver.java",0,0.648648648648649,2,2,4
"hbase-server/src/main/java/org/apache/hadoop/hbase/regionserver/ColumnCount.java",0,0.792792792792793,0,3,3
"hbase-server/src/main/java/org/apache/hadoop/hbase/regionserver/ColumnTracker.java",0,0.532710280373832,2,2,4
"hbase-server/src/main/java/org/apache/hadoop/hbase/regionserver/CompactSplitThread.java",0,0.247641509433962,4,6,10
"hbase-server/src/main/java/org/apache/hadoop/hbase/regionserver/CompactionRequestor.java",0,0.391304347826087,2,5,7
"hbase-server/src/main/java/org/apache/hadoop/hbase/regionserver/CompactionTool.java",0,0.925438596491228,2,2,4
"hbase-server/src/main/java/org/apache/hadoop/hbase/regionserver/ConstantSizeRegionSplitPolicy.java",0,0.723684210526316,2,3,5
"hbase-server/src/main/java/org/apache/hadoop/hbase/regionserver/DebugPrint.java",0,0.690140845070423,1,2,3
"hbase-server/src/main/java/org/apache/hadoop/hbase/regionserver/DefaultStoreEngine.java",0,0.663366336633663,0,2,2
"hbase-server/src/main/java/org/apache/hadoop/hbase/regionserver/DefaultStoreFileManager.java",0,0.916083916083916,0,2,2
"hbase-server/src/main/java/org/apache/hadoop/hbase/regionserver/DeleteTracker.java",0,0.758928571428571,0,3,3
"hbase-server/src/main/java/org/apache/hadoop/hbase/regionserver/DelimitedKeyPrefixRegionSplitPolicy.java",0,1,0,1,1
"hbase-server/src/main/java/org/apache/hadoop/hbase/regionserver/ExplicitColumnTracker.java",0,0.281746031746032,3,4,7
"hbase-server/src/main/java/org/apache/hadoop/hbase/regionserver/FlushRequester.java",0,0.742857142857143,1,2,3
"hbase-server/src/main/java/org/apache/hadoop/hbase/regionserver/GetClosestRowBeforeTracker.java",0,0.991666666666667,2,1,3
"hbase-server/src/main/java/org/apache/hadoop/hbase/regionserver/HRegion.java",0,0.292399782332668,20,5,25
"hbase-server/src/main/java/org/apache/hadoop/hbase/regionserver/HRegionFileSystem.java",0,0.82017982017982,1,2,3
"hbase-server/src/main/java/org/apache/hadoop/hbase/regionserver/HRegionServer.java",0,0.60270202651989,21,3,24
"hbase-server/src/main/java/org/apache/hadoop/hbase/regionserver/HRegionServerCommandLine.java",0,0.965909090909091,1,1,2
"hbase-server/src/main/java/org/apache/hadoop/hbase/regionserver/HRegionThriftServer.java",0,0.641975308641975,1,3,4
"hbase-server/src/main/java/org/apache/hadoop/hbase/regionserver/HStore.java",0,0.656284153005464,7,4,11
"hbase-server/src/main/java/org/apache/hadoop/hbase/regionserver/IncreasingToUpperBoundRegionSplitPolicy.java",0,0.915254237288136,1,2,3
"hbase-server/src/main/java/org/apache/hadoop/hbase/regionserver/InternalScan.java",0,0.962025316455696,1,1,2
"hbase-server/src/main/java/org/apache/hadoop/hbase/regionserver/InternalScanner.java",0,0.229885057471264,0,7,7
"hbase-server/src/main/java/org/apache/hadoop/hbase/regionserver/KeyPrefixRegionSplitPolicy.java",0,0.813953488372093,1,2,3
"hbase-server/src/main/java/org/apache/hadoop/hbase/regionserver/KeyValueHeap.java",0,0.41031941031941,3,4,7
"hbase-server/src/main/java/org/apache/hadoop/hbase/regionserver/KeyValueScanner.java",0,0.312,1,4,5
"hbase-server/src/main/java/org/apache/hadoop/hbase/regionserver/KeyValueSkipListSet.java",0,0.956521739130435,2,1,3
"hbase-server/src/main/java/org/apache/hadoop/hbase/regionserver/LastSequenceId.java",0,1,0,1,1
"hbase-server/src/main/java/org/apache/hadoop/hbase/regionserver/LeaseListener.java",0,0.583333333333333,0,3,3
"hbase-server/src/main/java/org/apache/hadoop/hbase/regionserver/Leases.java",0,0.346666666666667,3,4,7
"hbase-server/src/main/java/org/apache/hadoop/hbase/regionserver/LogRoller.java",0,0.54679802955665,7,3,10
"hbase-server/src/main/java/org/apache/hadoop/hbase/regionserver/LruHashMap.java",0,0.922727272727273,1,2,3
"hbase-server/src/main/java/org/apache/hadoop/hbase/regionserver/MemStore.java",0,0.451707317073171,6,6,12
"hbase-server/src/main/java/org/apache/hadoop/hbase/regionserver/MemStoreChunkPool.java",0,1,0,1,1
"hbase-server/src/main/java/org/apache/hadoop/hbase/regionserver/MemStoreFlusher.java",0,0.420489296636086,9,4,13
"hbase-server/src/main/java/org/apache/hadoop/hbase/regionserver/MemStoreLAB.java",0,0.719298245614035,3,2,5
"hbase-server/src/main/java/org/apache/hadoop/hbase/regionserver/MetaLogRoller.java",0,1,0,1,1
"hbase-server/src/main/java/org/apache/hadoop/hbase/regionserver/MetricsRegion.java",0,1,0,1,1
"hbase-server/src/main/java/org/apache/hadoop/hbase/regionserver/MetricsRegionServer.java",0,1,0,1,1
"hbase-server/src/main/java/org/apache/hadoop/hbase/regionserver/MetricsRegionServerWrapperImpl.java",0,1,0,1,1
"hbase-server/src/main/java/org/apache/hadoop/hbase/regionserver/MetricsRegionWrapperImpl.java",0,0.894736842105263,0,2,2
"hbase-server/src/main/java/org/apache/hadoop/hbase/regionserver/MiniBatchOperationInProgress.java",0,1,0,1,1
"hbase-server/src/main/java/org/apache/hadoop/hbase/regionserver/MultiRowMutationProcessor.java",0,0.821917808219178,2,2,4
"hbase-server/src/main/java/org/apache/hadoop/hbase/regionserver/MultiVersionConsistencyControl.java",0,0.466101694915254,0,6,6
"hbase-server/src/main/java/org/apache/hadoop/hbase/regionserver/NonLazyKeyValueScanner.java",0,0.614285714285714,1,2,3
"hbase-server/src/main/java/org/apache/hadoop/hbase/regionserver/OnlineRegions.java",0,0.863636363636364,1,2,3
"hbase-server/src/main/java/org/apache/hadoop/hbase/regionserver/OperationStatus.java",0,0.972972972972973,1,1,2
"hbase-server/src/main/java/org/apache/hadoop/hbase/regionserver/QosFunction.java",0,1,0,1,1
"hbase-server/src/main/java/org/apache/hadoop/hbase/regionserver/RSDumpServlet.java",0,0.728070175438597,0,2,2
"hbase-server/src/main/java/org/apache/hadoop/hbase/regionserver/RSStatusServlet.java",0,0.826923076923077,0,2,2
"hbase-server/src/main/java/org/apache/hadoop/hbase/regionserver/RegionCoprocessorHost.java",0,0.375469336670839,7,5,12
"hbase-server/src/main/java/org/apache/hadoop/hbase/regionserver/RegionMergeRequest.java",0,0.805755395683453,0,2,2
"hbase-server/src/main/java/org/apache/hadoop/hbase/regionserver/RegionMergeTransaction.java",0,0.957198443579767,1,1,2
"hbase-server/src/main/java/org/apache/hadoop/hbase/regionserver/RegionScanner.java",0,0.448598130841121,1,3,4
"hbase-server/src/main/java/org/apache/hadoop/hbase/regionserver/RegionServerAccounting.java",0,0.51,0,2,2
"hbase-server/src/main/java/org/apache/hadoop/hbase/regionserver/RegionServerCoprocessorHost.java",0,1,0,1,1
"hbase-server/src/main/java/org/apache/hadoop/hbase/regionserver/RegionServerServices.java",0,0.563636363636364,5,5,10
"hbase-server/src/main/java/org/apache/hadoop/hbase/regionserver/RegionSplitPolicy.java",0,0.852713178294574,1,3,4
"hbase-server/src/main/java/org/apache/hadoop/hbase/regionserver/ReplicationService.java",0,0.962962962962963,1,1,2
"hbase-server/src/main/java/org/apache/hadoop/hbase/regionserver/ReplicationSinkService.java",0,0.95,0,2,2
"hbase-server/src/main/java/org/apache/hadoop/hbase/regionserver/ReplicationSourceService.java",0,0.948717948717949,0,2,2
"hbase-server/src/main/java/org/apache/hadoop/hbase/regionserver/RowProcessor.java",0,0.698529411764706,2,2,4
"hbase-server/src/main/java/org/apache/hadoop/hbase/regionserver/ScanDeleteTracker.java",0,0.757575757575758,2,2,4
"hbase-server/src/main/java/org/apache/hadoop/hbase/regionserver/ScanInfo.java",0,1,0,1,1
"hbase-server/src/main/java/org/apache/hadoop/hbase/regionserver/ScanQueryMatcher.java",0,0.406360424028269,5,5,10
"hbase-server/src/main/java/org/apache/hadoop/hbase/regionserver/ScanType.java",0,0.933333333333333,0,2,2
"hbase-server/src/main/java/org/apache/hadoop/hbase/regionserver/ScanWildcardColumnTracker.java",0,0.411167512690355,3,4,7
"hbase-server/src/main/java/org/apache/hadoop/hbase/regionserver/ShutdownHook.java",0,0.921052631578947,1,2,3
"hbase-server/src/main/java/org/apache/hadoop/hbase/regionserver/SplitLogWorker.java",0,0.859375,6,2,8
"hbase-server/src/main/java/org/apache/hadoop/hbase/regionserver/SplitRequest.java",0,0.392857142857143,2,5,7
"hbase-server/src/main/java/org/apache/hadoop/hbase/regionserver/SplitTransaction.java",0,0.576413959085439,8,4,12
"hbase-server/src/main/java/org/apache/hadoop/hbase/regionserver/Store.java",0,0.631578947368421,13,2,15
"hbase-server/src/main/java/org/apache/hadoop/hbase/regionserver/StoreConfigInformation.java",0,0.86046511627907,0,2,2
"hbase-server/src/main/java/org/apache/hadoop/hbase/regionserver/StoreEngine.java",0,0.724137931034483,0,2,2
"hbase-server/src/main/java/org/apache/hadoop/hbase/regionserver/StoreFile.java",0,0.221446700507614,11,6,17
"hbase-server/src/main/java/org/apache/hadoop/hbase/regionserver/StoreFileInfo.java",0,1,0,1,1
"hbase-server/src/main/java/org/apache/hadoop/hbase/regionserver/StoreFileManager.java",0,0.952755905511811,1,1,2
"hbase-server/src/main/java/org/apache/hadoop/hbase/regionserver/StoreFileScanner.java",0,0.264935064935065,5,6,11
"hbase-server/src/main/java/org/apache/hadoop/hbase/regionserver/StoreFlusher.java",0,0.907692307692308,3,1,4
"hbase-server/src/main/java/org/apache/hadoop/hbase/regionserver/StoreScanner.java",0,0.195014662756598,7,6,13
"hbase-server/src/main/java/org/apache/hadoop/hbase/regionserver/StoreUtils.java",0,0.705882352941177,0,2,2
"hbase-server/src/main/java/org/apache/hadoop/hbase/regionserver/TimeRangeTracker.java",0,0.947019867549669,2,1,3
"hbase-server/src/main/java/org/apache/hadoop/hbase/regionserver/compactions/CompactionConfiguration.java",0,0.943181818181818,2,1,3
"hbase-server/src/main/java/org/apache/hadoop/hbase/regionserver/compactions/CompactionContext.java",0,1,0,1,1
"hbase-server/src/main/java/org/apache/hadoop/hbase/regionserver/compactions/CompactionPolicy.java",0,0.561643835616438,0,3,3
"hbase-server/src/main/java/org/apache/hadoop/hbase/regionserver/compactions/CompactionProgress.java",0,0.981481481481482,1,1,2
"hbase-server/src/main/java/org/apache/hadoop/hbase/regionserver/compactions/CompactionRequest.java",0,0.803493449781659,1,3,4
"hbase-server/src/main/java/org/apache/hadoop/hbase/regionserver/compactions/Compactor.java",0,0.693548387096774,2,3,5
"hbase-server/src/main/java/org/apache/hadoop/hbase/regionserver/compactions/DefaultCompactionPolicy.java",0,0.783505154639175,0,3,3
"hbase-server/src/main/java/org/apache/hadoop/hbase/regionserver/compactions/DefaultCompactor.java",0,0.505154639175258,4,3,7
"hbase-server/src/main/java/org/apache/hadoop/hbase/regionserver/compactions/OffPeakCompactions.java",0,1,0,1,1
"hbase-server/src/main/java/org/apache/hadoop/hbase/regionserver/handler/CloseMetaHandler.java",0,0.869565217391304,1,2,3
"hbase-server/src/main/java/org/apache/hadoop/hbase/regionserver/handler/CloseRegionHandler.java",0,0.608490566037736,4,3,7
"hbase-server/src/main/java/org/apache/hadoop/hbase/regionserver/handler/CloseRootHandler.java",0,0.869565217391304,1,2,3
"hbase-server/src/main/java/org/apache/hadoop/hbase/regionserver/handler/OpenMetaHandler.java",0,0.5,1,2,3
"hbase-server/src/main/java/org/apache/hadoop/hbase/regionserver/handler/OpenRegionHandler.java",0,0.61121157323689,6,4,10
"hbase-server/src/main/java/org/apache/hadoop/hbase/regionserver/handler/OpenRootHandler.java",0,0.521739130434783,1,2,3
"hbase-server/src/main/java/org/apache/hadoop/hbase/regionserver/handler/ParallelSeekHandler.java",0,0.986486486486487,1,1,2
"hbase-server/src/main/java/org/apache/hadoop/hbase/regionserver/snapshot/FlushSnapshotSubprocedure.java",0,0.968944099378882,2,1,3
"hbase-server/src/main/java/org/apache/hadoop/hbase/regionserver/snapshot/RegionServerSnapshotManager.java",0,0.981432360742706,2,1,3
"hbase-server/src/main/java/org/apache/hadoop/hbase/regionserver/wal/CompressionContext.java",0,1,0,1,1
"hbase-server/src/main/java/org/apache/hadoop/hbase/regionserver/wal/Compressor.java",0,0.963541666666667,2,1,3
"hbase-server/src/main/java/org/apache/hadoop/hbase/regionserver/wal/Dictionary.java",0,1,0,1,1
"hbase-server/src/main/java/org/apache/hadoop/hbase/regionserver/wal/FSHLog.java",0,0.764222069910898,6,2,8
"hbase-server/src/main/java/org/apache/hadoop/hbase/regionserver/wal/HLog.java",0,0.547945205479452,7,4,11
"hbase-server/src/main/java/org/apache/hadoop/hbase/regionserver/wal/HLogFactory.java",0,0.9140625,1,2,3
"hbase-server/src/main/java/org/apache/hadoop/hbase/regionserver/wal/HLogKey.java",0,0.600609756097561,1,5,6
"hbase-server/src/main/java/org/apache/hadoop/hbase/regionserver/wal/HLogPrettyPrinter.java",0,0.978891820580475,2,1,3
"hbase-server/src/main/java/org/apache/hadoop/hbase/regionserver/wal/HLogSplitter.java",0,0.649966147596479,9,2,11
"hbase-server/src/main/java/org/apache/hadoop/hbase/regionserver/wal/HLogUtil.java",0,0.96551724137931,2,1,3
"hbase-server/src/main/java/org/apache/hadoop/hbase/regionserver/wal/KeyValueCompression.java",0,1,0,1,1
"hbase-server/src/main/java/org/apache/hadoop/hbase/regionserver/wal/LRUDictionary.java",0,1,0,1,1
"hbase-server/src/main/java/org/apache/hadoop/hbase/regionserver/wal/MetricsWAL.java",0,1,0,1,1
"hbase-server/src/main/java/org/apache/hadoop/hbase/regionserver/wal/SequenceFileLogReader.java",0,0.581993569131833,0,3,3
"hbase-server/src/main/java/org/apache/hadoop/hbase/regionserver/wal/SequenceFileLogWriter.java",0,0.547794117647059,1,4,5
"hbase-server/src/main/java/org/apache/hadoop/hbase/regionserver/wal/WALActionsListener.java",0,0.698924731182796,1,2,3
"hbase-server/src/main/java/org/apache/hadoop/hbase/regionserver/wal/WALCoprocessorHost.java",0,0.764705882352941,1,3,4
"hbase-server/src/main/java/org/apache/hadoop/hbase/regionserver/wal/WALEdit.java",0,0.525,0,3,3
"hbase-server/src/main/java/org/apache/hadoop/hbase/replication/master/ReplicationLogCleaner.java",0,0.741176470588235,1,3,4
"hbase-server/src/main/java/org/apache/hadoop/hbase/replication/regionserver/MetricsSink.java",0,0.72,0,3,3
"hbase-server/src/main/java/org/apache/hadoop/hbase/replication/regionserver/MetricsSource.java",0,0.924528301886792,0,2,2
"hbase-server/src/main/java/org/apache/hadoop/hbase/replication/regionserver/Replication.java",0,0.607017543859649,3,3,6
"hbase-server/src/main/java/org/apache/hadoop/hbase/replication/regionserver/ReplicationHLogReaderManager.java",0,0.937062937062937,3,1,4
"hbase-server/src/main/java/org/apache/hadoop/hbase/replication/regionserver/ReplicationSink.java",0,0.524793388429752,4,2,6
"hbase-server/src/main/java/org/apache/hadoop/hbase/replication/regionserver/ReplicationSource.java",0,0.763358778625954,4,3,7
"hbase-server/src/main/java/org/apache/hadoop/hbase/replication/regionserver/ReplicationSourceInterface.java",0,0.932692307692308,0,2,2
"hbase-server/src/main/java/org/apache/hadoop/hbase/replication/regionserver/ReplicationSourceManager.java",0,0.877611940298507,2,2,4
"hbase-server/src/main/java/org/apache/hadoop/hbase/rest/Constants.java",0,0.847826086956522,0,2,2
"hbase-server/src/main/java/org/apache/hadoop/hbase/rest/ExistsResource.java",0,0.96,1,1,2
"hbase-server/src/main/java/org/apache/hadoop/hbase/rest/MetricsREST.java",0,0.404494382022472,0,4,4
"hbase-server/src/main/java/org/apache/hadoop/hbase/rest/MultiRowResource.java",0,0.849056603773585,2,2,4
"hbase-server/src/main/java/org/apache/hadoop/hbase/rest/ProtobufMessageHandler.java",0,0.934782608695652,0,2,2
"hbase-server/src/main/java/org/apache/hadoop/hbase/rest/RESTServer.java",0,0.430769230769231,1,3,4
"hbase-server/src/main/java/org/apache/hadoop/hbase/rest/RESTServlet.java",0,0.588235294117647,2,3,5
"hbase-server/src/main/java/org/apache/hadoop/hbase/rest/RegionsResource.java",0,0.865384615384615,3,2,5
"hbase-server/src/main/java/org/apache/hadoop/hbase/rest/ResourceBase.java",0,0.911764705882353,0,2,2
"hbase-server/src/main/java/org/apache/hadoop/hbase/rest/ResourceConfig.java",0,0.903225806451613,0,2,2
"hbase-server/src/main/java/org/apache/hadoop/hbase/rest/ResultGenerator.java",0,0.959183673469388,1,1,2
"hbase-server/src/main/java/org/apache/hadoop/hbase/rest/RootResource.java",0,0.962962962962963,2,1,3
"hbase-server/src/main/java/org/apache/hadoop/hbase/rest/RowResource.java",0,0.711504424778761,3,2,5
"hbase-server/src/main/java/org/apache/hadoop/hbase/rest/RowResultGenerator.java",0,0.966666666666667,3,1,4
"hbase-server/src/main/java/org/apache/hadoop/hbase/rest/RowSpec.java",0,0.995024875621891,1,1,2
"hbase-server/src/main/java/org/apache/hadoop/hbase/rest/ScannerInstanceResource.java",0,0.884422110552764,1,2,3
"hbase-server/src/main/java/org/apache/hadoop/hbase/rest/ScannerResource.java",0,0.891025641025641,3,2,5
"hbase-server/src/main/java/org/apache/hadoop/hbase/rest/ScannerResultGenerator.java",0,0.92817679558011,3,1,4
"hbase-server/src/main/java/org/apache/hadoop/hbase/rest/SchemaResource.java",0,0.925650557620818,3,1,4
"hbase-server/src/main/java/org/apache/hadoop/hbase/rest/StorageClusterStatusResource.java",0,0.807339449541284,1,3,4
"hbase-server/src/main/java/org/apache/hadoop/hbase/rest/StorageClusterVersionResource.java",0,0.949367088607595,2,1,3
"hbase-server/src/main/java/org/apache/hadoop/hbase/rest/TableResource.java",0,0.882978723404255,0,2,2
"hbase-server/src/main/java/org/apache/hadoop/hbase/rest/VersionResource.java",0,0.971153846153846,2,1,3
"hbase-server/src/main/java/org/apache/hadoop/hbase/rest/client/Client.java",0,0.892857142857143,1,2,3
"hbase-server/src/main/java/org/apache/hadoop/hbase/rest/client/Cluster.java",0,0.932038834951456,0,2,2
"hbase-server/src/main/java/org/apache/hadoop/hbase/rest/client/RemoteAdmin.java",0,0.979057591623037,1,1,2
"hbase-server/src/main/java/org/apache/hadoop/hbase/rest/client/RemoteHTable.java",0,0.762210796915167,5,2,7
"hbase-server/src/main/java/org/apache/hadoop/hbase/rest/client/Response.java",0,0.968992248062015,1,1,2
"hbase-server/src/main/java/org/apache/hadoop/hbase/rest/filter/GZIPRequestStream.java",0,0.931034482758621,0,2,2
"hbase-server/src/main/java/org/apache/hadoop/hbase/rest/filter/GZIPRequestWrapper.java",0,0.923076923076923,0,2,2
"hbase-server/src/main/java/org/apache/hadoop/hbase/rest/filter/GZIPResponseStream.java",0,0.948717948717949,0,2,2
"hbase-server/src/main/java/org/apache/hadoop/hbase/rest/filter/GZIPResponseWrapper.java",0,0.972789115646258,1,1,2
"hbase-server/src/main/java/org/apache/hadoop/hbase/rest/filter/GzipFilter.java",0,0.952380952380952,1,1,2
"hbase-server/src/main/java/org/apache/hadoop/hbase/rest/model/CellModel.java",0,0.949748743718593,2,1,3
"hbase-server/src/main/java/org/apache/hadoop/hbase/rest/model/CellSetModel.java",0,0.986666666666667,1,1,2
"hbase-server/src/main/java/org/apache/hadoop/hbase/rest/model/ColumnSchemaModel.java",0,0.962025316455696,1,1,2
"hbase-server/src/main/java/org/apache/hadoop/hbase/rest/model/RowModel.java",0,0.986013986013986,1,1,2
"hbase-server/src/main/java/org/apache/hadoop/hbase/rest/model/ScannerModel.java",0,0.939040207522698,3,1,4
"hbase-server/src/main/java/org/apache/hadoop/hbase/rest/model/StorageClusterStatusModel.java",0,0.776649746192893,2,2,4
"hbase-server/src/main/java/org/apache/hadoop/hbase/rest/model/StorageClusterVersionModel.java",0,0.955223880597015,1,1,2
"hbase-server/src/main/java/org/apache/hadoop/hbase/rest/model/TableInfoModel.java",0,0.98125,1,1,2
"hbase-server/src/main/java/org/apache/hadoop/hbase/rest/model/TableListModel.java",0,0.982300884955752,1,1,2
"hbase-server/src/main/java/org/apache/hadoop/hbase/rest/model/TableModel.java",0,0.964285714285714,1,1,2
"hbase-server/src/main/java/org/apache/hadoop/hbase/rest/model/TableRegionModel.java",0,0.928571428571429,0,2,2
"hbase-server/src/main/java/org/apache/hadoop/hbase/rest/model/TableSchemaModel.java",0,0.991525423728814,1,1,2
"hbase-server/src/main/java/org/apache/hadoop/hbase/rest/model/VersionModel.java",0,0.990430622009569,1,1,2
"hbase-server/src/main/java/org/apache/hadoop/hbase/rest/protobuf/generated/CellMessage.java",0,0.647985989492119,0,2,2
"hbase-server/src/main/java/org/apache/hadoop/hbase/rest/protobuf/generated/CellSetMessage.java",0,0.503585657370518,0,2,2
"hbase-server/src/main/java/org/apache/hadoop/hbase/rest/protobuf/generated/ColumnSchemaMessage.java",0,0.513703443429375,0,2,2
"hbase-server/src/main/java/org/apache/hadoop/hbase/rest/protobuf/generated/ScannerMessage.java",0,0.517021276595745,0,3,3
"hbase-server/src/main/java/org/apache/hadoop/hbase/rest/protobuf/generated/StorageClusterStatusMessage.java",0,0.437869822485207,0,3,3
"hbase-server/src/main/java/org/apache/hadoop/hbase/rest/protobuf/generated/TableInfoMessage.java",0,0.501797268152408,0,2,2
"hbase-server/src/main/java/org/apache/hadoop/hbase/rest/protobuf/generated/TableListMessage.java",0,0.696145124716553,0,2,2
"hbase-server/src/main/java/org/apache/hadoop/hbase/rest/protobuf/generated/TableSchemaMessage.java",0,0.553494124922696,0,2,2
"hbase-server/src/main/java/org/apache/hadoop/hbase/rest/protobuf/generated/VersionMessage.java",0,0.520496894409938,0,2,2
"hbase-server/src/main/java/org/apache/hadoop/hbase/rest/provider/JAXBContextResolver.java",0,0.97752808988764,1,1,2
"hbase-server/src/main/java/org/apache/hadoop/hbase/rest/provider/consumer/ProtobufMessageBodyConsumer.java",0,0.977272727272727,1,1,2
"hbase-server/src/main/java/org/apache/hadoop/hbase/rest/provider/producer/PlainTextMessageBodyProducer.java",0,0.972972972972973,1,1,2
"hbase-server/src/main/java/org/apache/hadoop/hbase/rest/provider/producer/ProtobufMessageBodyProducer.java",0,0.975308641975309,1,1,2
"hbase-server/src/main/java/org/apache/hadoop/hbase/security/HBasePolicyProvider.java",0,0.947368421052632,2,1,3
"hbase-server/src/main/java/org/apache/hadoop/hbase/security/HBaseSaslRpcServer.java",0,0.969849246231156,2,1,3
"hbase-server/src/main/java/org/apache/hadoop/hbase/security/access/AccessControlFilter.java",0,0.831460674157303,1,2,3
"hbase-server/src/main/java/org/apache/hadoop/hbase/security/access/AccessControlLists.java",0,0.685121107266436,3,3,6
"hbase-server/src/main/java/org/apache/hadoop/hbase/security/access/AccessController.java",0,0.509170946441673,7,6,13
"hbase-server/src/main/java/org/apache/hadoop/hbase/security/access/AuthResult.java",0,1,0,1,1
"hbase-server/src/main/java/org/apache/hadoop/hbase/security/access/CodeToClassAndBackFor96Migration.java",0,0.974025974025974,1,1,2
"hbase-server/src/main/java/org/apache/hadoop/hbase/security/access/HbaseObjectWritableFor96Migration.java",0,0.701970443349754,10,3,13
"hbase-server/src/main/java/org/apache/hadoop/hbase/security/access/SecureBulkLoadEndpoint.java",0,0.991549295774648,1,1,2
"hbase-server/src/main/java/org/apache/hadoop/hbase/security/access/TableAuthManager.java",0,0.913533834586466,5,1,6
"hbase-server/src/main/java/org/apache/hadoop/hbase/security/access/ZKPermissionWatcher.java",0,0.956521739130435,2,1,3
"hbase-server/src/main/java/org/apache/hadoop/hbase/security/token/AuthenticationKey.java",0,1,0,1,1
"hbase-server/src/main/java/org/apache/hadoop/hbase/security/token/AuthenticationTokenSecretManager.java",0,0.979041916167665,1,1,2
"hbase-server/src/main/java/org/apache/hadoop/hbase/security/token/TokenProvider.java",0,0.84,2,2,4
"hbase-server/src/main/java/org/apache/hadoop/hbase/security/token/TokenUtil.java",0,1,0,1,1
"hbase-server/src/main/java/org/apache/hadoop/hbase/security/token/ZKSecretWatcher.java",0,1,0,1,1
"hbase-server/src/main/java/org/apache/hadoop/hbase/snapshot/CopyRecoveredEditsTask.java",0,1,0,1,1
"hbase-server/src/main/java/org/apache/hadoop/hbase/snapshot/ExportSnapshot.java",0,0.985528219971056,3,1,4
"hbase-server/src/main/java/org/apache/hadoop/hbase/snapshot/ReferenceRegionHFilesTask.java",0,1,0,1,1
"hbase-server/src/main/java/org/apache/hadoop/hbase/snapshot/ReferenceServerWALsTask.java",0,1,0,1,1
"hbase-server/src/main/java/org/apache/hadoop/hbase/snapshot/RestoreSnapshotHelper.java",0,0.98471986417657,2,1,3
"hbase-server/src/main/java/org/apache/hadoop/hbase/snapshot/SnapshotDescriptionUtils.java",0,0.984709480122324,2,1,3
"hbase-server/src/main/java/org/apache/hadoop/hbase/snapshot/SnapshotInfo.java",0,1,0,1,1
"hbase-server/src/main/java/org/apache/hadoop/hbase/snapshot/SnapshotLogSplitter.java",0,1,0,1,1
"hbase-server/src/main/java/org/apache/hadoop/hbase/snapshot/SnapshotReferenceUtil.java",0,1,0,1,1
"hbase-server/src/main/java/org/apache/hadoop/hbase/snapshot/SnapshotTask.java",0,0.970149253731343,1,1,2
"hbase-server/src/main/java/org/apache/hadoop/hbase/snapshot/TableInfoCopyTask.java",0,0.986301369863014,1,1,2
"hbase-server/src/main/java/org/apache/hadoop/hbase/snapshot/TakeSnapshotUtils.java",0,0.993548387096774,2,1,3
"hbase-server/src/main/java/org/apache/hadoop/hbase/thrift/CallQueue.java",0,0.99236641221374,1,1,2
"hbase-server/src/main/java/org/apache/hadoop/hbase/thrift/HThreadedSelectorServerArgs.java",0,0.979591836734694,1,1,2
"hbase-server/src/main/java/org/apache/hadoop/hbase/thrift/HbaseHandlerMetricsProxy.java",0,0.963414634146341,2,1,3
"hbase-server/src/main/java/org/apache/hadoop/hbase/thrift/IncrementCoalescer.java",0,0.991891891891892,2,1,3
"hbase-server/src/main/java/org/apache/hadoop/hbase/thrift/IncrementCoalescerMBean.java",0,1,0,1,1
"hbase-server/src/main/java/org/apache/hadoop/hbase/thrift/TBoundedThreadPoolServer.java",0,0.986970684039088,1,1,2
"hbase-server/src/main/java/org/apache/hadoop/hbase/thrift/ThriftMetrics.java",0,0.622222222222222,1,3,4
"hbase-server/src/main/java/org/apache/hadoop/hbase/thrift/ThriftServer.java",0,0.542857142857143,0,3,3
"hbase-server/src/main/java/org/apache/hadoop/hbase/thrift/ThriftServerRunner.java",0,0.912328767123288,3,2,5
"hbase-server/src/main/java/org/apache/hadoop/hbase/thrift/ThriftUtilities.java",0,0.574712643678161,4,3,7
"hbase-server/src/main/java/org/apache/hadoop/hbase/thrift/generated/AlreadyExists.java",0,0.453846153846154,0,4,4
"hbase-server/src/main/java/org/apache/hadoop/hbase/thrift/generated/BatchMutation.java",0,0.386980108499096,0,4,4
"hbase-server/src/main/java/org/apache/hadoop/hbase/thrift/generated/ColumnDescriptor.java",0,0.377422072451559,0,4,4
"hbase-server/src/main/java/org/apache/hadoop/hbase/thrift/generated/Hbase.java",0,0.371358265867724,1,4,5
"hbase-server/src/main/java/org/apache/hadoop/hbase/thrift/generated/IOError.java",0,0.48849104859335,0,4,4
"hbase-server/src/main/java/org/apache/hadoop/hbase/thrift/generated/IllegalArgument.java",0,0.487179487179487,0,4,4
"hbase-server/src/main/java/org/apache/hadoop/hbase/thrift/generated/Mutation.java",0,0.357446808510638,0,4,4
"hbase-server/src/main/java/org/apache/hadoop/hbase/thrift/generated/TCell.java",0,0.446,0,4,4
"hbase-server/src/main/java/org/apache/hadoop/hbase/thrift/generated/TIncrement.java",0,0.984679665738162,1,1,2
"hbase-server/src/main/java/org/apache/hadoop/hbase/thrift/generated/TRegionInfo.java",0,0.298522167487685,0,5,5
"hbase-server/src/main/java/org/apache/hadoop/hbase/thrift/generated/TRowResult.java",0,0.351063829787234,0,4,4
"hbase-server/src/main/java/org/apache/hadoop/hbase/thrift/generated/TScan.java",0,0.716202270381837,0,2,2
"hbase-server/src/main/java/org/apache/hadoop/hbase/thrift2/ThriftHBaseServiceHandler.java",0,0.994169096209913,1,1,2
"hbase-server/src/main/java/org/apache/hadoop/hbase/thrift2/ThriftServer.java",0,0.852233676975945,1,2,3
"hbase-server/src/main/java/org/apache/hadoop/hbase/thrift2/ThriftUtilities.java",0,0.893292682926829,0,2,2
"hbase-server/src/main/java/org/apache/hadoop/hbase/thrift2/generated/TColumn.java",0,1,0,1,1
"hbase-server/src/main/java/org/apache/hadoop/hbase/thrift2/generated/TColumnIncrement.java",0,1,0,1,1
"hbase-server/src/main/java/org/apache/hadoop/hbase/thrift2/generated/TColumnValue.java",0,1,0,1,1
"hbase-server/src/main/java/org/apache/hadoop/hbase/thrift2/generated/TDelete.java",0,1,0,1,1
"hbase-server/src/main/java/org/apache/hadoop/hbase/thrift2/generated/TDeleteType.java",0,1,0,1,1
"hbase-server/src/main/java/org/apache/hadoop/hbase/thrift2/generated/TGet.java",0,1,0,1,1
"hbase-server/src/main/java/org/apache/hadoop/hbase/thrift2/generated/THBaseService.java",0,1,0,1,1
"hbase-server/src/main/java/org/apache/hadoop/hbase/thrift2/generated/TIOError.java",0,1,0,1,1
"hbase-server/src/main/java/org/apache/hadoop/hbase/thrift2/generated/TIllegalArgument.java",0,1,0,1,1
"hbase-server/src/main/java/org/apache/hadoop/hbase/thrift2/generated/TIncrement.java",0,1,0,1,1
"hbase-server/src/main/java/org/apache/hadoop/hbase/thrift2/generated/TPut.java",0,1,0,1,1
"hbase-server/src/main/java/org/apache/hadoop/hbase/thrift2/generated/TResult.java",0,1,0,1,1
"hbase-server/src/main/java/org/apache/hadoop/hbase/thrift2/generated/TScan.java",0,1,0,1,1
"hbase-server/src/main/java/org/apache/hadoop/hbase/thrift2/generated/TTimeRange.java",0,1,0,1,1
"hbase-server/src/main/java/org/apache/hadoop/hbase/tool/Canary.java",0,0.992094861660079,2,1,3
"hbase-server/src/main/java/org/apache/hadoop/hbase/trace/HBaseLocalFileSpanReceiver.java",0,1,0,1,1
"hbase-server/src/main/java/org/apache/hadoop/hbase/trace/SpanReceiverHost.java",0,1,0,1,1
"hbase-server/src/main/java/org/apache/hadoop/hbase/util/AbstractHBaseTool.java",0,0.967391304347826,1,1,2
"hbase-server/src/main/java/org/apache/hadoop/hbase/util/Base64.java",0,0.903402187120292,1,2,3
"hbase-server/src/main/java/org/apache/hadoop/hbase/util/BloomFilter.java",0,0.634920634920635,0,3,3
"hbase-server/src/main/java/org/apache/hadoop/hbase/util/BloomFilterBase.java",0,0.964912280701754,1,1,2
"hbase-server/src/main/java/org/apache/hadoop/hbase/util/BloomFilterFactory.java",0,0.681647940074906,3,2,5
"hbase-server/src/main/java/org/apache/hadoop/hbase/util/BloomFilterWriter.java",0,0.967741935483871,1,1,2
"hbase-server/src/main/java/org/apache/hadoop/hbase/util/ByteBloomFilter.java",0,0.546969696969697,2,2,4
"hbase-server/src/main/java/org/apache/hadoop/hbase/util/CancelableProgressable.java",0,0.897435897435897,0,2,2
"hbase-server/src/main/java/org/apache/hadoop/hbase/util/ChecksumFactory.java",0,0.989690721649485,1,1,2
"hbase-server/src/main/java/org/apache/hadoop/hbase/util/ChecksumType.java",0,0.977777777777778,2,1,3
"hbase-server/src/main/java/org/apache/hadoop/hbase/util/CollectionBackedScanner.java",0,0.984615384615385,1,1,2
"hbase-server/src/main/java/org/apache/hadoop/hbase/util/CompoundBloomFilter.java",0,0.966292134831461,2,1,3
"hbase-server/src/main/java/org/apache/hadoop/hbase/util/CompoundBloomFilterBase.java",0,0.96875,1,1,2
"hbase-server/src/main/java/org/apache/hadoop/hbase/util/CompoundBloomFilterWriter.java",0,0.981949458483754,2,1,3
"hbase-server/src/main/java/org/apache/hadoop/hbase/util/CompressionTest.java",0,0.383561643835616,4,3,7
"hbase-server/src/main/java/org/apache/hadoop/hbase/util/DirectMemoryUtils.java",0,1,0,1,1
"hbase-server/src/main/java/org/apache/hadoop/hbase/util/FSHDFSUtils.java",0,0.776978417266187,2,2,4
"hbase-server/src/main/java/org/apache/hadoop/hbase/util/FSMapRUtils.java",0,1,0,1,1
"hbase-server/src/main/java/org/apache/hadoop/hbase/util/FSTableDescriptors.java",0,0.818040435458787,5,2,7
"hbase-server/src/main/java/org/apache/hadoop/hbase/util/FSUtils.java",0,0.459809264305177,9,6,15
"hbase-server/src/main/java/org/apache/hadoop/hbase/util/FSVisitor.java",0,0.994845360824742,1,1,2
"hbase-server/src/main/java/org/apache/hadoop/hbase/util/GetJavaProperty.java",0,1,0,1,1
"hbase-server/src/main/java/org/apache/hadoop/hbase/util/HBaseConfTool.java",0,0.69047619047619,0,2,2
"hbase-server/src/main/java/org/apache/hadoop/hbase/util/HBaseFsck.java",0,0.513700452247938,9,4,13
"hbase-server/src/main/java/org/apache/hadoop/hbase/util/HBaseFsckRepair.java",0,0.535714285714286,5,3,8
"hbase-server/src/main/java/org/apache/hadoop/hbase/util/HFileArchiveUtil.java",0,0.506024096385542,2,3,5
"hbase-server/src/main/java/org/apache/hadoop/hbase/util/HMerge.java",0,0.464285714285714,6,2,8
"hbase-server/src/main/java/org/apache/hadoop/hbase/util/HashedBytes.java",0,1,0,1,1
"hbase-server/src/main/java/org/apache/hadoop/hbase/util/IdLock.java",0,0.975409836065574,1,1,2
"hbase-server/src/main/java/org/apache/hadoop/hbase/util/InfoServer.java",0,0.864661654135338,7,1,8
"hbase-server/src/main/java/org/apache/hadoop/hbase/util/JVMClusterUtil.java",0,0.60377358490566,2,4,6
"hbase-server/src/main/java/org/apache/hadoop/hbase/util/JvmVersion.java",0,1,0,1,1
"hbase-server/src/main/java/org/apache/hadoop/hbase/util/KeyLocker.java",0,0.819548872180451,0,2,2
"hbase-server/src/main/java/org/apache/hadoop/hbase/util/KeyRange.java",0,0.903225806451613,0,2,2
"hbase-server/src/main/java/org/apache/hadoop/hbase/util/Keying.java",0,0.975,2,1,3
"hbase-server/src/main/java/org/apache/hadoop/hbase/util/ManualEnvironmentEdge.java",0,0.844444444444444,0,3,3
"hbase-server/src/main/java/org/apache/hadoop/hbase/util/Merge.java",0,0.570446735395189,3,2,5
"hbase-server/src/main/java/org/apache/hadoop/hbase/util/MetaUtils.java",0,0.44578313253012,1,3,4
"hbase-server/src/main/java/org/apache/hadoop/hbase/util/ModifyRegionUtils.java",0,0.994350282485876,1,1,2
"hbase-server/src/main/java/org/apache/hadoop/hbase/util/ProtoUtil.java",0,1,0,1,1
"hbase-server/src/main/java/org/apache/hadoop/hbase/util/RegionSplitCalculator.java",0,0.675105485232067,1,2,3
"hbase-server/src/main/java/org/apache/hadoop/hbase/util/RegionSplitter.java",0,0.93011811023622,6,1,7
"hbase-server/src/main/java/org/apache/hadoop/hbase/util/ServerCommandLine.java",0,0.873563218390805,1,2,3
"hbase-server/src/main/java/org/apache/hadoop/hbase/util/ShutdownHookManager.java",0,1,0,1,1
"hbase-server/src/main/java/org/apache/hadoop/hbase/util/SortedCopyOnWriteSet.java",0,0.966480446927374,1,1,2
"hbase-server/src/main/java/org/apache/hadoop/hbase/util/hbck/HFileCorruptionChecker.java",0,0.956989247311828,3,1,4
"hbase-server/src/main/java/org/apache/hadoop/hbase/util/hbck/OfflineMetaRepair.java",0,0.844961240310077,2,2,4
"hbase-server/src/main/java/org/apache/hadoop/hbase/util/hbck/TableIntegrityErrorHandler.java",0,0.910891089108911,0,2,2
"hbase-server/src/main/java/org/apache/hadoop/hbase/util/hbck/TableIntegrityErrorHandlerImpl.java",0,0.932038834951456,0,2,2
"hbase-server/src/main/java/org/apache/hadoop/hbase/zookeeper/ClusterStatusTracker.java",0,0.99,1,1,2
"hbase-server/src/main/java/org/apache/hadoop/hbase/zookeeper/DeletionListener.java",0,1,0,1,1
"hbase-server/src/main/java/org/apache/hadoop/hbase/zookeeper/DrainingServerTracker.java",0,0.991735537190083,1,1,2
"hbase-server/src/main/java/org/apache/hadoop/hbase/zookeeper/LoadBalancerTracker.java",0,0.98936170212766,1,1,2
"hbase-server/src/main/java/org/apache/hadoop/hbase/zookeeper/MiniZooKeeperCluster.java",0,0.721938775510204,4,3,7
"hbase-server/src/main/java/org/apache/hadoop/hbase/zookeeper/RegionServerTracker.java",0,0.938931297709924,0,2,2
"hbase-server/src/main/java/org/apache/hadoop/hbase/zookeeper/ZKServerTool.java",0,0.350877192982456,1,3,4
"hbase-server/src/main/java/org/apache/hadoop/hbase/zookeeper/ZKSplitLog.java",0,0.944,0,2,2
"hbase-server/src/main/java/org/apache/hadoop/hbase/zookeeper/ZooKeeperMainServerArg.java",0,0.805194805194805,0,2,2
"hbase-server/src/main/java/org/apache/hadoop/hbase/zookeeper/lock/ZKInterProcessLockBase.java",0,1,0,1,1
"hbase-server/src/main/java/org/apache/hadoop/hbase/zookeeper/lock/ZKInterProcessReadLock.java",0,1,0,1,1
"hbase-server/src/main/java/org/apache/hadoop/hbase/zookeeper/lock/ZKInterProcessReadWriteLock.java",0,1,0,1,1
"hbase-server/src/main/java/org/apache/hadoop/hbase/zookeeper/lock/ZKInterProcessWriteLock.java",0,1,0,1,1
"hbase-server/src/test/java/org/apache/hadoop/hbase/HBaseCluster.java",0,0.962199312714777,1,1,2
"hbase-server/src/test/java/org/apache/hadoop/hbase/HBaseTestCase.java",0,0.464233576642336,6,4,10
"hbase-server/src/test/java/org/apache/hadoop/hbase/HBaseTestingUtility.java",0,0.454786227771472,14,5,19
"hbase-server/src/test/java/org/apache/hadoop/hbase/HFilePerformanceEvaluation.java",0,0.970189701897019,4,1,5
"hbase-server/src/test/java/org/apache/hadoop/hbase/HServerLoad092.java",0,1,0,1,1
"hbase-server/src/test/java/org/apache/hadoop/hbase/HTestConst.java",0,1,0,1,1
"hbase-server/src/test/java/org/apache/hadoop/hbase/MapFilePerformanceEvaluation.java",0,0.991379310344828,2,1,3
"hbase-server/src/test/java/org/apache/hadoop/hbase/MiniHBaseCluster.java",0,0.535966149506347,10,3,13
"hbase-server/src/test/java/org/apache/hadoop/hbase/MultithreadedTestUtil.java",0,0.74468085106383,1,2,3
"hbase-server/src/test/java/org/apache/hadoop/hbase/PerformanceEvaluation.java",0,0.651108518086348,6,3,9
"hbase-server/src/test/java/org/apache/hadoop/hbase/PerformanceEvaluationCommons.java",0,1,0,1,1
"hbase-server/src/test/java/org/apache/hadoop/hbase/ServerResourceCheckerJUnitListener.java",0,0.619047619047619,0,2,2
"hbase-server/src/test/java/org/apache/hadoop/hbase/TestAcidGuarantees.java",0,0.802030456852792,7,2,9
"hbase-server/src/test/java/org/apache/hadoop/hbase/TestCheckTestClasses.java",0,1,0,1,1
"hbase-server/src/test/java/org/apache/hadoop/hbase/TestClusterBootOrder.java",0,1,0,1,1
"hbase-server/src/test/java/org/apache/hadoop/hbase/TestCompare.java",0,0.322033898305085,1,4,5
"hbase-server/src/test/java/org/apache/hadoop/hbase/TestDrainingServer.java",0,0.498316498316498,0,3,3
"hbase-server/src/test/java/org/apache/hadoop/hbase/TestFSTableDescriptorForceCreation.java",0,0.96,1,1,2
"hbase-server/src/test/java/org/apache/hadoop/hbase/TestFullLogReconstruction.java",0,0.796875,2,2,4
"hbase-server/src/test/java/org/apache/hadoop/hbase/TestGlobalMemStoreSize.java",0,0.960893854748603,2,1,3
"hbase-server/src/test/java/org/apache/hadoop/hbase/TestHBaseTestingUtility.java",0,0.960176991150443,1,1,2
"hbase-server/src/test/java/org/apache/hadoop/hbase/TestHColumnDescriptor.java",0,0.77319587628866,3,2,5
"hbase-server/src/test/java/org/apache/hadoop/hbase/TestHDFSBlocksDistribution.java",0,1,0,1,1
"hbase-server/src/test/java/org/apache/hadoop/hbase/TestHRegionLocation.java",0,0.825,3,2,5
"hbase-server/src/test/java/org/apache/hadoop/hbase/TestHTableDescriptor.java",0,0.318407960199005,2,5,7
"hbase-server/src/test/java/org/apache/hadoop/hbase/TestIPv6NIOServerSocketChannel.java",0,1,0,1,1
"hbase-server/src/test/java/org/apache/hadoop/hbase/TestInfoServers.java",0,0.458333333333333,4,3,7
"hbase-server/src/test/java/org/apache/hadoop/hbase/TestLocalHBaseCluster.java",0,1,0,1,1
"hbase-server/src/test/java/org/apache/hadoop/hbase/TestMultiVersions.java",0,0.955089820359281,3,1,4
"hbase-server/src/test/java/org/apache/hadoop/hbase/TestNodeHealthCheckChore.java",0,0.7375,1,2,3
"hbase-server/src/test/java/org/apache/hadoop/hbase/TestRegionRebalancing.java",0,0.504032258064516,4,2,6
"hbase-server/src/test/java/org/apache/hadoop/hbase/TestSerialization.java",0,0.458110516934046,5,3,8
"hbase-server/src/test/java/org/apache/hadoop/hbase/TestServerLoad.java",0,0.963855421686747,1,1,2
"hbase-server/src/test/java/org/apache/hadoop/hbase/TestServerName.java",0,0.965116279069767,1,1,2
"hbase-server/src/test/java/org/apache/hadoop/hbase/TestZooKeeper.java",0,0.367729831144465,5,4,9
"hbase-server/src/test/java/org/apache/hadoop/hbase/TimestampTestBase.java",0,0.58695652173913,0,4,4
"hbase-server/src/test/java/org/apache/hadoop/hbase/backup/TestHFileArchiving.java",0,0.641379310344828,3,3,6
"hbase-server/src/test/java/org/apache/hadoop/hbase/backup/example/TestZooKeeperTableArchiveClient.java",0,0.715311004784689,0,2,2
"hbase-server/src/test/java/org/apache/hadoop/hbase/catalog/MetaMockingUtil.java",0,1,0,1,1
"hbase-server/src/test/java/org/apache/hadoop/hbase/catalog/TestCatalogTracker.java",0,0.875609756097561,6,2,8
"hbase-server/src/test/java/org/apache/hadoop/hbase/catalog/TestMetaMigrationConvertingToPB.java",0,0.953995157384988,2,1,3
"hbase-server/src/test/java/org/apache/hadoop/hbase/catalog/TestMetaReaderEditor.java",0,0.791946308724832,0,3,3
"hbase-server/src/test/java/org/apache/hadoop/hbase/catalog/TestMetaReaderEditorNoCluster.java",0,0.957943925233645,5,1,6
"hbase-server/src/test/java/org/apache/hadoop/hbase/client/HConnectionTestingUtility.java",0,0.903225806451613,3,2,5
"hbase-server/src/test/java/org/apache/hadoop/hbase/client/TestAdmin.java",0,0.561764705882353,11,4,15
"hbase-server/src/test/java/org/apache/hadoop/hbase/client/TestClientScannerRPCTimeout.java",0,1,0,1,1
"hbase-server/src/test/java/org/apache/hadoop/hbase/client/TestClientTimeouts.java",0,0.718446601941748,1,2,3
"hbase-server/src/test/java/org/apache/hadoop/hbase/client/TestCloneSnapshotFromClient.java",0,1,0,1,1
"hbase-server/src/test/java/org/apache/hadoop/hbase/client/TestConnectionUtils.java",0,1,0,1,1
"hbase-server/src/test/java/org/apache/hadoop/hbase/client/TestFromClientSide.java",0,0.432874526231797,9,4,13
"hbase-server/src/test/java/org/apache/hadoop/hbase/client/TestFromClientSide3.java",0,0.57002457002457,1,3,4
"hbase-server/src/test/java/org/apache/hadoop/hbase/client/TestFromClientSideWithCoprocessor.java",0,0.976190476190476,1,1,2
"hbase-server/src/test/java/org/apache/hadoop/hbase/client/TestHCM.java",0,0.266757865937073,4,6,10
"hbase-server/src/test/java/org/apache/hadoop/hbase/client/TestHTableMultiplexer.java",0,0.882352941176471,1,2,3
"hbase-server/src/test/java/org/apache/hadoop/hbase/client/TestHTablePool.java",0,0.905325443786982,1,2,3
"hbase-server/src/test/java/org/apache/hadoop/hbase/client/TestHTableUtil.java",0,0.976923076923077,1,1,2
"hbase-server/src/test/java/org/apache/hadoop/hbase/client/TestIntraRowPagination.java",0,1,0,1,1
"hbase-server/src/test/java/org/apache/hadoop/hbase/client/TestMetaScanner.java",0,0.938775510204082,2,1,3
"hbase-server/src/test/java/org/apache/hadoop/hbase/client/TestMultiParallel.java",0,0.680532445923461,4,4,8
"hbase-server/src/test/java/org/apache/hadoop/hbase/client/TestMultipleTimestamps.java",0,0.525046382189239,1,3,4
"hbase-server/src/test/java/org/apache/hadoop/hbase/client/TestPutDeleteEtcCellIteration.java",0,1,0,1,1
"hbase-server/src/test/java/org/apache/hadoop/hbase/client/TestRestoreSnapshotFromClient.java",0,0.973244147157191,1,1,2
"hbase-server/src/test/java/org/apache/hadoop/hbase/client/TestResult.java",0,0.590747330960854,1,3,4
"hbase-server/src/test/java/org/apache/hadoop/hbase/client/TestScannerTimeout.java",0,0.64,2,4,6
"hbase-server/src/test/java/org/apache/hadoop/hbase/client/TestScannersFromClientSide.java",0,1,0,1,1
"hbase-server/src/test/java/org/apache/hadoop/hbase/client/TestShell.java",0,0.958904109589041,1,1,2
"hbase-server/src/test/java/org/apache/hadoop/hbase/client/TestSnapshotCloneIndependence.java",0,0.997354497354497,1,1,2
"hbase-server/src/test/java/org/apache/hadoop/hbase/client/TestSnapshotFromClient.java",0,0.986899563318777,2,1,3
"hbase-server/src/test/java/org/apache/hadoop/hbase/client/TestSnapshotMetadata.java",0,1,0,1,1
"hbase-server/src/test/java/org/apache/hadoop/hbase/client/TestTimestampsFilter.java",0,0.839378238341969,2,2,4
"hbase-server/src/test/java/org/apache/hadoop/hbase/client/replication/TestReplicationAdmin.java",0,0.689075630252101,0,3,3
"hbase-server/src/test/java/org/apache/hadoop/hbase/codec/CodecPerformance.java",0,1,0,1,1
"hbase-server/src/test/java/org/apache/hadoop/hbase/codec/TestCellMessageCodec.java",0,1,0,1,1
"hbase-server/src/test/java/org/apache/hadoop/hbase/constraint/AllFailConstraint.java",0,0.96875,1,1,2
"hbase-server/src/test/java/org/apache/hadoop/hbase/constraint/AllPassConstraint.java",0,1,0,1,1
"hbase-server/src/test/java/org/apache/hadoop/hbase/constraint/CheckConfigurationConstraint.java",0,0.866666666666667,0,2,2
"hbase-server/src/test/java/org/apache/hadoop/hbase/constraint/RuntimeFailConstraint.java",0,0.5,1,2,3
"hbase-server/src/test/java/org/apache/hadoop/hbase/constraint/TestConstraint.java",0,0.988593155893536,2,1,3
"hbase-server/src/test/java/org/apache/hadoop/hbase/constraint/TestConstraints.java",0,0.985436893203884,1,1,2
"hbase-server/src/test/java/org/apache/hadoop/hbase/constraint/WorksConstraint.java",0,1,0,1,1
"hbase-server/src/test/java/org/apache/hadoop/hbase/coprocessor/ColumnAggregationEndpoint.java",0,0.53448275862069,1,3,4
"hbase-server/src/test/java/org/apache/hadoop/hbase/coprocessor/ProtobufCoprocessorService.java",0,1,0,1,1
"hbase-server/src/test/java/org/apache/hadoop/hbase/coprocessor/SampleRegionWALObserver.java",0,0.925,2,1,3
"hbase-server/src/test/java/org/apache/hadoop/hbase/coprocessor/SimpleRegionObserver.java",0,0.506172839506173,2,5,7
"hbase-server/src/test/java/org/apache/hadoop/hbase/coprocessor/TestAggregateProtocol.java",0,0.868390129259694,0,2,2
"hbase-server/src/test/java/org/apache/hadoop/hbase/coprocessor/TestBigDecimalColumnInterpreter.java",0,1,0,1,1
"hbase-server/src/test/java/org/apache/hadoop/hbase/coprocessor/TestClassLoading.java",0,0.359133126934985,3,4,7
"hbase-server/src/test/java/org/apache/hadoop/hbase/coprocessor/TestCoprocessorEndpoint.java",0,0.37910447761194,0,4,4
"hbase-server/src/test/java/org/apache/hadoop/hbase/coprocessor/TestCoprocessorInterface.java",0,0.405825242718447,5,5,10
"hbase-server/src/test/java/org/apache/hadoop/hbase/coprocessor/TestMasterCoprocessorExceptionWithAbort.java",0,0.927038626609442,1,2,3
"hbase-server/src/test/java/org/apache/hadoop/hbase/coprocessor/TestMasterCoprocessorExceptionWithRemove.java",0,0.91703056768559,2,2,4
"hbase-server/src/test/java/org/apache/hadoop/hbase/coprocessor/TestMasterObserver.java",0,0.509166666666667,5,4,9
"hbase-server/src/test/java/org/apache/hadoop/hbase/coprocessor/TestRegionObserverBypass.java",0,0.824074074074074,3,2,5
"hbase-server/src/test/java/org/apache/hadoop/hbase/coprocessor/TestRegionObserverInterface.java",0,0.499079189686924,4,4,8
"hbase-server/src/test/java/org/apache/hadoop/hbase/coprocessor/TestRegionObserverStacking.java",0,0.746478873239437,3,2,5
"hbase-server/src/test/java/org/apache/hadoop/hbase/coprocessor/TestRegionServerCoprocessorExceptionWithAbort.java",0,0.954954954954955,3,1,4
"hbase-server/src/test/java/org/apache/hadoop/hbase/coprocessor/TestRegionServerCoprocessorExceptionWithRemove.java",0,0.95,4,1,5
"hbase-server/src/test/java/org/apache/hadoop/hbase/coprocessor/TestRowProcessorEndpoint.java",0,0.806451612903226,1,2,3
"hbase-server/src/test/java/org/apache/hadoop/hbase/coprocessor/TestWALObserver.java",0,0.706601466992665,2,2,4
"hbase-server/src/test/java/org/apache/hadoop/hbase/coprocessor/protobuf/generated/ColumnAggregationProtos.java",0,1,0,1,1
"hbase-server/src/test/java/org/apache/hadoop/hbase/coprocessor/protobuf/generated/IncrementCounterProcessorTestProtos.java",0,1,0,1,1
"hbase-server/src/test/java/org/apache/hadoop/hbase/coprocessor/protobuf/generated/PingProtos.java",0,1,0,1,1
"hbase-server/src/test/java/org/apache/hadoop/hbase/errorhandling/TestForeignExceptionDispatcher.java",0,1,0,1,1
"hbase-server/src/test/java/org/apache/hadoop/hbase/errorhandling/TestForeignExceptionSerialization.java",0,1,0,1,1
"hbase-server/src/test/java/org/apache/hadoop/hbase/errorhandling/TestTimeoutExceptionInjector.java",0,1,0,1,1
"hbase-server/src/test/java/org/apache/hadoop/hbase/executor/TestExecutorService.java",0,0.744318181818182,3,3,6
"hbase-server/src/test/java/org/apache/hadoop/hbase/filter/TestBitComparator.java",0,0.7,1,2,3
"hbase-server/src/test/java/org/apache/hadoop/hbase/filter/TestColumnPaginationFilter.java",0,0.957894736842105,1,1,2
"hbase-server/src/test/java/org/apache/hadoop/hbase/filter/TestColumnPrefixFilter.java",0,0.61139896373057,1,3,4
"hbase-server/src/test/java/org/apache/hadoop/hbase/filter/TestColumnRangeFilter.java",0,0.980694980694981,1,1,2
"hbase-server/src/test/java/org/apache/hadoop/hbase/filter/TestComparatorSerialization.java",0,1,0,1,1
"hbase-server/src/test/java/org/apache/hadoop/hbase/filter/TestDependentColumnFilter.java",0,0.902834008097166,1,2,3
"hbase-server/src/test/java/org/apache/hadoop/hbase/filter/TestFilter.java",0,0.564239194789816,4,3,7
"hbase-server/src/test/java/org/apache/hadoop/hbase/filter/TestFilterList.java",0,0.793427230046948,1,2,3
"hbase-server/src/test/java/org/apache/hadoop/hbase/filter/TestFilterSerialization.java",0,0.993788819875776,1,1,2
"hbase-server/src/test/java/org/apache/hadoop/hbase/filter/TestFilterWithScanLimits.java",0,0.932642487046632,3,1,4
"hbase-server/src/test/java/org/apache/hadoop/hbase/filter/TestFilterWrapper.java",0,0.979591836734694,2,1,3
"hbase-server/src/test/java/org/apache/hadoop/hbase/filter/TestFirstKeyValueMatchingQualifiersFilter.java",0,1,0,1,1
"hbase-server/src/test/java/org/apache/hadoop/hbase/filter/TestFuzzyRowFilter.java",0,1,0,1,1
"hbase-server/src/test/java/org/apache/hadoop/hbase/filter/TestInclusiveStopFilter.java",0,0.945652173913043,2,1,3
"hbase-server/src/test/java/org/apache/hadoop/hbase/filter/TestMultipleColumnPrefixFilter.java",0,0.98804780876494,1,1,2
"hbase-server/src/test/java/org/apache/hadoop/hbase/filter/TestPageFilter.java",0,0.758241758241758,1,3,4
"hbase-server/src/test/java/org/apache/hadoop/hbase/filter/TestParseFilter.java",0,0.995508982035928,1,1,2
"hbase-server/src/test/java/org/apache/hadoop/hbase/filter/TestPrefixFilter.java",0,0.946808510638298,0,2,2
"hbase-server/src/test/java/org/apache/hadoop/hbase/filter/TestRandomRowFilter.java",0,0.815217391304348,1,2,3
"hbase-server/src/test/java/org/apache/hadoop/hbase/filter/TestSingleColumnValueExcludeFilter.java",0,0.793103448275862,0,2,2
"hbase-server/src/test/java/org/apache/hadoop/hbase/filter/TestSingleColumnValueFilter.java",0,0.690721649484536,0,3,3
"hbase-server/src/test/java/org/apache/hadoop/hbase/fs/TestBlockReorder.java",0,0.985507246376812,2,1,3
"hbase-server/src/test/java/org/apache/hadoop/hbase/io/TestFileLink.java",0,1,0,1,1
"hbase-server/src/test/java/org/apache/hadoop/hbase/io/TestHalfStoreFileReader.java",0,0.470588235294118,1,4,5
"hbase-server/src/test/java/org/apache/hadoop/hbase/io/TestHeapSize.java",0,0.670951156812339,2,3,5
"hbase-server/src/test/java/org/apache/hadoop/hbase/io/TestImmutableBytesWritable.java",0,0.757352941176471,1,2,3
"hbase-server/src/test/java/org/apache/hadoop/hbase/io/TestReference.java",0,1,0,1,1
"hbase-server/src/test/java/org/apache/hadoop/hbase/io/encoding/TestBufferedDataBlockEncoder.java",0,0.953488372093023,1,1,2
"hbase-server/src/test/java/org/apache/hadoop/hbase/io/encoding/TestChangingEncoding.java",0,0.948339483394834,2,1,3
"hbase-server/src/test/java/org/apache/hadoop/hbase/io/encoding/TestDataBlockEncoders.java",0,0.984042553191489,3,1,4
"hbase-server/src/test/java/org/apache/hadoop/hbase/io/encoding/TestEncodedSeekers.java",0,0.649122807017544,1,3,4
"hbase-server/src/test/java/org/apache/hadoop/hbase/io/encoding/TestLoadAndSwitchEncodeOnDisk.java",0,0.752136752136752,1,2,3
"hbase-server/src/test/java/org/apache/hadoop/hbase/io/hfile/CacheTestUtils.java",0,0.523160762942779,3,3,6
"hbase-server/src/test/java/org/apache/hadoop/hbase/io/hfile/KVGenerator.java",0,1,0,1,1
"hbase-server/src/test/java/org/apache/hadoop/hbase/io/hfile/KeySampler.java",0,1,0,1,1
"hbase-server/src/test/java/org/apache/hadoop/hbase/io/hfile/NanoTimer.java",0,1,0,1,1
"hbase-server/src/test/java/org/apache/hadoop/hbase/io/hfile/RandomDistribution.java",0,1,0,1,1
"hbase-server/src/test/java/org/apache/hadoop/hbase/io/hfile/RandomSeek.java",0,0.9453125,3,1,4
"hbase-server/src/test/java/org/apache/hadoop/hbase/io/hfile/TestBlockCacheColumnFamilySummary.java",0,0.983870967741935,1,1,2
"hbase-server/src/test/java/org/apache/hadoop/hbase/io/hfile/TestCacheOnWrite.java",0,0.493333333333333,6,2,8
"hbase-server/src/test/java/org/apache/hadoop/hbase/io/hfile/TestCachedBlockQueue.java",0,0.824324324324324,4,2,6
"hbase-server/src/test/java/org/apache/hadoop/hbase/io/hfile/TestChecksum.java",0,0.967272727272727,3,1,4
"hbase-server/src/test/java/org/apache/hadoop/hbase/io/hfile/TestFixedFileTrailer.java",0,0.952173913043478,4,1,5
"hbase-server/src/test/java/org/apache/hadoop/hbase/io/hfile/TestForceCacheImportantBlocks.java",0,0.944827586206897,3,1,4
"hbase-server/src/test/java/org/apache/hadoop/hbase/io/hfile/TestHFile.java",0,0.637075718015666,6,3,9
"hbase-server/src/test/java/org/apache/hadoop/hbase/io/hfile/TestHFileBlock.java",0,0.520671834625323,5,2,7
"hbase-server/src/test/java/org/apache/hadoop/hbase/io/hfile/TestHFileBlockCompatibility.java",0,0.983448275862069,4,1,5
"hbase-server/src/test/java/org/apache/hadoop/hbase/io/hfile/TestHFileBlockIndex.java",0,0.948051948051948,5,1,6
"hbase-server/src/test/java/org/apache/hadoop/hbase/io/hfile/TestHFileDataBlockEncoder.java",0,0.935828877005348,5,1,6
"hbase-server/src/test/java/org/apache/hadoop/hbase/io/hfile/TestHFileInlineToRootChunkConversion.java",0,1,0,1,1
"hbase-server/src/test/java/org/apache/hadoop/hbase/io/hfile/TestHFilePerformance.java",0,0.961928934010152,3,1,4
"hbase-server/src/test/java/org/apache/hadoop/hbase/io/hfile/TestHFileSeek.java",0,0.900917431192661,4,2,6
"hbase-server/src/test/java/org/apache/hadoop/hbase/io/hfile/TestHFileWriterV2.java",0,0.692073170731707,1,5,6
"hbase-server/src/test/java/org/apache/hadoop/hbase/io/hfile/TestLruBlockCache.java",0,0.647407407407407,4,4,8
"hbase-server/src/test/java/org/apache/hadoop/hbase/io/hfile/TestReseekTo.java",0,0.797979797979798,3,2,5
"hbase-server/src/test/java/org/apache/hadoop/hbase/io/hfile/TestScannerSelectionUsingTTL.java",0,0.736196319018405,3,2,5
"hbase-server/src/test/java/org/apache/hadoop/hbase/io/hfile/TestSeekTo.java",0,0.493723849372385,2,3,5
"hbase-server/src/test/java/org/apache/hadoop/hbase/io/hfile/bucket/TestBucketCache.java",0,1,0,1,1
"hbase-server/src/test/java/org/apache/hadoop/hbase/io/hfile/bucket/TestByteBufferIOEngine.java",0,1,0,1,1
"hbase-server/src/test/java/org/apache/hadoop/hbase/io/hfile/bucket/TestFileIOEngine.java",0,1,0,1,1
"hbase-server/src/test/java/org/apache/hadoop/hbase/io/hfile/slab/TestSingleSizeCache.java",0,0.855421686746988,0,2,2
"hbase-server/src/test/java/org/apache/hadoop/hbase/io/hfile/slab/TestSlab.java",0,0.935064935064935,0,2,2
"hbase-server/src/test/java/org/apache/hadoop/hbase/io/hfile/slab/TestSlabCache.java",0,0.783783783783784,0,2,2
"hbase-server/src/test/java/org/apache/hadoop/hbase/ipc/MetricsHBaseServerWrapperStub.java",0,1,0,1,1
"hbase-server/src/test/java/org/apache/hadoop/hbase/ipc/RandomTimeoutRpcEngine.java",0,0.8125,2,2,4
"hbase-server/src/test/java/org/apache/hadoop/hbase/ipc/TestDelayedRpc.java",0,0.560747663551402,2,3,5
"hbase-server/src/test/java/org/apache/hadoop/hbase/ipc/TestHBaseClient.java",0,1,0,1,1
"hbase-server/src/test/java/org/apache/hadoop/hbase/ipc/TestIPC.java",0,0.683962264150943,1,2,3
"hbase-server/src/test/java/org/apache/hadoop/hbase/ipc/TestProtoBufRpc.java",0,0.847328244274809,1,2,3
"hbase-server/src/test/java/org/apache/hadoop/hbase/ipc/TestRpcMetrics.java",0,1,0,1,1
"hbase-server/src/test/java/org/apache/hadoop/hbase/ipc/protobuf/generated/TestDelayedRpcProtos.java",0,1,0,1,1
"hbase-server/src/test/java/org/apache/hadoop/hbase/ipc/protobuf/generated/TestProtos.java",0,1,0,1,1
"hbase-server/src/test/java/org/apache/hadoop/hbase/ipc/protobuf/generated/TestRpcServiceProtos.java",0,1,0,1,1
"hbase-server/src/test/java/org/apache/hadoop/hbase/mapred/TestTableInputFormat.java",0,0.815384615384615,2,2,4
"hbase-server/src/test/java/org/apache/hadoop/hbase/mapred/TestTableMapReduce.java",0,0.802281368821293,0,3,3
"hbase-server/src/test/java/org/apache/hadoop/hbase/mapreduce/MapreduceTestingShim.java",0,1,0,1,1
"hbase-server/src/test/java/org/apache/hadoop/hbase/mapreduce/NMapInputFormat.java",0,0.888888888888889,0,2,2
"hbase-server/src/test/java/org/apache/hadoop/hbase/mapreduce/TestHFileOutputFormat.java",0,0.437284234752589,5,5,10
"hbase-server/src/test/java/org/apache/hadoop/hbase/mapreduce/TestHLogRecordReader.java",0,0.928870292887029,2,1,3
"hbase-server/src/test/java/org/apache/hadoop/hbase/mapreduce/TestImportExport.java",0,0.427230046948357,1,5,6
"hbase-server/src/test/java/org/apache/hadoop/hbase/mapreduce/TestImportTsv.java",0,0.684210526315789,3,3,6
"hbase-server/src/test/java/org/apache/hadoop/hbase/mapreduce/TestImportTsvParser.java",0,1,0,1,1
"hbase-server/src/test/java/org/apache/hadoop/hbase/mapreduce/TestLoadIncrementalHFiles.java",0,0.368956743002545,5,4,9
"hbase-server/src/test/java/org/apache/hadoop/hbase/mapreduce/TestLoadIncrementalHFilesSplitRecovery.java",0,0.878411910669975,4,2,6
"hbase-server/src/test/java/org/apache/hadoop/hbase/mapreduce/TestMultiTableInputFormat.java",0,1,0,1,1
"hbase-server/src/test/java/org/apache/hadoop/hbase/mapreduce/TestMultithreadedTableMapper.java",0,0.941634241245136,0,2,2
"hbase-server/src/test/java/org/apache/hadoop/hbase/mapreduce/TestRowCounter.java",0,1,0,1,1
"hbase-server/src/test/java/org/apache/hadoop/hbase/mapreduce/TestSecureLoadIncrementalHFiles.java",0,0.982142857142857,1,1,2
"hbase-server/src/test/java/org/apache/hadoop/hbase/mapreduce/TestSecureLoadIncrementalHFilesSplitRecovery.java",0,0.984848484848485,1,1,2
"hbase-server/src/test/java/org/apache/hadoop/hbase/mapreduce/TestSimpleTotalOrderPartitioner.java",0,0.957142857142857,1,1,2
"hbase-server/src/test/java/org/apache/hadoop/hbase/mapreduce/TestTableInputFormatScan.java",0,0.867532467532467,1,2,3
"hbase-server/src/test/java/org/apache/hadoop/hbase/mapreduce/TestTableMapReduce.java",0,0.845890410958904,3,2,5
"hbase-server/src/test/java/org/apache/hadoop/hbase/mapreduce/TestTableSplit.java",0,0.931818181818182,0,2,2
"hbase-server/src/test/java/org/apache/hadoop/hbase/mapreduce/TestTimeRangeMapRed.java",0,0.952830188679245,5,1,6
"hbase-server/src/test/java/org/apache/hadoop/hbase/mapreduce/TestWALPlayer.java",0,1,0,1,1
"hbase-server/src/test/java/org/apache/hadoop/hbase/mapreduce/TsvImporterCustomTestMapper.java",0,1,0,1,1
"hbase-server/src/test/java/org/apache/hadoop/hbase/mapreduce/hadoopbackport/TestJarFinder.java",0,1,0,1,1
"hbase-server/src/test/java/org/apache/hadoop/hbase/master/MockRegionServer.java",0,0.873563218390805,6,2,8
"hbase-server/src/test/java/org/apache/hadoop/hbase/master/Mocking.java",0,0.671428571428571,1,3,4
"hbase-server/src/test/java/org/apache/hadoop/hbase/master/TestActiveMasterManager.java",0,0.831210191082803,1,2,3
"hbase-server/src/test/java/org/apache/hadoop/hbase/master/TestAssignmentManager.java",0,0.480672268907563,3,4,7
"hbase-server/src/test/java/org/apache/hadoop/hbase/master/TestAssignmentManagerOnCluster.java",0,0.995180722891566,1,1,2
"hbase-server/src/test/java/org/apache/hadoop/hbase/master/TestCatalogJanitor.java",0,0.729662077596996,10,2,12
"hbase-server/src/test/java/org/apache/hadoop/hbase/master/TestClockSkewDetection.java",0,0.700934579439252,3,2,5
"hbase-server/src/test/java/org/apache/hadoop/hbase/master/TestClusterStatusPublisher.java",0,1,0,1,1
"hbase-server/src/test/java/org/apache/hadoop/hbase/master/TestDeadServer.java",0,0.543103448275862,1,4,5
"hbase-server/src/test/java/org/apache/hadoop/hbase/master/TestDistributedLogSplitting.java",0,0.793877551020408,4,2,6
"hbase-server/src/test/java/org/apache/hadoop/hbase/master/TestHMasterRPCException.java",0,0.379310344827586,2,4,6
"hbase-server/src/test/java/org/apache/hadoop/hbase/master/TestMaster.java",0,0.478468899521531,3,3,6
"hbase-server/src/test/java/org/apache/hadoop/hbase/master/TestMasterFailover.java",0,0.664640324214792,5,2,7
"hbase-server/src/test/java/org/apache/hadoop/hbase/master/TestMasterFailoverBalancerPersistence.java",0,0.983471074380165,1,1,2
"hbase-server/src/test/java/org/apache/hadoop/hbase/master/TestMasterFileSystem.java",0,1,0,1,1
"hbase-server/src/test/java/org/apache/hadoop/hbase/master/TestMasterMetrics.java",0,0.912621359223301,0,2,2
"hbase-server/src/test/java/org/apache/hadoop/hbase/master/TestMasterMetricsWrapper.java",0,0.961538461538462,1,1,2
"hbase-server/src/test/java/org/apache/hadoop/hbase/master/TestMasterNoCluster.java",0,0.944767441860465,4,1,5
"hbase-server/src/test/java/org/apache/hadoop/hbase/master/TestMasterRestartAfterDisablingTable.java",0,0.909090909090909,0,2,2
"hbase-server/src/test/java/org/apache/hadoop/hbase/master/TestMasterShutdown.java",0,1,0,1,1
"hbase-server/src/test/java/org/apache/hadoop/hbase/master/TestMasterStatusServlet.java",0,0.820652173913043,1,3,4
"hbase-server/src/test/java/org/apache/hadoop/hbase/master/TestMasterTransitions.java",0,0.976014760147601,4,1,5
"hbase-server/src/test/java/org/apache/hadoop/hbase/master/TestOpenedRegionHandler.java",0,0.92093023255814,4,1,5
"hbase-server/src/test/java/org/apache/hadoop/hbase/master/TestRestartCluster.java",0,0.671532846715328,3,2,5
"hbase-server/src/test/java/org/apache/hadoop/hbase/master/TestRollingRestart.java",0,0.894607843137255,5,1,6
"hbase-server/src/test/java/org/apache/hadoop/hbase/master/TestSplitLogManager.java",0,0.667883211678832,3,4,7
"hbase-server/src/test/java/org/apache/hadoop/hbase/master/TestTableLockManager.java",0,0.95609756097561,2,1,3
"hbase-server/src/test/java/org/apache/hadoop/hbase/master/TestZKBasedOpenCloseRegion.java",0,0.445221445221445,1,4,5
"hbase-server/src/test/java/org/apache/hadoop/hbase/master/balancer/BalancerTestBase.java",0,1,0,1,1
"hbase-server/src/test/java/org/apache/hadoop/hbase/master/balancer/TestBaseLoadBalancer.java",0,1,0,1,1
"hbase-server/src/test/java/org/apache/hadoop/hbase/master/balancer/TestDefaultLoadBalancer.java",0,1,0,1,1
"hbase-server/src/test/java/org/apache/hadoop/hbase/master/balancer/TestStochasticLoadBalancer.java",0,1,0,1,1
"hbase-server/src/test/java/org/apache/hadoop/hbase/master/cleaner/TestCleanerChore.java",0,0.79047619047619,0,2,2
"hbase-server/src/test/java/org/apache/hadoop/hbase/master/cleaner/TestHFileCleaner.java",0,0.485355648535565,3,4,7
"hbase-server/src/test/java/org/apache/hadoop/hbase/master/cleaner/TestHFileLinkCleaner.java",0,0.977011494252874,2,1,3
"hbase-server/src/test/java/org/apache/hadoop/hbase/master/cleaner/TestLogsCleaner.java",0,0.649717514124294,3,3,6
"hbase-server/src/test/java/org/apache/hadoop/hbase/master/cleaner/TestSnapshotFromMaster.java",0,0.987309644670051,2,1,3
"hbase-server/src/test/java/org/apache/hadoop/hbase/master/handler/TestCreateTableHandler.java",0,1,0,1,1
"hbase-server/src/test/java/org/apache/hadoop/hbase/master/handler/TestTableDeleteFamilyHandler.java",0,1,0,1,1
"hbase-server/src/test/java/org/apache/hadoop/hbase/master/handler/TestTableDescriptorModification.java",0,1,0,1,1
"hbase-server/src/test/java/org/apache/hadoop/hbase/master/snapshot/TestSnapshotFileCache.java",0,1,0,1,1
"hbase-server/src/test/java/org/apache/hadoop/hbase/master/snapshot/TestSnapshotHFileCleaner.java",0,1,0,1,1
"hbase-server/src/test/java/org/apache/hadoop/hbase/master/snapshot/TestSnapshotLogCleaner.java",0,1,0,1,1
"hbase-server/src/test/java/org/apache/hadoop/hbase/master/snapshot/TestSnapshotManager.java",0,1,0,1,1
"hbase-server/src/test/java/org/apache/hadoop/hbase/metrics/TestExactCounterMetric.java",0,0.980769230769231,1,1,2
"hbase-server/src/test/java/org/apache/hadoop/hbase/metrics/TestExponentiallyDecayingSample.java",0,0.985294117647059,1,1,2
"hbase-server/src/test/java/org/apache/hadoop/hbase/metrics/TestMetricsHistogram.java",0,0.990291262135922,1,1,2
"hbase-server/src/test/java/org/apache/hadoop/hbase/metrics/TestMetricsMBeanBase.java",0,0.679558011049724,2,2,4
"hbase-server/src/test/java/org/apache/hadoop/hbase/monitoring/TestMemoryBoundedLogMessageBuffer.java",0,0.844155844155844,3,2,5
"hbase-server/src/test/java/org/apache/hadoop/hbase/monitoring/TestTaskMonitor.java",0,0.933333333333333,3,1,4
"hbase-server/src/test/java/org/apache/hadoop/hbase/procedure/TestProcedure.java",0,1,0,1,1
"hbase-server/src/test/java/org/apache/hadoop/hbase/procedure/TestProcedureCoordinator.java",0,1,0,1,1
"hbase-server/src/test/java/org/apache/hadoop/hbase/procedure/TestProcedureMember.java",0,1,0,1,1
"hbase-server/src/test/java/org/apache/hadoop/hbase/procedure/TestZKProcedure.java",0,1,0,1,1
"hbase-server/src/test/java/org/apache/hadoop/hbase/procedure/TestZKProcedureControllers.java",0,1,0,1,1
"hbase-server/src/test/java/org/apache/hadoop/hbase/protobuf/TestProtobufUtil.java",0,1,0,1,1
"hbase-server/src/test/java/org/apache/hadoop/hbase/regionserver/CreateRandomStoreFile.java",0,0.947882736156352,4,1,5
"hbase-server/src/test/java/org/apache/hadoop/hbase/regionserver/DataBlockEncodingTool.java",0,0.995804195804196,2,1,3
"hbase-server/src/test/java/org/apache/hadoop/hbase/regionserver/EncodedSeekPerformanceTest.java",0,1,0,1,1
"hbase-server/src/test/java/org/apache/hadoop/hbase/regionserver/HFileReadWriteTest.java",0,0.985714285714286,6,1,7
"hbase-server/src/test/java/org/apache/hadoop/hbase/regionserver/KeyValueScanFixture.java",0,0.770833333333333,0,2,2
"hbase-server/src/test/java/org/apache/hadoop/hbase/regionserver/MetricsRegionServerWrapperStub.java",0,1,0,1,1
"hbase-server/src/test/java/org/apache/hadoop/hbase/regionserver/MetricsRegionWrapperStub.java",0,0.661290322580645,0,2,2
"hbase-server/src/test/java/org/apache/hadoop/hbase/regionserver/NoOpScanPolicyObserver.java",0,0.836065573770492,1,2,3
"hbase-server/src/test/java/org/apache/hadoop/hbase/regionserver/OOMERegionServer.java",0,0.876923076923077,5,1,6
"hbase-server/src/test/java/org/apache/hadoop/hbase/regionserver/TestAtomicOperation.java",0,0.625523012552301,2,2,4
"hbase-server/src/test/java/org/apache/hadoop/hbase/regionserver/TestBlocksRead.java",0,0.47136563876652,3,3,6
"hbase-server/src/test/java/org/apache/hadoop/hbase/regionserver/TestBlocksScanned.java",0,0.97752808988764,2,1,3
"hbase-server/src/test/java/org/apache/hadoop/hbase/regionserver/TestCacheOnWriteInSchema.java",0,0.880281690140845,3,2,5
"hbase-server/src/test/java/org/apache/hadoop/hbase/regionserver/TestClusterId.java",0,0.988636363636364,1,1,2
"hbase-server/src/test/java/org/apache/hadoop/hbase/regionserver/TestColumnSeeking.java",0,0.660958904109589,3,2,5
"hbase-server/src/test/java/org/apache/hadoop/hbase/regionserver/TestCompaction.java",0,0.387782204515272,11,5,16
"hbase-server/src/test/java/org/apache/hadoop/hbase/regionserver/TestCompactionState.java",0,0.61965811965812,1,2,3
"hbase-server/src/test/java/org/apache/hadoop/hbase/regionserver/TestCompactionWithCoprocessor.java",0,1,0,1,1
"hbase-server/src/test/java/org/apache/hadoop/hbase/regionserver/TestCompoundBloomFilter.java",0,0.923497267759563,5,1,6
"hbase-server/src/test/java/org/apache/hadoop/hbase/regionserver/TestDefaultCompactSelection.java",0,0.832826747720365,3,2,5
"hbase-server/src/test/java/org/apache/hadoop/hbase/regionserver/TestDefaultStoreEngine.java",0,1,0,1,1
"hbase-server/src/test/java/org/apache/hadoop/hbase/regionserver/TestEndToEndSplitTransaction.java",0,0.536144578313253,2,3,5
"hbase-server/src/test/java/org/apache/hadoop/hbase/regionserver/TestExplicitColumnTracker.java",0,0.325,3,5,8
"hbase-server/src/test/java/org/apache/hadoop/hbase/regionserver/TestFSErrorsExposed.java",0,0.652014652014652,7,3,10
"hbase-server/src/test/java/org/apache/hadoop/hbase/regionserver/TestGetClosestAtOrBefore.java",0,0.99135446685879,3,1,4
"hbase-server/src/test/java/org/apache/hadoop/hbase/regionserver/TestHBase7051.java",0,0.561497326203209,1,2,3
"hbase-server/src/test/java/org/apache/hadoop/hbase/regionserver/TestHRegion.java",0,0.553444782168186,14,3,17
"hbase-server/src/test/java/org/apache/hadoop/hbase/regionserver/TestHRegionBusyWait.java",0,0.977777777777778,2,1,3
"hbase-server/src/test/java/org/apache/hadoop/hbase/regionserver/TestHRegionFileSystem.java",0,0.5625,0,2,2
"hbase-server/src/test/java/org/apache/hadoop/hbase/regionserver/TestHRegionInfo.java",0,0.641975308641975,2,4,6
"hbase-server/src/test/java/org/apache/hadoop/hbase/regionserver/TestHRegionOnCluster.java",0,1,0,1,1
"hbase-server/src/test/java/org/apache/hadoop/hbase/regionserver/TestHRegionServerBulkLoad.java",0,0.917682926829268,6,1,7
"hbase-server/src/test/java/org/apache/hadoop/hbase/regionserver/TestJoinedScanners.java",0,0.960674157303371,1,1,2
"hbase-server/src/test/java/org/apache/hadoop/hbase/regionserver/TestKeepDeletes.java",0,0.823453608247423,2,3,5
"hbase-server/src/test/java/org/apache/hadoop/hbase/regionserver/TestKeyValueHeap.java",0,0.558441558441558,1,4,5
"hbase-server/src/test/java/org/apache/hadoop/hbase/regionserver/TestKeyValueScanFixture.java",0,0.885714285714286,1,2,3
"hbase-server/src/test/java/org/apache/hadoop/hbase/regionserver/TestKeyValueSkipListSet.java",0,0.973509933774834,1,1,2
"hbase-server/src/test/java/org/apache/hadoop/hbase/regionserver/TestMasterAddressManager.java",0,0.966101694915254,1,1,2
"hbase-server/src/test/java/org/apache/hadoop/hbase/regionserver/TestMemStore.java",0,0.504504504504504,7,3,10
"hbase-server/src/test/java/org/apache/hadoop/hbase/regionserver/TestMemStoreChunkPool.java",0,1,0,1,1
"hbase-server/src/test/java/org/apache/hadoop/hbase/regionserver/TestMemStoreLAB.java",0,0.971751412429379,2,1,3
"hbase-server/src/test/java/org/apache/hadoop/hbase/regionserver/TestMetricsRegion.java",0,1,0,1,1
"hbase-server/src/test/java/org/apache/hadoop/hbase/regionserver/TestMetricsRegionServer.java",0,1,0,1,1
"hbase-server/src/test/java/org/apache/hadoop/hbase/regionserver/TestMinVersions.java",0,0.957964601769911,2,1,3
"hbase-server/src/test/java/org/apache/hadoop/hbase/regionserver/TestMiniBatchOperationInProgress.java",0,1,0,1,1
"hbase-server/src/test/java/org/apache/hadoop/hbase/regionserver/TestMultiColumnScanner.java",0,0.755162241887906,5,3,8
"hbase-server/src/test/java/org/apache/hadoop/hbase/regionserver/TestMultiVersionConsistencyControl.java",0,0.681818181818182,1,4,5
"hbase-server/src/test/java/org/apache/hadoop/hbase/regionserver/TestOffPeakCompactions.java",0,1,0,1,1
"hbase-server/src/test/java/org/apache/hadoop/hbase/regionserver/TestParallelPut.java",0,0.975903614457831,2,1,3
"hbase-server/src/test/java/org/apache/hadoop/hbase/regionserver/TestPriorityRpc.java",0,0.959183673469388,3,1,4
"hbase-server/src/test/java/org/apache/hadoop/hbase/regionserver/TestQueryMatcher.java",0,0.411594202898551,4,4,8
"hbase-server/src/test/java/org/apache/hadoop/hbase/regionserver/TestRSKilledWhenMasterInitializing.java",0,0.966386554621849,1,1,2
"hbase-server/src/test/java/org/apache/hadoop/hbase/regionserver/TestRSStatusServlet.java",0,0.651376146788991,2,2,4
"hbase-server/src/test/java/org/apache/hadoop/hbase/regionserver/TestRegionMergeTransaction.java",0,0.983606557377049,1,1,2
"hbase-server/src/test/java/org/apache/hadoop/hbase/regionserver/TestRegionMergeTransactionOnCluster.java",0,0.983221476510067,1,1,2
"hbase-server/src/test/java/org/apache/hadoop/hbase/regionserver/TestRegionServerMetrics.java",0,0.75,3,3,6
"hbase-server/src/test/java/org/apache/hadoop/hbase/regionserver/TestRegionServerNoMaster.java",0,0.98876404494382,1,1,2
"hbase-server/src/test/java/org/apache/hadoop/hbase/regionserver/TestRegionSplitPolicy.java",0,0.377162629757785,1,5,6
"hbase-server/src/test/java/org/apache/hadoop/hbase/regionserver/TestResettingCounters.java",0,0.669902912621359,1,2,3
"hbase-server/src/test/java/org/apache/hadoop/hbase/regionserver/TestScanDeleteTracker.java",0,0.582677165354331,1,4,5
"hbase-server/src/test/java/org/apache/hadoop/hbase/regionserver/TestScanWildcardColumnTracker.java",0,0.531746031746032,4,3,7
"hbase-server/src/test/java/org/apache/hadoop/hbase/regionserver/TestScanWithBloomError.java",0,0.883177570093458,4,2,6
"hbase-server/src/test/java/org/apache/hadoop/hbase/regionserver/TestScanner.java",0,0.625423728813559,7,4,11
"hbase-server/src/test/java/org/apache/hadoop/hbase/regionserver/TestSeekOptimizations.java",0,0.933481152993348,6,1,7
"hbase-server/src/test/java/org/apache/hadoop/hbase/regionserver/TestServerCustomProtocol.java",0,0.591101694915254,3,3,6
"hbase-server/src/test/java/org/apache/hadoop/hbase/regionserver/TestSplitLogWorker.java",0,0.875399361022364,2,2,4
"hbase-server/src/test/java/org/apache/hadoop/hbase/regionserver/TestSplitTransaction.java",0,0.815642458100559,5,2,7
"hbase-server/src/test/java/org/apache/hadoop/hbase/regionserver/TestSplitTransactionOnCluster.java",0,0.400852878464819,4,5,9
"hbase-server/src/test/java/org/apache/hadoop/hbase/regionserver/TestStore.java",0,0.46689497716895,11,4,15
"hbase-server/src/test/java/org/apache/hadoop/hbase/regionserver/TestStoreFile.java",0,0.300403225806452,4,7,11
"hbase-server/src/test/java/org/apache/hadoop/hbase/regionserver/TestStoreFileBlockCacheSummary.java",0,0.933333333333333,2,1,3
"hbase-server/src/test/java/org/apache/hadoop/hbase/regionserver/TestStoreFileInfo.java",0,1,0,1,1
"hbase-server/src/test/java/org/apache/hadoop/hbase/regionserver/TestStoreScanner.java",0,0.487889273356401,5,4,9
"hbase-server/src/test/java/org/apache/hadoop/hbase/regionserver/TestWideScanner.java",0,0.876811594202899,3,2,5
"hbase-server/src/test/java/org/apache/hadoop/hbase/regionserver/compactions/PerfTestCompactionPolicies.java",0,0.920502092050209,1,2,3
"hbase-server/src/test/java/org/apache/hadoop/hbase/regionserver/handler/TestCloseRegionHandler.java",0,0.495495495495495,4,2,6
"hbase-server/src/test/java/org/apache/hadoop/hbase/regionserver/handler/TestOpenRegionHandler.java",0,0.55,4,3,7
"hbase-server/src/test/java/org/apache/hadoop/hbase/regionserver/wal/FaultySequenceFileLogReader.java",0,0.963414634146341,1,1,2
"hbase-server/src/test/java/org/apache/hadoop/hbase/regionserver/wal/HLogPerformanceEvaluation.java",0,1,0,1,1
"hbase-server/src/test/java/org/apache/hadoop/hbase/regionserver/wal/HLogUtilsForTests.java",0,0.933333333333333,0,2,2
"hbase-server/src/test/java/org/apache/hadoop/hbase/regionserver/wal/InstrumentedSequenceFileLogWriter.java",0,1,0,1,1
"hbase-server/src/test/java/org/apache/hadoop/hbase/regionserver/wal/TestCompressor.java",0,1,0,1,1
"hbase-server/src/test/java/org/apache/hadoop/hbase/regionserver/wal/TestHLog.java",0,0.452322738386308,8,5,13
"hbase-server/src/test/java/org/apache/hadoop/hbase/regionserver/wal/TestHLogFiltering.java",0,0.993506493506494,1,1,2
"hbase-server/src/test/java/org/apache/hadoop/hbase/regionserver/wal/TestHLogMethods.java",0,0.958823529411765,1,1,2
"hbase-server/src/test/java/org/apache/hadoop/hbase/regionserver/wal/TestHLogSplit.java",0,0.825857519788918,6,2,8
"hbase-server/src/test/java/org/apache/hadoop/hbase/regionserver/wal/TestHLogSplitCompressed.java",0,1,0,1,1
"hbase-server/src/test/java/org/apache/hadoop/hbase/regionserver/wal/TestKeyValueCompression.java",0,1,0,1,1
"hbase-server/src/test/java/org/apache/hadoop/hbase/regionserver/wal/TestLRUDictionary.java",0,1,0,1,1
"hbase-server/src/test/java/org/apache/hadoop/hbase/regionserver/wal/TestLogRollAbort.java",0,0.827380952380952,2,2,4
"hbase-server/src/test/java/org/apache/hadoop/hbase/regionserver/wal/TestLogRolling.java",0,0.420863309352518,8,4,12
"hbase-server/src/test/java/org/apache/hadoop/hbase/regionserver/wal/TestLogRollingNoCluster.java",0,0.937062937062937,2,1,3
"hbase-server/src/test/java/org/apache/hadoop/hbase/regionserver/wal/TestWALActionsListener.java",0,0.522727272727273,0,3,3
"hbase-server/src/test/java/org/apache/hadoop/hbase/regionserver/wal/TestWALReplay.java",0,0.778947368421053,7,3,10
"hbase-server/src/test/java/org/apache/hadoop/hbase/regionserver/wal/TestWALReplayCompressed.java",0,1,0,1,1
"hbase-server/src/test/java/org/apache/hadoop/hbase/replication/ReplicationSourceDummy.java",0,0.943181818181818,2,1,3
"hbase-server/src/test/java/org/apache/hadoop/hbase/replication/TestMasterReplication.java",0,0.975460122699387,3,1,4
"hbase-server/src/test/java/org/apache/hadoop/hbase/replication/TestMultiSlaveReplication.java",0,0.892086330935252,1,2,3
"hbase-server/src/test/java/org/apache/hadoop/hbase/replication/TestReplicationBase.java",0,0.993464052287582,1,1,2
"hbase-server/src/test/java/org/apache/hadoop/hbase/replication/TestReplicationDisableInactivePeer.java",0,1,0,1,1
"hbase-server/src/test/java/org/apache/hadoop/hbase/replication/TestReplicationQueueFailover.java",0,0.992481203007519,1,1,2
"hbase-server/src/test/java/org/apache/hadoop/hbase/replication/TestReplicationQueueFailoverCompressed.java",0,0.975,1,1,2
"hbase-server/src/test/java/org/apache/hadoop/hbase/replication/TestReplicationSmallTests.java",0,0.713450292397661,2,2,4
"hbase-server/src/test/java/org/apache/hadoop/hbase/replication/TestReplicationSource.java",0,0.754385964912281,1,2,3
"hbase-server/src/test/java/org/apache/hadoop/hbase/replication/TestReplicationZookeeper.java",0,1,0,1,1
"hbase-server/src/test/java/org/apache/hadoop/hbase/replication/regionserver/TestReplicationSink.java",0,0.869565217391304,1,2,3
"hbase-server/src/test/java/org/apache/hadoop/hbase/replication/regionserver/TestReplicationSourceManager.java",0,0.474698795180723,1,3,4
"hbase-server/src/test/java/org/apache/hadoop/hbase/rest/HBaseRESTTestingUtility.java",0,0.761363636363636,2,2,4
"hbase-server/src/test/java/org/apache/hadoop/hbase/rest/PerformanceEvaluation.java",0,1,0,1,1
"hbase-server/src/test/java/org/apache/hadoop/hbase/rest/TestGzipFilter.java",0,0.935064935064935,3,1,4
"hbase-server/src/test/java/org/apache/hadoop/hbase/rest/TestMultiRowResource.java",0,0.954022988505747,3,1,4
"hbase-server/src/test/java/org/apache/hadoop/hbase/rest/TestRowResource.java",0,0.695590327169274,2,2,4
"hbase-server/src/test/java/org/apache/hadoop/hbase/rest/TestScannerResource.java",0,0.795454545454545,1,2,3
"hbase-server/src/test/java/org/apache/hadoop/hbase/rest/TestScannersWithFilters.java",0,0.98997995991984,2,1,3
"hbase-server/src/test/java/org/apache/hadoop/hbase/rest/TestSchemaResource.java",0,0.835227272727273,1,2,3
"hbase-server/src/test/java/org/apache/hadoop/hbase/rest/TestStatusResource.java",0,0.948275862068966,2,1,3
"hbase-server/src/test/java/org/apache/hadoop/hbase/rest/TestTableResource.java",0,0.896551724137931,2,2,4
"hbase-server/src/test/java/org/apache/hadoop/hbase/rest/TestVersionResource.java",0,0.966480446927374,2,1,3
"hbase-server/src/test/java/org/apache/hadoop/hbase/rest/client/TestRemoteAdmin.java",0,0.794520547945205,1,2,3
"hbase-server/src/test/java/org/apache/hadoop/hbase/rest/client/TestRemoteTable.java",0,0.979057591623037,2,1,3
"hbase-server/src/test/java/org/apache/hadoop/hbase/rest/model/TestCellModel.java",0,0.953703703703704,2,1,3
"hbase-server/src/test/java/org/apache/hadoop/hbase/rest/model/TestCellSetModel.java",0,0.968354430379747,2,1,3
"hbase-server/src/test/java/org/apache/hadoop/hbase/rest/model/TestColumnSchemaModel.java",0,0.952830188679245,2,1,3
"hbase-server/src/test/java/org/apache/hadoop/hbase/rest/model/TestRowModel.java",0,0.948453608247423,2,1,3
"hbase-server/src/test/java/org/apache/hadoop/hbase/rest/model/TestScannerModel.java",0,0.903703703703704,2,2,4
"hbase-server/src/test/java/org/apache/hadoop/hbase/rest/model/TestStorageClusterStatusModel.java",0,0.793103448275862,2,2,4
"hbase-server/src/test/java/org/apache/hadoop/hbase/rest/model/TestStorageClusterVersionModel.java",0,0.935064935064935,2,1,3
"hbase-server/src/test/java/org/apache/hadoop/hbase/rest/model/TestTableInfoModel.java",0,0.958333333333333,2,1,3
"hbase-server/src/test/java/org/apache/hadoop/hbase/rest/model/TestTableListModel.java",0,0.954954954954955,2,1,3
"hbase-server/src/test/java/org/apache/hadoop/hbase/rest/model/TestTableRegionModel.java",0,0.787037037037037,1,2,3
"hbase-server/src/test/java/org/apache/hadoop/hbase/rest/model/TestTableSchemaModel.java",0,0.962121212121212,2,1,3
"hbase-server/src/test/java/org/apache/hadoop/hbase/rest/model/TestVersionModel.java",0,0.956896551724138,2,1,3
"hbase-server/src/test/java/org/apache/hadoop/hbase/security/TestUser.java",0,0.690909090909091,1,2,3
"hbase-server/src/test/java/org/apache/hadoop/hbase/security/access/SecureTestUtil.java",0,0.95,0,2,2
"hbase-server/src/test/java/org/apache/hadoop/hbase/security/access/TestAccessControlFilter.java",0,0.847368421052632,4,2,6
"hbase-server/src/test/java/org/apache/hadoop/hbase/security/access/TestAccessController.java",0,0.443715295305401,9,3,12
"hbase-server/src/test/java/org/apache/hadoop/hbase/security/access/TestTablePermissions.java",0,0.640449438202247,4,3,7
"hbase-server/src/test/java/org/apache/hadoop/hbase/security/access/TestZKPermissionsWatcher.java",0,0.941935483870968,0,2,2
"hbase-server/src/test/java/org/apache/hadoop/hbase/security/token/TestTokenAuthentication.java",0,0.97172236503856,3,1,4
"hbase-server/src/test/java/org/apache/hadoop/hbase/security/token/TestZKSecretWatcher.java",0,0.968627450980392,1,1,2
"hbase-server/src/test/java/org/apache/hadoop/hbase/snapshot/SnapshotTestingUtils.java",0,0.983981693363844,3,1,4
"hbase-server/src/test/java/org/apache/hadoop/hbase/snapshot/TestCopyRecoveredEditsTask.java",0,1,0,1,1
"hbase-server/src/test/java/org/apache/hadoop/hbase/snapshot/TestExportSnapshot.java",0,0.897526501766785,0,2,2
"hbase-server/src/test/java/org/apache/hadoop/hbase/snapshot/TestFlushSnapshotFromClient.java",0,0.927184466019418,4,1,5
"hbase-server/src/test/java/org/apache/hadoop/hbase/snapshot/TestReferenceRegionHFilesTask.java",0,1,0,1,1
"hbase-server/src/test/java/org/apache/hadoop/hbase/snapshot/TestRestoreFlushSnapshotFromClient.java",0,0.980544747081712,2,1,3
"hbase-server/src/test/java/org/apache/hadoop/hbase/snapshot/TestRestoreSnapshotHelper.java",0,0.925742574257426,0,2,2
"hbase-server/src/test/java/org/apache/hadoop/hbase/snapshot/TestSnapshotDescriptionUtils.java",0,1,0,1,1
"hbase-server/src/test/java/org/apache/hadoop/hbase/snapshot/TestSnapshotLogSplitter.java",0,1,0,1,1
"hbase-server/src/test/java/org/apache/hadoop/hbase/snapshot/TestSnapshotTask.java",0,1,0,1,1
"hbase-server/src/test/java/org/apache/hadoop/hbase/snapshot/TestWALReferenceTask.java",0,1,0,1,1
"hbase-server/src/test/java/org/apache/hadoop/hbase/thrift/TestCallQueue.java",0,0.922480620155039,0,2,2
"hbase-server/src/test/java/org/apache/hadoop/hbase/thrift/TestThriftServer.java",0,0.551401869158878,4,3,7
"hbase-server/src/test/java/org/apache/hadoop/hbase/thrift/TestThriftServerCmdLine.java",0,0.901639344262295,3,2,5
"hbase-server/src/test/java/org/apache/hadoop/hbase/thrift2/TestThriftHBaseServiceHandler.java",0,0.954144620811287,2,1,3
"hbase-server/src/test/java/org/apache/hadoop/hbase/trace/TestHTraceHooks.java",0,1,0,1,1
"hbase-server/src/test/java/org/apache/hadoop/hbase/util/HBaseHomePath.java",0,0.970588235294118,1,1,2
"hbase-server/src/test/java/org/apache/hadoop/hbase/util/HFileArchiveTestingUtil.java",0,0.930327868852459,2,1,3
"hbase-server/src/test/java/org/apache/hadoop/hbase/util/LoadTestTool.java",0,0.653266331658292,4,3,7
"hbase-server/src/test/java/org/apache/hadoop/hbase/util/MockRegionServerServices.java",0,0.649484536082474,4,4,8
"hbase-server/src/test/java/org/apache/hadoop/hbase/util/MockServer.java",0,0.946428571428571,2,1,3
"hbase-server/src/test/java/org/apache/hadoop/hbase/util/MultiThreadedAction.java",0,0.551136363636364,1,2,3
"hbase-server/src/test/java/org/apache/hadoop/hbase/util/MultiThreadedReader.java",0,0.866459627329193,2,2,4
"hbase-server/src/test/java/org/apache/hadoop/hbase/util/MultiThreadedWriter.java",0,0.733974358974359,1,3,4
"hbase-server/src/test/java/org/apache/hadoop/hbase/util/ProcessBasedLocalHBaseCluster.java",0,0.502692998204668,0,2,2
"hbase-server/src/test/java/org/apache/hadoop/hbase/util/RestartMetaTest.java",0,0.874172185430464,3,2,5
"hbase-server/src/test/java/org/apache/hadoop/hbase/util/StoppableImplementation.java",0,1,0,1,1
"hbase-server/src/test/java/org/apache/hadoop/hbase/util/TestBase64.java",0,0.915492957746479,2,1,3
"hbase-server/src/test/java/org/apache/hadoop/hbase/util/TestByteBloomFilter.java",0,0.738095238095238,0,2,2
"hbase-server/src/test/java/org/apache/hadoop/hbase/util/TestByteBufferUtils.java",0,0.963076923076923,1,1,2
"hbase-server/src/test/java/org/apache/hadoop/hbase/util/TestCompressionTest.java",0,0.457746478873239,2,3,5
"hbase-server/src/test/java/org/apache/hadoop/hbase/util/TestCoprocessorScanPolicy.java",0,0.833910034602076,2,3,5
"hbase-server/src/test/java/org/apache/hadoop/hbase/util/TestDefaultEnvironmentEdge.java",0,0.907407407407407,1,2,3
"hbase-server/src/test/java/org/apache/hadoop/hbase/util/TestFSTableDescriptors.java",0,0.848993288590604,4,2,6
"hbase-server/src/test/java/org/apache/hadoop/hbase/util/TestFSUtils.java",0,0.610344827586207,1,3,4
"hbase-server/src/test/java/org/apache/hadoop/hbase/util/TestFSVisitor.java",0,1,0,1,1
"hbase-server/src/test/java/org/apache/hadoop/hbase/util/TestHBaseFsck.java",0,0.464948453608247,7,4,11
"hbase-server/src/test/java/org/apache/hadoop/hbase/util/TestHBaseFsckComparator.java",0,0.96969696969697,1,1,2
"hbase-server/src/test/java/org/apache/hadoop/hbase/util/TestHFileArchiveUtil.java",0,0.955882352941177,2,1,3
"hbase-server/src/test/java/org/apache/hadoop/hbase/util/TestIdLock.java",0,0.973451327433628,1,1,2
"hbase-server/src/test/java/org/apache/hadoop/hbase/util/TestIncrementingEnvironmentEdge.java",0,0.844444444444444,2,2,4
"hbase-server/src/test/java/org/apache/hadoop/hbase/util/TestKeyLocker.java",0,1,0,1,1
"hbase-server/src/test/java/org/apache/hadoop/hbase/util/TestKeying.java",0,0.787878787878788,0,3,3
"hbase-server/src/test/java/org/apache/hadoop/hbase/util/TestMergeTable.java",0,0.820809248554913,2,2,4
"hbase-server/src/test/java/org/apache/hadoop/hbase/util/TestMergeTool.java",0,0.488372093023256,5,3,8
"hbase-server/src/test/java/org/apache/hadoop/hbase/util/TestMiniClusterLoadEncoded.java",0,1,0,1,1
"hbase-server/src/test/java/org/apache/hadoop/hbase/util/TestMiniClusterLoadParallel.java",0,0.866666666666667,0,2,2
"hbase-server/src/test/java/org/apache/hadoop/hbase/util/TestMiniClusterLoadSequential.java",0,0.578651685393258,5,3,8
"hbase-server/src/test/java/org/apache/hadoop/hbase/util/TestPoolMap.java",0,0.948497854077253,3,1,4
"hbase-server/src/test/java/org/apache/hadoop/hbase/util/TestProcessBasedCluster.java",0,0.946236559139785,0,2,2
"hbase-server/src/test/java/org/apache/hadoop/hbase/util/TestRegionSplitCalculator.java",0,0.81360201511335,2,3,5
"hbase-server/src/test/java/org/apache/hadoop/hbase/util/TestRegionSplitter.java",0,0.953079178885631,2,1,3
"hbase-server/src/test/java/org/apache/hadoop/hbase/util/TestRootPath.java",0,0.895522388059702,1,2,3
"hbase-server/src/test/java/org/apache/hadoop/hbase/util/TestSortedCopyOnWriteSet.java",0,0.953271028037383,2,1,3
"hbase-server/src/test/java/org/apache/hadoop/hbase/util/hbck/HbckTestingUtil.java",0,0.505494505494505,1,3,4
"hbase-server/src/test/java/org/apache/hadoop/hbase/util/hbck/OfflineMetaRebuildTestCore.java",0,0.890459363957597,2,2,4
"hbase-server/src/test/java/org/apache/hadoop/hbase/util/hbck/TestOfflineMetaRebuildBase.java",0,0.955555555555556,3,1,4
"hbase-server/src/test/java/org/apache/hadoop/hbase/util/hbck/TestOfflineMetaRebuildHole.java",0,0.957446808510638,2,1,3
"hbase-server/src/test/java/org/apache/hadoop/hbase/util/hbck/TestOfflineMetaRebuildOverlap.java",0,0.971153846153846,2,1,3
"hbase-server/src/test/java/org/apache/hadoop/hbase/zookeeper/TestHQuorumPeer.java",0,0.818181818181818,2,3,5
"hbase-server/src/test/java/org/apache/hadoop/hbase/zookeeper/TestRecoverableZooKeeper.java",0,1,0,1,1
"hbase-server/src/test/java/org/apache/hadoop/hbase/zookeeper/TestZKConfig.java",0,1,0,1,1
"hbase-server/src/test/java/org/apache/hadoop/hbase/zookeeper/TestZKLeaderManager.java",0,0.961538461538462,1,1,2
"hbase-server/src/test/java/org/apache/hadoop/hbase/zookeeper/TestZKMulti.java",0,1,0,1,1
"hbase-server/src/test/java/org/apache/hadoop/hbase/zookeeper/TestZKTable.java",0,0.827272727272727,1,2,3
"hbase-server/src/test/java/org/apache/hadoop/hbase/zookeeper/TestZooKeeperACL.java",0,0.98134328358209,1,1,2
"hbase-server/src/test/java/org/apache/hadoop/hbase/zookeeper/TestZooKeeperMainServerArg.java",0,0.829787234042553,1,2,3
"hbase-server/src/test/java/org/apache/hadoop/hbase/zookeeper/TestZooKeeperNodeTracker.java",0,0.917613636363636,1,2,3
"hbase-server/src/test/java/org/apache/hadoop/hbase/zookeeper/lock/TestZKInterProcessReadWriteLock.java",0,1,0,1,1
"bin/get-active-master.rb",0,0.977272727272727,1,1,2
"bin/hirb.rb",0,0.851851851851852,3,2,5
"bin/region_mover.rb",0,0.910869565217391,1,2,3
"bin/region_status.rb",0,0.953333333333333,2,1,3
"bin/replication/copy_tables_desc.rb",0,1,0,1,1
"hbase-examples/src/main/cpp/DemoClient.cpp",0,0.840764331210191,0,2,2
"hbase-examples/src/main/cpp/gen-cpp/Hbase.cpp",0,1,0,1,1
"hbase-examples/src/main/cpp/gen-cpp/Hbase.h",0,1,0,1,1
"hbase-examples/src/main/cpp/gen-cpp/Hbase_constants.cpp",0,1,0,1,1
"hbase-examples/src/main/cpp/gen-cpp/Hbase_constants.h",0,1,0,1,1
"hbase-examples/src/main/cpp/gen-cpp/Hbase_server.skeleton.cpp",0,1,0,1,1
"hbase-examples/src/main/cpp/gen-cpp/Hbase_types.cpp",0,1,0,1,1
"hbase-examples/src/main/cpp/gen-cpp/Hbase_types.h",0,1,0,1,1
"hbase-examples/src/main/python/DemoClient.py",0,0.94954128440367,0,2,2
"hbase-examples/src/main/python/gen-py/hbase/Hbase.py",0,1,0,1,1
"hbase-examples/src/main/python/gen-py/hbase/__init__.py",0,1,0,1,1
"hbase-examples/src/main/python/gen-py/hbase/constants.py",0,1,0,1,1
"hbase-examples/src/main/python/gen-py/hbase/ttypes.py",0,1,0,1,1
"hbase-examples/src/main/ruby/DemoClient.rb",0,0.762845849802372,0,2,2
"hbase-examples/src/main/ruby/gen-rb/hbase.rb",0,1,0,1,1
"hbase-examples/src/main/ruby/gen-rb/hbase_constants.rb",0,1,0,1,1
"hbase-examples/src/main/ruby/gen-rb/hbase_types.rb",0,1,0,1,1
"hbase-examples/src/main/ruby/index-builder-setup.rb",0,0.516129032258065,0,2,2
"hbase-examples/thrift2/DemoClient.py",0,0.985294117647059,1,1,2
"hbase-server/src/main/native/src/mlockall_agent/mlockall_agent.c",0,1,0,1,1
"hbase-server/src/main/python/hbase/merge_conf.py",0,0.901960784313726,0,2,2
"hbase-server/src/main/ruby/hbase.rb",0,0.6875,5,2,7
"hbase-server/src/main/ruby/hbase/admin.rb",0,0.740845070422535,10,3,13
"hbase-server/src/main/ruby/hbase/hbase.rb",0,0.525423728813559,0,4,4
"hbase-server/src/main/ruby/hbase/replication_admin.rb",0,0.839506172839506,1,3,4
"hbase-server/src/main/ruby/hbase/security.rb",0,0.505813953488372,0,3,3
"hbase-server/src/main/ruby/hbase/table.rb",0,0.935969868173258,5,1,6
"hbase-server/src/main/ruby/irb/hirb.rb",0,0.677966101694915,0,2,2
"hbase-server/src/main/ruby/shell.rb",0,0.781437125748503,5,3,8
"hbase-server/src/main/ruby/shell/commands.rb",0,0.702127659574468,2,2,4
"hbase-server/src/main/ruby/shell/commands/add_peer.rb",0,0.813953488372093,0,2,2
"hbase-server/src/main/ruby/shell/commands/alter.rb",0,0.571428571428571,1,2,3
"hbase-server/src/main/ruby/shell/commands/alter_async.rb",0,1,0,1,1
"hbase-server/src/main/ruby/shell/commands/alter_status.rb",0,1,0,1,1
"hbase-server/src/main/ruby/shell/commands/assign.rb",0,0.513513513513513,0,4,4
"hbase-server/src/main/ruby/shell/commands/balance_switch.rb",0,0.547619047619048,0,2,2
"hbase-server/src/main/ruby/shell/commands/balancer.rb",0,0.475,0,3,3
"hbase-server/src/main/ruby/shell/commands/catalogjanitor_enabled.rb",0,1,0,1,1
"hbase-server/src/main/ruby/shell/commands/catalogjanitor_run.rb",0,1,0,1,1
"hbase-server/src/main/ruby/shell/commands/catalogjanitor_switch.rb",0,1,0,1,1
"hbase-server/src/main/ruby/shell/commands/clone_snapshot.rb",0,0.95,0,2,2
"hbase-server/src/main/ruby/shell/commands/close_region.rb",0,0.666666666666667,0,2,2
"hbase-server/src/main/ruby/shell/commands/compact.rb",0,0.404255319148936,0,3,3
"hbase-server/src/main/ruby/shell/commands/count.rb",0,0.671052631578947,0,3,3
"hbase-server/src/main/ruby/shell/commands/create.rb",0,0.676470588235294,1,2,3
"hbase-server/src/main/ruby/shell/commands/delete.rb",0,0.648148148148148,0,2,2
"hbase-server/src/main/ruby/shell/commands/delete_snapshot.rb",0,1,0,1,1
"hbase-server/src/main/ruby/shell/commands/deleteall.rb",0,0.614035087719298,0,3,3
"hbase-server/src/main/ruby/shell/commands/describe.rb",0,0.536585365853659,0,2,2
"hbase-server/src/main/ruby/shell/commands/disable.rb",0,0.527777777777778,0,2,2
"hbase-server/src/main/ruby/shell/commands/disable_all.rb",0,0.979591836734694,1,1,2
"hbase-server/src/main/ruby/shell/commands/disable_peer.rb",0,0.878048780487805,0,2,2
"hbase-server/src/main/ruby/shell/commands/drop.rb",0,0.527777777777778,0,2,2
"hbase-server/src/main/ruby/shell/commands/drop_all.rb",0,0.979591836734694,1,1,2
"hbase-server/src/main/ruby/shell/commands/enable.rb",0,0.527777777777778,0,2,2
"hbase-server/src/main/ruby/shell/commands/enable_all.rb",0,0.979591836734694,1,1,2
"hbase-server/src/main/ruby/shell/commands/enable_peer.rb",0,0.878048780487805,0,2,2
"hbase-server/src/main/ruby/shell/commands/exists.rb",0,0.5,0,2,2
"hbase-server/src/main/ruby/shell/commands/flush.rb",0,0.525,0,2,2
"hbase-server/src/main/ruby/shell/commands/get.rb",0,0.791208791208791,0,2,2
"hbase-server/src/main/ruby/shell/commands/get_counter.rb",0,0.641509433962264,0,2,2
"hbase-server/src/main/ruby/shell/commands/get_table.rb",0,1,0,1,1
"hbase-server/src/main/ruby/shell/commands/grant.rb",0,0.931818181818182,0,2,2
"hbase-server/src/main/ruby/shell/commands/hlog_roll.rb",0,1,0,1,1
"hbase-server/src/main/ruby/shell/commands/incr.rb",0,0.654545454545455,0,2,2
"hbase-server/src/main/ruby/shell/commands/is_disabled.rb",0,1,0,1,1
"hbase-server/src/main/ruby/shell/commands/is_enabled.rb",0,1,0,1,1
"hbase-server/src/main/ruby/shell/commands/list.rb",0,0.404255319148936,1,3,4
"hbase-server/src/main/ruby/shell/commands/list_peers.rb",0,0.936170212765957,0,2,2
"hbase-server/src/main/ruby/shell/commands/list_snapshots.rb",0,1,0,1,1
"hbase-server/src/main/ruby/shell/commands/major_compact.rb",0,0.395833333333333,0,3,3
"hbase-server/src/main/ruby/shell/commands/merge_region.rb",0,1,0,1,1
"hbase-server/src/main/ruby/shell/commands/move.rb",0,0.595744680851064,0,2,2
"hbase-server/src/main/ruby/shell/commands/put.rb",0,0.634615384615385,0,2,2
"hbase-server/src/main/ruby/shell/commands/remove_peer.rb",0,0.897435897435897,0,2,2
"hbase-server/src/main/ruby/shell/commands/rename_snapshot.rb",0,1,0,1,1
"hbase-server/src/main/ruby/shell/commands/restore_snapshot.rb",0,1,0,1,1
"hbase-server/src/main/ruby/shell/commands/revoke.rb",0,0.897435897435897,0,2,2
"hbase-server/src/main/ruby/shell/commands/scan.rb",0,0.754545454545455,1,3,4
"hbase-server/src/main/ruby/shell/commands/show_filters.rb",0,1,0,1,1
"hbase-server/src/main/ruby/shell/commands/snapshot.rb",0,1,0,1,1
"hbase-server/src/main/ruby/shell/commands/split.rb",0,0.452380952380952,0,3,3
"hbase-server/src/main/ruby/shell/commands/start_replication.rb",0,0.833333333333333,0,2,2
"hbase-server/src/main/ruby/shell/commands/status.rb",0,0.525,0,2,2
"hbase-server/src/main/ruby/shell/commands/stop_replication.rb",0,0.833333333333333,0,2,2
"hbase-server/src/main/ruby/shell/commands/table_help.rb",0,1,0,1,1
"hbase-server/src/main/ruby/shell/commands/truncate.rb",0,0.5,0,2,2
"hbase-server/src/main/ruby/shell/commands/unassign.rb",0,0.488372093023256,0,3,3
"hbase-server/src/main/ruby/shell/commands/user_permission.rb",0,0.936170212765957,0,2,2
"hbase-server/src/main/ruby/shell/commands/version.rb",0,0.513513513513513,0,2,2
"hbase-server/src/main/ruby/shell/commands/whoami.rb",0,1,0,1,1
"hbase-server/src/main/ruby/shell/commands/zk_dump.rb",0,0.558823529411765,0,2,2
"hbase-server/src/main/ruby/shell/formatter.rb",0,0.858823529411765,1,2,3
"hbase-server/src/test/ruby/hbase/admin_test.rb",0,0.818443804034582,1,2,3
"hbase-server/src/test/ruby/hbase/hbase_test.rb",0,0.591836734693878,1,2,3
"hbase-server/src/test/ruby/hbase/table_test.rb",0,0.960743801652893,1,1,2
"hbase-server/src/test/ruby/shell/commands_test.rb",0,0.558823529411765,0,2,2
"hbase-server/src/test/ruby/shell/formatter_test.rb",0,0.720588235294118,0,2,2
"hbase-server/src/test/ruby/shell/shell_test.rb",0,0.710144927536232,1,2,3
"hbase-server/src/test/ruby/test_helper.rb",0,1,0,1,1
"hbase-server/src/test/ruby/tests_runner.rb",0,0.707692307692308,0,2,2
