"Filename","X","LineOWN","LineMinor","LineMajor","LineNumDev"
"dev-support/jenkins-tools/buildstats/src/main/java/org/apache/hadoop/hbase/devtools/buildstats/BuildResultWithTestCaseDetails.java",0,1,0,1,1
"dev-support/jenkins-tools/buildstats/src/main/java/org/apache/hadoop/hbase/devtools/buildstats/HistoryReport.java",0,1,0,1,1
"dev-support/jenkins-tools/buildstats/src/main/java/org/apache/hadoop/hbase/devtools/buildstats/TestCaseResult.java",0,1,0,1,1
"dev-support/jenkins-tools/buildstats/src/main/java/org/apache/hadoop/hbase/devtools/buildstats/TestResultHistory.java",0,1,0,1,1
"dev-support/jenkins-tools/buildstats/src/main/java/org/apache/hadoop/hbase/devtools/buildstats/TestSuite.java",0,1,0,1,1
"hbase-client/src/main/java/org/apache/hadoop/hbase/Abortable.java",0,0.577777777777778,0,2,2
"hbase-client/src/main/java/org/apache/hadoop/hbase/Chore.java",0,0.683098591549296,1,5,6
"hbase-client/src/main/java/org/apache/hadoop/hbase/ClockOutOfSyncException.java",0,0.810810810810811,1,2,3
"hbase-client/src/main/java/org/apache/hadoop/hbase/ClusterId.java",0,0.893203883495146,1,2,3
"hbase-client/src/main/java/org/apache/hadoop/hbase/ClusterStatus.java",0,0.3725,5,3,8
"hbase-client/src/main/java/org/apache/hadoop/hbase/Coprocessor.java",0,0.553571428571429,1,3,4
"hbase-client/src/main/java/org/apache/hadoop/hbase/CoprocessorEnvironment.java",0,0.709090909090909,2,2,4
"hbase-client/src/main/java/org/apache/hadoop/hbase/DoNotRetryIOException.java",0,0.783333333333333,2,3,5
"hbase-client/src/main/java/org/apache/hadoop/hbase/DroppedSnapshotException.java",0,0.804347826086957,2,2,4
"hbase-client/src/main/java/org/apache/hadoop/hbase/HColumnDescriptor.java",0,0.30016051364366,7,6,13
"hbase-client/src/main/java/org/apache/hadoop/hbase/HRegionInfo.java",0,0.729920564872021,11,2,13
"hbase-client/src/main/java/org/apache/hadoop/hbase/HRegionLocation.java",0,0.488,1,4,5
"hbase-client/src/main/java/org/apache/hadoop/hbase/HTableDescriptor.java",0,0.32699868938401,12,5,17
"hbase-client/src/main/java/org/apache/hadoop/hbase/InvalidFamilyOperationException.java",0,0.944444444444444,2,1,3
"hbase-client/src/main/java/org/apache/hadoop/hbase/MasterNotRunningException.java",0,0.649122807017544,2,2,4
"hbase-client/src/main/java/org/apache/hadoop/hbase/NotAllMetaRegionsOnlineException.java",0,0.844444444444444,1,2,3
"hbase-client/src/main/java/org/apache/hadoop/hbase/NotServingRegionException.java",0,0.678571428571429,2,2,4
"hbase-client/src/main/java/org/apache/hadoop/hbase/PleaseHoldException.java",0,0.543478260869565,1,3,4
"hbase-client/src/main/java/org/apache/hadoop/hbase/RegionException.java",0,0.91304347826087,3,1,4
"hbase-client/src/main/java/org/apache/hadoop/hbase/RegionLoad.java",0,0.718446601941748,1,2,3
"hbase-client/src/main/java/org/apache/hadoop/hbase/RegionTooBusyException.java",0,0.978723404255319,1,1,2
"hbase-client/src/main/java/org/apache/hadoop/hbase/RegionTransition.java",0,0.942028985507246,2,1,3
"hbase-client/src/main/java/org/apache/hadoop/hbase/RemoteExceptionHandler.java",0,0.525,1,2,3
"hbase-client/src/main/java/org/apache/hadoop/hbase/Server.java",0,1,0,1,1
"hbase-client/src/main/java/org/apache/hadoop/hbase/ServerLoad.java",0,0.756578947368421,1,2,3
"hbase-client/src/main/java/org/apache/hadoop/hbase/ServerName.java",0,0.932795698924731,4,1,5
"hbase-client/src/main/java/org/apache/hadoop/hbase/Stoppable.java",0,0.526315789473684,0,2,2
"hbase-client/src/main/java/org/apache/hadoop/hbase/TableExistsException.java",0,0.755555555555556,1,2,3
"hbase-client/src/main/java/org/apache/hadoop/hbase/TableInfoMissingException.java",0,0.958333333333333,2,1,3
"hbase-client/src/main/java/org/apache/hadoop/hbase/TableNotDisabledException.java",0,0.593220338983051,1,2,3
"hbase-client/src/main/java/org/apache/hadoop/hbase/TableNotEnabledException.java",0,0.733333333333333,2,2,4
"hbase-client/src/main/java/org/apache/hadoop/hbase/TableNotFoundException.java",0,0.63265306122449,1,2,3
"hbase-client/src/main/java/org/apache/hadoop/hbase/UnknownRegionException.java",0,0.571428571428571,2,2,4
"hbase-client/src/main/java/org/apache/hadoop/hbase/UnknownScannerException.java",0,0.75,1,2,3
"hbase-client/src/main/java/org/apache/hadoop/hbase/YouAreDeadException.java",0,0.736842105263158,1,3,4
"hbase-client/src/main/java/org/apache/hadoop/hbase/ZooKeeperConnectionException.java",0,0.905660377358491,3,1,4
"hbase-client/src/main/java/org/apache/hadoop/hbase/catalog/CatalogTracker.java",0,0.883826879271071,6,2,8
"hbase-client/src/main/java/org/apache/hadoop/hbase/catalog/MetaReader.java",0,0.869281045751634,4,2,6
"hbase-client/src/main/java/org/apache/hadoop/hbase/client/AbstractClientScanner.java",0,0.896103896103896,1,2,3
"hbase-client/src/main/java/org/apache/hadoop/hbase/client/Action.java",0,0.63768115942029,2,2,4
"hbase-client/src/main/java/org/apache/hadoop/hbase/client/Append.java",0,0.606837606837607,3,2,5
"hbase-client/src/main/java/org/apache/hadoop/hbase/client/AsyncProcess.java",0,0.948275862068966,4,1,5
"hbase-client/src/main/java/org/apache/hadoop/hbase/client/Attributes.java",0,0.941176470588235,2,1,3
"hbase-client/src/main/java/org/apache/hadoop/hbase/client/ClientScanner.java",0,0.687927107061503,4,4,8
"hbase-client/src/main/java/org/apache/hadoop/hbase/client/ClusterStatusListener.java",0,0.983739837398374,1,1,2
"hbase-client/src/main/java/org/apache/hadoop/hbase/client/ConnectionUtils.java",0,0.666666666666667,0,3,3
"hbase-client/src/main/java/org/apache/hadoop/hbase/client/DelegatingRetryingCallable.java",0,0.62962962962963,0,2,2
"hbase-client/src/main/java/org/apache/hadoop/hbase/client/Delete.java",0,0.42258064516129,2,4,6
"hbase-client/src/main/java/org/apache/hadoop/hbase/client/Durability.java",0,0.932203389830508,0,2,2
"hbase-client/src/main/java/org/apache/hadoop/hbase/client/Get.java",0,0.530120481927711,3,4,7
"hbase-client/src/main/java/org/apache/hadoop/hbase/client/HBaseAdmin.java",0,0.494706448508181,18,4,22
"hbase-client/src/main/java/org/apache/hadoop/hbase/client/HConnectable.java",0,0.520833333333333,2,2,4
"hbase-client/src/main/java/org/apache/hadoop/hbase/client/HConnection.java",0,0.507575757575758,7,4,11
"hbase-client/src/main/java/org/apache/hadoop/hbase/client/HConnectionKey.java",0,1,0,1,1
"hbase-client/src/main/java/org/apache/hadoop/hbase/client/HConnectionManager.java",0,0.628490632732414,15,4,19
"hbase-client/src/main/java/org/apache/hadoop/hbase/client/HConnectionWrapper.java",0,0.611479028697572,2,3,5
"hbase-client/src/main/java/org/apache/hadoop/hbase/client/HTable.java",0,0.426987060998152,10,6,16
"hbase-client/src/main/java/org/apache/hadoop/hbase/client/HTableFactory.java",0,0.918367346938776,2,1,3
"hbase-client/src/main/java/org/apache/hadoop/hbase/client/HTableInterface.java",0,0.593128390596745,5,5,10
"hbase-client/src/main/java/org/apache/hadoop/hbase/client/HTableInterfaceFactory.java",0,0.942307692307692,2,1,3
"hbase-client/src/main/java/org/apache/hadoop/hbase/client/HTableMultiplexer.java",0,0.918965517241379,4,2,6
"hbase-client/src/main/java/org/apache/hadoop/hbase/client/HTablePool.java",0,0.736754966887417,6,3,9
"hbase-client/src/main/java/org/apache/hadoop/hbase/client/HTableUtil.java",0,0.948905109489051,2,1,3
"hbase-client/src/main/java/org/apache/hadoop/hbase/client/Increment.java",0,0.524528301886792,4,2,6
"hbase-client/src/main/java/org/apache/hadoop/hbase/client/IsolationLevel.java",0,0.915254237288136,0,2,2
"hbase-client/src/main/java/org/apache/hadoop/hbase/client/MasterAdminKeepAliveConnection.java",0,1,0,1,1
"hbase-client/src/main/java/org/apache/hadoop/hbase/client/MasterMonitorKeepAliveConnection.java",0,1,0,1,1
"hbase-client/src/main/java/org/apache/hadoop/hbase/client/MetaScanner.java",0,0.815934065934066,7,2,9
"hbase-client/src/main/java/org/apache/hadoop/hbase/client/MultiAction.java",0,0.782608695652174,2,3,5
"hbase-client/src/main/java/org/apache/hadoop/hbase/client/MultiResponse.java",0,0.894117647058824,2,2,4
"hbase-client/src/main/java/org/apache/hadoop/hbase/client/MultiServerCallable.java",0,1,0,1,1
"hbase-client/src/main/java/org/apache/hadoop/hbase/client/Mutation.java",0,0.682741116751269,5,3,8
"hbase-client/src/main/java/org/apache/hadoop/hbase/client/NoServerForRegionException.java",0,0.977777777777778,1,1,2
"hbase-client/src/main/java/org/apache/hadoop/hbase/client/Operation.java",0,0.973684210526316,1,1,2
"hbase-client/src/main/java/org/apache/hadoop/hbase/client/OperationWithAttributes.java",0,0.953703703703704,2,1,3
"hbase-client/src/main/java/org/apache/hadoop/hbase/client/Put.java",0,0.574324324324324,3,3,6
"hbase-client/src/main/java/org/apache/hadoop/hbase/client/RegionOfflineException.java",0,0.769230769230769,2,3,5
"hbase-client/src/main/java/org/apache/hadoop/hbase/client/RegionServerCallable.java",0,0.993150684931507,1,1,2
"hbase-client/src/main/java/org/apache/hadoop/hbase/client/Registry.java",0,1,0,1,1
"hbase-client/src/main/java/org/apache/hadoop/hbase/client/Result.java",0,0.454166666666667,5,3,8
"hbase-client/src/main/java/org/apache/hadoop/hbase/client/ResultScanner.java",0,0.722222222222222,0,3,3
"hbase-client/src/main/java/org/apache/hadoop/hbase/client/RetriesExhaustedException.java",0,0.651785714285714,2,3,5
"hbase-client/src/main/java/org/apache/hadoop/hbase/client/RetriesExhaustedWithDetailsException.java",0,0.617977528089888,4,4,8
"hbase-client/src/main/java/org/apache/hadoop/hbase/client/RetryingCallable.java",0,1,0,1,1
"hbase-client/src/main/java/org/apache/hadoop/hbase/client/Row.java",0,0.970588235294118,1,1,2
"hbase-client/src/main/java/org/apache/hadoop/hbase/client/RowMutations.java",0,1,0,1,1
"hbase-client/src/main/java/org/apache/hadoop/hbase/client/RpcRetryingCaller.java",0,0.920704845814978,3,2,5
"hbase-client/src/main/java/org/apache/hadoop/hbase/client/RpcRetryingCallerFactory.java",0,1,0,1,1
"hbase-client/src/main/java/org/apache/hadoop/hbase/client/Scan.java",0,0.425106990014265,3,6,9
"hbase-client/src/main/java/org/apache/hadoop/hbase/client/ScannerCallable.java",0,0.464705882352941,3,5,8
"hbase-client/src/main/java/org/apache/hadoop/hbase/client/ScannerTimeoutException.java",0,0.795454545454545,1,2,3
"hbase-client/src/main/java/org/apache/hadoop/hbase/client/UnmodifyableHRegionInfo.java",0,0.886792452830189,0,2,2
"hbase-client/src/main/java/org/apache/hadoop/hbase/client/UnmodifyableHTableDescriptor.java",0,0.748031496062992,2,2,4
"hbase-client/src/main/java/org/apache/hadoop/hbase/client/WrongRowIOException.java",0,1,0,1,1
"hbase-client/src/main/java/org/apache/hadoop/hbase/client/ZooKeeperKeepAliveConnection.java",0,1,0,1,1
"hbase-client/src/main/java/org/apache/hadoop/hbase/client/ZooKeeperRegistry.java",0,1,0,1,1
"hbase-client/src/main/java/org/apache/hadoop/hbase/client/coprocessor/Batch.java",0,0.77027027027027,0,3,3
"hbase-client/src/main/java/org/apache/hadoop/hbase/client/coprocessor/BigDecimalColumnInterpreter.java",0,1,0,1,1
"hbase-client/src/main/java/org/apache/hadoop/hbase/client/coprocessor/LongColumnInterpreter.java",0,0.676470588235294,2,2,4
"hbase-client/src/main/java/org/apache/hadoop/hbase/client/coprocessor/SecureBulkLoadClient.java",0,0.966101694915254,2,1,3
"hbase-client/src/main/java/org/apache/hadoop/hbase/client/coprocessor/package-info.java",0,0.52212389380531,1,2,3
"hbase-client/src/main/java/org/apache/hadoop/hbase/client/metrics/ScanMetrics.java",0,0.591549295774648,1,2,3
"hbase-client/src/main/java/org/apache/hadoop/hbase/client/package-info.java",0,0.904761904761905,1,2,3
"hbase-client/src/main/java/org/apache/hadoop/hbase/client/replication/ReplicationAdmin.java",0,0.741228070175439,2,3,5
"hbase-client/src/main/java/org/apache/hadoop/hbase/coprocessor/ColumnInterpreter.java",0,0.573033707865168,1,2,3
"hbase-client/src/main/java/org/apache/hadoop/hbase/coprocessor/CoprocessorException.java",0,0.890909090909091,1,2,3
"hbase-client/src/main/java/org/apache/hadoop/hbase/exceptions/DeserializationException.java",0,0.511627906976744,1,2,3
"hbase-client/src/main/java/org/apache/hadoop/hbase/exceptions/FailedSanityCheckException.java",0,0.959183673469388,2,1,3
"hbase-client/src/main/java/org/apache/hadoop/hbase/exceptions/HBaseException.java",0,0.5,1,2,3
"hbase-client/src/main/java/org/apache/hadoop/hbase/exceptions/LockTimeoutException.java",0,0.861111111111111,1,3,4
"hbase-client/src/main/java/org/apache/hadoop/hbase/exceptions/MergeRegionException.java",0,0.977777777777778,1,1,2
"hbase-client/src/main/java/org/apache/hadoop/hbase/exceptions/OutOfOrderScannerNextException.java",0,0.948717948717949,2,1,3
"hbase-client/src/main/java/org/apache/hadoop/hbase/exceptions/RegionInRecoveryException.java",0,0.978260869565217,1,1,2
"hbase-client/src/main/java/org/apache/hadoop/hbase/exceptions/RegionMovedException.java",0,0.748387096774194,2,3,5
"hbase-client/src/main/java/org/apache/hadoop/hbase/exceptions/RegionOpeningException.java",0,0.987341772151899,1,1,2
"hbase-client/src/main/java/org/apache/hadoop/hbase/exceptions/UnknownProtocolException.java",0,0.934782608695652,2,1,3
"hbase-client/src/main/java/org/apache/hadoop/hbase/executor/EventType.java",0,0.670289855072464,2,2,4
"hbase-client/src/main/java/org/apache/hadoop/hbase/executor/ExecutorType.java",0,0.982758620689655,1,1,2
"hbase-client/src/main/java/org/apache/hadoop/hbase/filter/BinaryComparator.java",0,0.5,4,3,7
"hbase-client/src/main/java/org/apache/hadoop/hbase/filter/BinaryPrefixComparator.java",0,0.877777777777778,5,1,6
"hbase-client/src/main/java/org/apache/hadoop/hbase/filter/BitComparator.java",0,0.871212121212121,3,2,5
"hbase-client/src/main/java/org/apache/hadoop/hbase/filter/ByteArrayComparable.java",0,0.530612244897959,3,4,7
"hbase-client/src/main/java/org/apache/hadoop/hbase/filter/ColumnCountGetFilter.java",0,0.666666666666667,3,3,6
"hbase-client/src/main/java/org/apache/hadoop/hbase/filter/ColumnPaginationFilter.java",0,0.863436123348018,4,2,6
"hbase-client/src/main/java/org/apache/hadoop/hbase/filter/ColumnPrefixFilter.java",0,0.564285714285714,2,2,4
"hbase-client/src/main/java/org/apache/hadoop/hbase/filter/ColumnRangeFilter.java",0,0.885964912280702,2,2,4
"hbase-client/src/main/java/org/apache/hadoop/hbase/filter/CompareFilter.java",0,0.418994413407821,5,4,9
"hbase-client/src/main/java/org/apache/hadoop/hbase/filter/DependentColumnFilter.java",0,0.4,5,4,9
"hbase-client/src/main/java/org/apache/hadoop/hbase/filter/FamilyFilter.java",0,0.961240310077519,2,1,3
"hbase-client/src/main/java/org/apache/hadoop/hbase/filter/Filter.java",0,0.513513513513513,3,3,6
"hbase-client/src/main/java/org/apache/hadoop/hbase/filter/FilterBase.java",0,0.607734806629834,3,3,6
"hbase-client/src/main/java/org/apache/hadoop/hbase/filter/FilterList.java",0,0.630952380952381,4,4,8
"hbase-client/src/main/java/org/apache/hadoop/hbase/filter/FilterWrapper.java",0,0.619354838709677,1,2,3
"hbase-client/src/main/java/org/apache/hadoop/hbase/filter/FirstKeyOnlyFilter.java",0,0.415929203539823,2,3,5
"hbase-client/src/main/java/org/apache/hadoop/hbase/filter/FirstKeyValueMatchingQualifiersFilter.java",0,0.548387096774194,0,3,3
"hbase-client/src/main/java/org/apache/hadoop/hbase/filter/FuzzyRowFilter.java",0,0.807228915662651,1,2,3
"hbase-client/src/main/java/org/apache/hadoop/hbase/filter/InclusiveStopFilter.java",0,0.428571428571429,3,3,6
"hbase-client/src/main/java/org/apache/hadoop/hbase/filter/IncompatibleFilterException.java",0,0.477272727272727,0,3,3
"hbase-client/src/main/java/org/apache/hadoop/hbase/filter/InvalidRowFilterException.java",0,0.711111111111111,0,2,2
"hbase-client/src/main/java/org/apache/hadoop/hbase/filter/KeyOnlyFilter.java",0,0.465346534653465,3,3,6
"hbase-client/src/main/java/org/apache/hadoop/hbase/filter/MultipleColumnPrefixFilter.java",0,0.853535353535353,1,2,3
"hbase-client/src/main/java/org/apache/hadoop/hbase/filter/NullComparator.java",0,0.561224489795918,3,2,5
"hbase-client/src/main/java/org/apache/hadoop/hbase/filter/PageFilter.java",0,0.435483870967742,5,2,7
"hbase-client/src/main/java/org/apache/hadoop/hbase/filter/ParseConstants.java",0,0.992395437262357,1,1,2
"hbase-client/src/main/java/org/apache/hadoop/hbase/filter/ParseFilter.java",0,0.984971098265896,2,1,3
"hbase-client/src/main/java/org/apache/hadoop/hbase/filter/PrefixFilter.java",0,0.487603305785124,3,3,6
"hbase-client/src/main/java/org/apache/hadoop/hbase/filter/QualifierFilter.java",0,0.5078125,3,2,5
"hbase-client/src/main/java/org/apache/hadoop/hbase/filter/RandomRowFilter.java",0,0.664429530201342,2,2,4
"hbase-client/src/main/java/org/apache/hadoop/hbase/filter/RegexStringComparator.java",0,0.476744186046512,5,3,8
"hbase-client/src/main/java/org/apache/hadoop/hbase/filter/RowFilter.java",0,0.475524475524476,2,2,4
"hbase-client/src/main/java/org/apache/hadoop/hbase/filter/SingleColumnValueExcludeFilter.java",0,0.856353591160221,2,2,4
"hbase-client/src/main/java/org/apache/hadoop/hbase/filter/SingleColumnValueFilter.java",0,0.445876288659794,6,4,10
"hbase-client/src/main/java/org/apache/hadoop/hbase/filter/SkipFilter.java",0,0.445945945945946,5,3,8
"hbase-client/src/main/java/org/apache/hadoop/hbase/filter/SubstringComparator.java",0,0.513513513513513,5,2,7
"hbase-client/src/main/java/org/apache/hadoop/hbase/filter/TimestampsFilter.java",0,0.442528735632184,2,3,5
"hbase-client/src/main/java/org/apache/hadoop/hbase/filter/ValueFilter.java",0,0.806451612903226,2,2,4
"hbase-client/src/main/java/org/apache/hadoop/hbase/filter/WhileMatchFilter.java",0,0.503311258278146,5,2,7
"hbase-client/src/main/java/org/apache/hadoop/hbase/filter/package-info.java",0,0.911764705882353,0,2,2
"hbase-client/src/main/java/org/apache/hadoop/hbase/ipc/BadAuthException.java",0,0.59375,0,2,2
"hbase-client/src/main/java/org/apache/hadoop/hbase/ipc/BlockingRpcCallback.java",0,0.986301369863014,1,1,2
"hbase-client/src/main/java/org/apache/hadoop/hbase/ipc/CallerDisconnectedException.java",0,0.9375,2,1,3
"hbase-client/src/main/java/org/apache/hadoop/hbase/ipc/CoprocessorRpcChannel.java",0,0.826666666666667,0,3,3
"hbase-client/src/main/java/org/apache/hadoop/hbase/ipc/FatalConnectionException.java",0,0.976190476190476,1,1,2
"hbase-client/src/main/java/org/apache/hadoop/hbase/ipc/IPCUtil.java",0,0.935943060498221,0,2,2
"hbase-client/src/main/java/org/apache/hadoop/hbase/ipc/MasterCoprocessorRpcChannel.java",0,0.938271604938272,2,1,3
"hbase-client/src/main/java/org/apache/hadoop/hbase/ipc/PayloadCarryingRpcController.java",0,1,0,1,1
"hbase-client/src/main/java/org/apache/hadoop/hbase/ipc/RegionCoprocessorRpcChannel.java",0,0.798165137614679,0,4,4
"hbase-client/src/main/java/org/apache/hadoop/hbase/ipc/RemoteWithExtrasException.java",0,0.985294117647059,1,1,2
"hbase-client/src/main/java/org/apache/hadoop/hbase/ipc/RpcClient.java",0,0.766410408042578,8,2,10
"hbase-client/src/main/java/org/apache/hadoop/hbase/ipc/ServerNotRunningYetException.java",0,0.71875,1,4,5
"hbase-client/src/main/java/org/apache/hadoop/hbase/ipc/ServerRpcController.java",0,1,0,1,1
"hbase-client/src/main/java/org/apache/hadoop/hbase/ipc/StoppedRpcClientException.java",0,0.633333333333333,0,2,2
"hbase-client/src/main/java/org/apache/hadoop/hbase/ipc/UnsupportedCellCodecException.java",0,0.59375,0,2,2
"hbase-client/src/main/java/org/apache/hadoop/hbase/ipc/UnsupportedCompressionCodecException.java",0,0.59375,0,2,2
"hbase-client/src/main/java/org/apache/hadoop/hbase/ipc/WrongVersionException.java",0,0.59375,0,2,2
"hbase-client/src/main/java/org/apache/hadoop/hbase/master/RegionState.java",0,0.947368421052632,2,1,3
"hbase-client/src/main/java/org/apache/hadoop/hbase/protobuf/ProtobufUtil.java",0,0.770678336980306,15,2,17
"hbase-client/src/main/java/org/apache/hadoop/hbase/protobuf/RequestConverter.java",0,0.823446327683616,7,3,10
"hbase-client/src/main/java/org/apache/hadoop/hbase/protobuf/ResponseConverter.java",0,0.811501597444089,2,3,5
"hbase-client/src/main/java/org/apache/hadoop/hbase/regionserver/BloomType.java",0,1,0,1,1
"hbase-client/src/main/java/org/apache/hadoop/hbase/regionserver/LeaseException.java",0,0.790697674418605,1,2,3
"hbase-client/src/main/java/org/apache/hadoop/hbase/regionserver/NoSuchColumnFamilyException.java",0,0.857142857142857,2,2,4
"hbase-client/src/main/java/org/apache/hadoop/hbase/regionserver/RegionAlreadyInTransitionException.java",0,0.692307692307692,1,4,5
"hbase-client/src/main/java/org/apache/hadoop/hbase/regionserver/RegionOpeningState.java",0,1,0,1,1
"hbase-client/src/main/java/org/apache/hadoop/hbase/regionserver/RegionServerRunningException.java",0,0.934782608695652,2,1,3
"hbase-client/src/main/java/org/apache/hadoop/hbase/regionserver/RegionServerStoppedException.java",0,0.852941176470588,1,2,3
"hbase-client/src/main/java/org/apache/hadoop/hbase/regionserver/WrongRegionException.java",0,0.934782608695652,2,1,3
"hbase-client/src/main/java/org/apache/hadoop/hbase/regionserver/wal/FailedLogCloseException.java",0,0.804347826086957,3,2,5
"hbase-client/src/main/java/org/apache/hadoop/hbase/replication/ReplicationFactory.java",0,1,0,1,1
"hbase-client/src/main/java/org/apache/hadoop/hbase/replication/ReplicationListener.java",0,1,0,1,1
"hbase-client/src/main/java/org/apache/hadoop/hbase/replication/ReplicationPeer.java",0,0.760869565217391,1,3,4
"hbase-client/src/main/java/org/apache/hadoop/hbase/replication/ReplicationPeers.java",0,0.905063291139241,0,2,2
"hbase-client/src/main/java/org/apache/hadoop/hbase/replication/ReplicationPeersZKImpl.java",0,1,0,1,1
"hbase-client/src/main/java/org/apache/hadoop/hbase/replication/ReplicationQueueInfo.java",0,1,0,1,1
"hbase-client/src/main/java/org/apache/hadoop/hbase/replication/ReplicationQueues.java",0,0.981981981981982,1,1,2
"hbase-client/src/main/java/org/apache/hadoop/hbase/replication/ReplicationQueuesClient.java",0,1,0,1,1
"hbase-client/src/main/java/org/apache/hadoop/hbase/replication/ReplicationQueuesClientZKImpl.java",0,1,0,1,1
"hbase-client/src/main/java/org/apache/hadoop/hbase/replication/ReplicationQueuesZKImpl.java",0,0.885856079404467,1,2,3
"hbase-client/src/main/java/org/apache/hadoop/hbase/replication/ReplicationStateZKBase.java",0,0.781818181818182,0,2,2
"hbase-client/src/main/java/org/apache/hadoop/hbase/replication/ReplicationTracker.java",0,1,0,1,1
"hbase-client/src/main/java/org/apache/hadoop/hbase/replication/ReplicationTrackerZKImpl.java",0,1,0,1,1
"hbase-client/src/main/java/org/apache/hadoop/hbase/security/AccessDeniedException.java",0,0.55,0,3,3
"hbase-client/src/main/java/org/apache/hadoop/hbase/security/AuthMethod.java",0,0.985294117647059,1,1,2
"hbase-client/src/main/java/org/apache/hadoop/hbase/security/HBaseSaslRpcClient.java",0,0.886925795053004,1,2,3
"hbase-client/src/main/java/org/apache/hadoop/hbase/security/SaslStatus.java",0,0.733333333333333,0,2,2
"hbase-client/src/main/java/org/apache/hadoop/hbase/security/SaslUtil.java",0,0.4375,0,3,3
"hbase-client/src/main/java/org/apache/hadoop/hbase/security/SecureBulkLoadUtil.java",0,0.675,1,2,3
"hbase-client/src/main/java/org/apache/hadoop/hbase/security/SecurityInfo.java",0,1,0,1,1
"hbase-client/src/main/java/org/apache/hadoop/hbase/security/User.java",0,0.612293144208038,2,2,4
"hbase-client/src/main/java/org/apache/hadoop/hbase/security/access/Permission.java",0,0.989949748743719,1,1,2
"hbase-client/src/main/java/org/apache/hadoop/hbase/security/access/TablePermission.java",0,0.651551312649165,0,2,2
"hbase-client/src/main/java/org/apache/hadoop/hbase/security/access/UserPermission.java",0,0.668316831683168,0,3,3
"hbase-client/src/main/java/org/apache/hadoop/hbase/security/token/AuthenticationTokenIdentifier.java",0,0.978260869565217,1,1,2
"hbase-client/src/main/java/org/apache/hadoop/hbase/security/token/AuthenticationTokenSelector.java",0,0.962962962962963,1,1,2
"hbase-client/src/main/java/org/apache/hadoop/hbase/snapshot/ClientSnapshotDescriptionUtils.java",0,0.8,0,2,2
"hbase-client/src/main/java/org/apache/hadoop/hbase/snapshot/CorruptedSnapshotException.java",0,0.982142857142857,1,1,2
"hbase-client/src/main/java/org/apache/hadoop/hbase/snapshot/ExportSnapshotException.java",0,0.976744186046512,1,1,2
"hbase-client/src/main/java/org/apache/hadoop/hbase/snapshot/HBaseSnapshotException.java",0,0.961038961038961,2,1,3
"hbase-client/src/main/java/org/apache/hadoop/hbase/snapshot/RestoreSnapshotException.java",0,0.976744186046512,1,1,2
"hbase-client/src/main/java/org/apache/hadoop/hbase/snapshot/SnapshotCreationException.java",0,0.945454545454545,0,2,2
"hbase-client/src/main/java/org/apache/hadoop/hbase/snapshot/SnapshotDoesNotExistException.java",0,0.977777777777778,1,1,2
"hbase-client/src/main/java/org/apache/hadoop/hbase/snapshot/SnapshotExistsException.java",0,0.975,1,1,2
"hbase-client/src/main/java/org/apache/hadoop/hbase/snapshot/TablePartiallyOpenException.java",0,0.76271186440678,3,2,5
"hbase-client/src/main/java/org/apache/hadoop/hbase/snapshot/UnknownSnapshotException.java",0,0.976190476190476,1,1,2
"hbase-client/src/main/java/org/apache/hadoop/hbase/util/FileSystemVersionException.java",0,0.976744186046512,1,1,2
"hbase-client/src/main/java/org/apache/hadoop/hbase/util/HasThread.java",0,0.98,1,1,2
"hbase-client/src/main/java/org/apache/hadoop/hbase/util/PoolMap.java",0,0.944567627494457,3,1,4
"hbase-client/src/main/java/org/apache/hadoop/hbase/util/Sleeper.java",0,0.914529914529915,2,2,4
"hbase-client/src/main/java/org/apache/hadoop/hbase/util/Writables.java",0,0.850299401197605,1,3,4
"hbase-client/src/main/java/org/apache/hadoop/hbase/zookeeper/EmptyWatcher.java",0,0.735294117647059,2,3,5
"hbase-client/src/main/java/org/apache/hadoop/hbase/zookeeper/HQuorumPeer.java",0,0.368098159509202,1,5,6
"hbase-client/src/main/java/org/apache/hadoop/hbase/zookeeper/MasterAddressTracker.java",0,0.972677595628415,1,1,2
"hbase-client/src/main/java/org/apache/hadoop/hbase/zookeeper/MetaRegionTracker.java",0,0.880208333333333,0,3,3
"hbase-client/src/main/java/org/apache/hadoop/hbase/zookeeper/RecoverableZooKeeper.java",0,0.426630434782609,5,4,9
"hbase-client/src/main/java/org/apache/hadoop/hbase/zookeeper/ZKAssign.java",0,0.65028901734104,5,3,8
"hbase-client/src/main/java/org/apache/hadoop/hbase/zookeeper/ZKClusterId.java",0,0.695652173913043,1,3,4
"hbase-client/src/main/java/org/apache/hadoop/hbase/zookeeper/ZKConfig.java",0,0.929368029739777,5,1,6
"hbase-client/src/main/java/org/apache/hadoop/hbase/zookeeper/ZKLeaderManager.java",0,0.939226519337017,2,1,3
"hbase-client/src/main/java/org/apache/hadoop/hbase/zookeeper/ZKTable.java",0,0.647208121827411,2,4,6
"hbase-client/src/main/java/org/apache/hadoop/hbase/zookeeper/ZKTableReadOnly.java",0,0.774390243902439,1,3,4
"hbase-client/src/main/java/org/apache/hadoop/hbase/zookeeper/ZKUtil.java",0,0.657784743991641,11,2,13
"hbase-client/src/main/java/org/apache/hadoop/hbase/zookeeper/ZooKeeperListener.java",0,0.975609756097561,1,1,2
"hbase-client/src/main/java/org/apache/hadoop/hbase/zookeeper/ZooKeeperNodeTracker.java",0,0.807228915662651,0,2,2
"hbase-client/src/main/java/org/apache/hadoop/hbase/zookeeper/ZooKeeperWatcher.java",0,0.737574552683897,12,2,14
"hbase-client/src/test/java/org/apache/hadoop/hbase/client/TestAsyncProcess.java",0,0.948031496062992,2,1,3
"hbase-client/src/test/java/org/apache/hadoop/hbase/client/TestAttributes.java",0,0.982035928143713,1,1,2
"hbase-client/src/test/java/org/apache/hadoop/hbase/client/TestClientNoCluster.java",0,0.979933110367893,2,1,3
"hbase-client/src/test/java/org/apache/hadoop/hbase/client/TestGet.java",0,0.542682926829268,1,3,4
"hbase-client/src/test/java/org/apache/hadoop/hbase/client/TestIncrement.java",0,1,0,1,1
"hbase-client/src/test/java/org/apache/hadoop/hbase/client/TestOperation.java",0,0.637096774193548,1,2,3
"hbase-client/src/test/java/org/apache/hadoop/hbase/client/TestPutDotHas.java",0,1,0,1,1
"hbase-client/src/test/java/org/apache/hadoop/hbase/client/TestPutWriteToWal.java",0,1,0,1,1
"hbase-client/src/test/java/org/apache/hadoop/hbase/client/TestScan.java",0,0.891891891891892,1,2,3
"hbase-client/src/test/java/org/apache/hadoop/hbase/client/TestSnapshotFromAdmin.java",0,0.891566265060241,2,2,4
"hbase-client/src/test/java/org/apache/hadoop/hbase/ipc/TestIPCUtil.java",0,1,0,1,1
"hbase-client/src/test/java/org/apache/hadoop/hbase/ipc/TestPayloadCarryingRpcController.java",0,0.906735751295337,0,2,2
"hbase-common/src/main/java/org/apache/hadoop/hbase/Cell.java",0,1,0,1,1
"hbase-common/src/main/java/org/apache/hadoop/hbase/CellComparator.java",0,0.813953488372093,0,3,3
"hbase-common/src/main/java/org/apache/hadoop/hbase/CellScannable.java",0,1,0,1,1
"hbase-common/src/main/java/org/apache/hadoop/hbase/CellScanner.java",0,1,0,1,1
"hbase-common/src/main/java/org/apache/hadoop/hbase/CellUtil.java",0,0.989510489510489,1,1,2
"hbase-common/src/main/java/org/apache/hadoop/hbase/CompoundConfiguration.java",0,0.474056603773585,1,4,5
"hbase-common/src/main/java/org/apache/hadoop/hbase/HBaseConfiguration.java",0,0.46031746031746,2,7,9
"hbase-common/src/main/java/org/apache/hadoop/hbase/HBaseIOException.java",0,0.9375,2,1,3
"hbase-common/src/main/java/org/apache/hadoop/hbase/HConstants.java",0,0.361014994232987,16,4,20
"hbase-common/src/main/java/org/apache/hadoop/hbase/KeyValue.java",0,0.44323374340949,10,4,14
"hbase-common/src/main/java/org/apache/hadoop/hbase/KeyValueTestUtil.java",0,0.887700534759358,0,2,2
"hbase-common/src/main/java/org/apache/hadoop/hbase/KeyValueUtil.java",0,0.990291262135922,1,1,2
"hbase-common/src/main/java/org/apache/hadoop/hbase/NamespaceDescriptor.java",0,1,0,1,1
"hbase-common/src/main/java/org/apache/hadoop/hbase/TableName.java",0,1,0,1,1
"hbase-common/src/main/java/org/apache/hadoop/hbase/VersionAnnotation.java",0,1,0,1,1
"hbase-common/src/main/java/org/apache/hadoop/hbase/codec/BaseDecoder.java",0,0.675324675324675,0,2,2
"hbase-common/src/main/java/org/apache/hadoop/hbase/codec/BaseEncoder.java",0,1,0,1,1
"hbase-common/src/main/java/org/apache/hadoop/hbase/codec/CellCodec.java",0,1,0,1,1
"hbase-common/src/main/java/org/apache/hadoop/hbase/codec/Codec.java",0,1,0,1,1
"hbase-common/src/main/java/org/apache/hadoop/hbase/codec/CodecException.java",0,1,0,1,1
"hbase-common/src/main/java/org/apache/hadoop/hbase/codec/KeyValueCodec.java",0,0.951219512195122,1,1,2
"hbase-common/src/main/java/org/apache/hadoop/hbase/io/ByteBufferOutputStream.java",0,0.941605839416058,0,2,2
"hbase-common/src/main/java/org/apache/hadoop/hbase/io/CellOutputStream.java",0,0.945454545454545,0,2,2
"hbase-common/src/main/java/org/apache/hadoop/hbase/io/HeapSize.java",0,0.755102040816326,0,2,2
"hbase-common/src/main/java/org/apache/hadoop/hbase/io/ImmutableBytesWritable.java",0,0.477941176470588,3,3,6
"hbase-common/src/main/java/org/apache/hadoop/hbase/io/SizedCellScanner.java",0,1,0,1,1
"hbase-common/src/main/java/org/apache/hadoop/hbase/io/TimeRange.java",0,0.754098360655738,0,3,3
"hbase-common/src/main/java/org/apache/hadoop/hbase/io/compress/Compression.java",0,0.599552572706935,3,4,7
"hbase-common/src/main/java/org/apache/hadoop/hbase/io/compress/ReusableStreamGzipCodec.java",0,0.683937823834197,2,2,4
"hbase-common/src/main/java/org/apache/hadoop/hbase/io/encoding/BufferedDataBlockEncoder.java",0,0.936,2,2,4
"hbase-common/src/main/java/org/apache/hadoop/hbase/io/encoding/CompressionState.java",0,0.983050847457627,1,1,2
"hbase-common/src/main/java/org/apache/hadoop/hbase/io/encoding/CopyKeyDataBlockEncoder.java",0,0.979591836734694,1,1,2
"hbase-common/src/main/java/org/apache/hadoop/hbase/io/encoding/DataBlockEncoder.java",0,0.836538461538462,1,2,3
"hbase-common/src/main/java/org/apache/hadoop/hbase/io/encoding/DataBlockEncoding.java",0,0.854922279792746,0,3,3
"hbase-common/src/main/java/org/apache/hadoop/hbase/io/encoding/DiffKeyDeltaEncoder.java",0,0.990925589836661,1,1,2
"hbase-common/src/main/java/org/apache/hadoop/hbase/io/encoding/EncodedDataBlock.java",0,0.958139534883721,4,1,5
"hbase-common/src/main/java/org/apache/hadoop/hbase/io/encoding/EncoderBufferTooSmallException.java",0,0.903225806451613,0,2,2
"hbase-common/src/main/java/org/apache/hadoop/hbase/io/encoding/FastDiffDeltaEncoder.java",0,0.994515539305302,1,1,2
"hbase-common/src/main/java/org/apache/hadoop/hbase/io/encoding/HFileBlockDecodingContext.java",0,0.706896551724138,1,2,3
"hbase-common/src/main/java/org/apache/hadoop/hbase/io/encoding/HFileBlockDefaultDecodingContext.java",0,0.836065573770492,1,2,3
"hbase-common/src/main/java/org/apache/hadoop/hbase/io/encoding/HFileBlockDefaultEncodingContext.java",0,0.917948717948718,2,2,4
"hbase-common/src/main/java/org/apache/hadoop/hbase/io/encoding/HFileBlockEncodingContext.java",0,0.813953488372093,2,2,4
"hbase-common/src/main/java/org/apache/hadoop/hbase/io/encoding/PrefixKeyDeltaEncoder.java",0,0.984771573604061,1,1,2
"hbase-common/src/main/java/org/apache/hadoop/hbase/io/hfile/BlockType.java",0,0.694063926940639,1,3,4
"hbase-common/src/main/java/org/apache/hadoop/hbase/types/DataType.java",0,1,0,1,1
"hbase-common/src/main/java/org/apache/hadoop/hbase/types/FixedLengthWrapper.java",0,1,0,1,1
"hbase-common/src/main/java/org/apache/hadoop/hbase/types/OrderedBlob.java",0,1,0,1,1
"hbase-common/src/main/java/org/apache/hadoop/hbase/types/OrderedBlobVar.java",0,1,0,1,1
"hbase-common/src/main/java/org/apache/hadoop/hbase/types/OrderedBytesBase.java",0,1,0,1,1
"hbase-common/src/main/java/org/apache/hadoop/hbase/types/OrderedFloat32.java",0,1,0,1,1
"hbase-common/src/main/java/org/apache/hadoop/hbase/types/OrderedFloat64.java",0,1,0,1,1
"hbase-common/src/main/java/org/apache/hadoop/hbase/types/OrderedInt32.java",0,1,0,1,1
"hbase-common/src/main/java/org/apache/hadoop/hbase/types/OrderedInt64.java",0,1,0,1,1
"hbase-common/src/main/java/org/apache/hadoop/hbase/types/OrderedNumeric.java",0,1,0,1,1
"hbase-common/src/main/java/org/apache/hadoop/hbase/types/OrderedString.java",0,1,0,1,1
"hbase-common/src/main/java/org/apache/hadoop/hbase/types/RawBytes.java",0,1,0,1,1
"hbase-common/src/main/java/org/apache/hadoop/hbase/types/RawBytesFixedLength.java",0,1,0,1,1
"hbase-common/src/main/java/org/apache/hadoop/hbase/types/RawBytesTerminated.java",0,1,0,1,1
"hbase-common/src/main/java/org/apache/hadoop/hbase/types/RawDouble.java",0,1,0,1,1
"hbase-common/src/main/java/org/apache/hadoop/hbase/types/RawFloat.java",0,1,0,1,1
"hbase-common/src/main/java/org/apache/hadoop/hbase/types/RawInteger.java",0,1,0,1,1
"hbase-common/src/main/java/org/apache/hadoop/hbase/types/RawLong.java",0,1,0,1,1
"hbase-common/src/main/java/org/apache/hadoop/hbase/types/RawString.java",0,1,0,1,1
"hbase-common/src/main/java/org/apache/hadoop/hbase/types/RawStringFixedLength.java",0,1,0,1,1
"hbase-common/src/main/java/org/apache/hadoop/hbase/types/RawStringTerminated.java",0,1,0,1,1
"hbase-common/src/main/java/org/apache/hadoop/hbase/types/Struct.java",0,1,0,1,1
"hbase-common/src/main/java/org/apache/hadoop/hbase/types/StructBuilder.java",0,1,0,1,1
"hbase-common/src/main/java/org/apache/hadoop/hbase/types/StructIterator.java",0,1,0,1,1
"hbase-common/src/main/java/org/apache/hadoop/hbase/types/TerminatedWrapper.java",0,1,0,1,1
"hbase-common/src/main/java/org/apache/hadoop/hbase/types/Union2.java",0,1,0,1,1
"hbase-common/src/main/java/org/apache/hadoop/hbase/types/Union3.java",0,1,0,1,1
"hbase-common/src/main/java/org/apache/hadoop/hbase/types/Union4.java",0,1,0,1,1
"hbase-common/src/main/java/org/apache/hadoop/hbase/types/package-info.java",0,1,0,1,1
"hbase-common/src/main/java/org/apache/hadoop/hbase/util/Addressing.java",0,1,0,1,1
"hbase-common/src/main/java/org/apache/hadoop/hbase/util/ArrayUtils.java",0,1,0,1,1
"hbase-common/src/main/java/org/apache/hadoop/hbase/util/Base64.java",0,0.903402187120292,1,2,3
"hbase-common/src/main/java/org/apache/hadoop/hbase/util/ByteBufferArray.java",0,1,0,1,1
"hbase-common/src/main/java/org/apache/hadoop/hbase/util/ByteBufferUtils.java",0,0.914660831509847,0,2,2
"hbase-common/src/main/java/org/apache/hadoop/hbase/util/ByteRange.java",0,0.695121951219512,0,2,2
"hbase-common/src/main/java/org/apache/hadoop/hbase/util/ByteRangeUtils.java",0,0.609756097560976,0,3,3
"hbase-common/src/main/java/org/apache/hadoop/hbase/util/Bytes.java",0,0.566787003610108,7,4,11
"hbase-common/src/main/java/org/apache/hadoop/hbase/util/ClassLoaderBase.java",0,1,0,1,1
"hbase-common/src/main/java/org/apache/hadoop/hbase/util/ClassSize.java",0,0.6,2,3,5
"hbase-common/src/main/java/org/apache/hadoop/hbase/util/Classes.java",0,0.939759036144578,0,2,2
"hbase-common/src/main/java/org/apache/hadoop/hbase/util/CollectionUtils.java",0,1,0,1,1
"hbase-common/src/main/java/org/apache/hadoop/hbase/util/CoprocessorClassLoader.java",0,1,0,1,1
"hbase-common/src/main/java/org/apache/hadoop/hbase/util/DefaultEnvironmentEdge.java",0,0.878048780487805,0,2,2
"hbase-common/src/main/java/org/apache/hadoop/hbase/util/DrainBarrier.java",0,1,0,1,1
"hbase-common/src/main/java/org/apache/hadoop/hbase/util/DynamicClassLoader.java",0,1,0,1,1
"hbase-common/src/main/java/org/apache/hadoop/hbase/util/EnvironmentEdge.java",0,0.875,0,2,2
"hbase-common/src/main/java/org/apache/hadoop/hbase/util/EnvironmentEdgeManager.java",0,0.911392405063291,1,2,3
"hbase-common/src/main/java/org/apache/hadoop/hbase/util/Hash.java",0,0.978102189781022,2,1,3
"hbase-common/src/main/java/org/apache/hadoop/hbase/util/IncrementingEnvironmentEdge.java",0,0.578125,1,2,3
"hbase-common/src/main/java/org/apache/hadoop/hbase/util/IterableUtils.java",0,0.560975609756098,1,2,3
"hbase-common/src/main/java/org/apache/hadoop/hbase/util/JVM.java",0,0.562015503875969,0,3,3
"hbase-common/src/main/java/org/apache/hadoop/hbase/util/JenkinsHash.java",0,0.609195402298851,1,2,3
"hbase-common/src/main/java/org/apache/hadoop/hbase/util/KeyLocker.java",0,0.819548872180451,0,2,2
"hbase-common/src/main/java/org/apache/hadoop/hbase/util/MD5Hash.java",0,1,0,1,1
"hbase-common/src/main/java/org/apache/hadoop/hbase/util/Methods.java",0,0.942028985507246,0,2,2
"hbase-common/src/main/java/org/apache/hadoop/hbase/util/MurmurHash.java",0,0.978260869565217,1,1,2
"hbase-common/src/main/java/org/apache/hadoop/hbase/util/Order.java",0,1,0,1,1
"hbase-common/src/main/java/org/apache/hadoop/hbase/util/OrderedBytes.java",0,1,0,1,1
"hbase-common/src/main/java/org/apache/hadoop/hbase/util/Pair.java",0,0.614814814814815,0,4,4
"hbase-common/src/main/java/org/apache/hadoop/hbase/util/PairOfSameType.java",0,1,0,1,1
"hbase-common/src/main/java/org/apache/hadoop/hbase/util/PositionedByteRange.java",0,1,0,1,1
"hbase-common/src/main/java/org/apache/hadoop/hbase/util/ReflectionUtils.java",0,1,0,1,1
"hbase-common/src/main/java/org/apache/hadoop/hbase/util/RetryCounter.java",0,0.811594202898551,1,2,3
"hbase-common/src/main/java/org/apache/hadoop/hbase/util/RetryCounterFactory.java",0,1,0,1,1
"hbase-common/src/main/java/org/apache/hadoop/hbase/util/SimpleByteRange.java",0,1,0,1,1
"hbase-common/src/main/java/org/apache/hadoop/hbase/util/SimplePositionedByteRange.java",0,1,0,1,1
"hbase-common/src/main/java/org/apache/hadoop/hbase/util/SoftValueSortedMap.java",0,0.418685121107266,3,4,7
"hbase-common/src/main/java/org/apache/hadoop/hbase/util/Strings.java",0,0.991379310344828,1,1,2
"hbase-common/src/main/java/org/apache/hadoop/hbase/util/Threads.java",0,0.895582329317269,2,2,4
"hbase-common/src/main/java/org/apache/hadoop/hbase/util/Triple.java",0,1,0,1,1
"hbase-common/src/main/java/org/apache/hadoop/hbase/util/VersionInfo.java",0,0.793103448275862,2,2,4
"hbase-common/src/main/java/org/apache/hadoop/hbase/util/test/LoadTestDataGenerator.java",0,0.917525773195876,0,2,2
"hbase-common/src/main/java/org/apache/hadoop/hbase/util/test/LoadTestKVGenerator.java",0,0.761904761904762,2,2,4
"hbase-common/src/main/java/org/apache/hadoop/hbase/util/test/RedundantKVGenerator.java",0,0.669191919191919,2,2,4
"hbase-common/src/test/java/org/apache/hadoop/hbase/ClassFinder.java",0,1,0,1,1
"hbase-common/src/test/java/org/apache/hadoop/hbase/ClassTestFinder.java",0,1,0,1,1
"hbase-common/src/test/java/org/apache/hadoop/hbase/HBaseCommonTestingUtility.java",0,0.980769230769231,2,1,3
"hbase-common/src/test/java/org/apache/hadoop/hbase/IntegrationTests.java",0,1,0,1,1
"hbase-common/src/test/java/org/apache/hadoop/hbase/LargeTests.java",0,0.973684210526316,1,1,2
"hbase-common/src/test/java/org/apache/hadoop/hbase/MediumTests.java",0,0.972972972972973,1,1,2
"hbase-common/src/test/java/org/apache/hadoop/hbase/ResourceChecker.java",0,0.904109589041096,0,2,2
"hbase-common/src/test/java/org/apache/hadoop/hbase/ResourceCheckerJUnitListener.java",0,0.737967914438503,1,2,3
"hbase-common/src/test/java/org/apache/hadoop/hbase/SmallTests.java",0,0.970588235294118,1,1,2
"hbase-common/src/test/java/org/apache/hadoop/hbase/TestClassFinder.java",0,0.94300518134715,0,2,2
"hbase-common/src/test/java/org/apache/hadoop/hbase/TestCompoundConfiguration.java",0,0.458149779735683,0,4,4
"hbase-common/src/test/java/org/apache/hadoop/hbase/TestHBaseConfiguration.java",0,1,0,1,1
"hbase-common/src/test/java/org/apache/hadoop/hbase/TestKeyValue.java",0,0.502879078694818,4,4,8
"hbase-common/src/test/java/org/apache/hadoop/hbase/Waiter.java",0,0.990196078431373,1,1,2
"hbase-common/src/test/java/org/apache/hadoop/hbase/codec/TestCellCodec.java",0,1,0,1,1
"hbase-common/src/test/java/org/apache/hadoop/hbase/codec/TestKeyValueCodec.java",0,1,0,1,1
"hbase-common/src/test/java/org/apache/hadoop/hbase/types/TestFixedLengthWrapper.java",0,1,0,1,1
"hbase-common/src/test/java/org/apache/hadoop/hbase/types/TestOrderedBlob.java",0,1,0,1,1
"hbase-common/src/test/java/org/apache/hadoop/hbase/types/TestOrderedBlobVar.java",0,1,0,1,1
"hbase-common/src/test/java/org/apache/hadoop/hbase/types/TestOrderedString.java",0,1,0,1,1
"hbase-common/src/test/java/org/apache/hadoop/hbase/types/TestRawString.java",0,1,0,1,1
"hbase-common/src/test/java/org/apache/hadoop/hbase/types/TestStruct.java",0,0.955380577427822,1,1,2
"hbase-common/src/test/java/org/apache/hadoop/hbase/types/TestTerminatedWrapper.java",0,1,0,1,1
"hbase-common/src/test/java/org/apache/hadoop/hbase/types/TestUnion2.java",0,1,0,1,1
"hbase-common/src/test/java/org/apache/hadoop/hbase/util/ClassLoaderTestHelper.java",0,1,0,1,1
"hbase-common/src/test/java/org/apache/hadoop/hbase/util/EnvironmentEdgeManagerTestHelper.java",0,1,0,1,1
"hbase-common/src/test/java/org/apache/hadoop/hbase/util/TestBase64.java",0,0.915492957746479,2,1,3
"hbase-common/src/test/java/org/apache/hadoop/hbase/util/TestBytes.java",0,0.524625267665953,3,5,8
"hbase-common/src/test/java/org/apache/hadoop/hbase/util/TestCoprocessorClassLoader.java",0,1,0,1,1
"hbase-common/src/test/java/org/apache/hadoop/hbase/util/TestDrainBarrier.java",0,1,0,1,1
"hbase-common/src/test/java/org/apache/hadoop/hbase/util/TestDynamicClassLoader.java",0,1,0,1,1
"hbase-common/src/test/java/org/apache/hadoop/hbase/util/TestEnvironmentEdgeManager.java",0,0.911764705882353,3,1,4
"hbase-common/src/test/java/org/apache/hadoop/hbase/util/TestKeyLocker.java",0,1,0,1,1
"hbase-common/src/test/java/org/apache/hadoop/hbase/util/TestLoadTestKVGenerator.java",0,0.828947368421053,2,3,5
"hbase-common/src/test/java/org/apache/hadoop/hbase/util/TestOrder.java",0,1,0,1,1
"hbase-common/src/test/java/org/apache/hadoop/hbase/util/TestOrderedBytes.java",0,1,0,1,1
"hbase-common/src/test/java/org/apache/hadoop/hbase/util/TestPositionedByteRange.java",0,1,0,1,1
"hbase-common/src/test/java/org/apache/hadoop/hbase/util/TestSimpleByteRange.java",0,0.816901408450704,0,2,2
"hbase-common/src/test/java/org/apache/hadoop/hbase/util/TestThreads.java",0,0.746835443037975,0,2,2
"hbase-examples/src/main/java/org/apache/hadoop/hbase/coprocessor/example/BulkDeleteEndpoint.java",0,0.979166666666667,3,1,4
"hbase-examples/src/main/java/org/apache/hadoop/hbase/coprocessor/example/RowCountEndpoint.java",0,0.99390243902439,1,1,2
"hbase-examples/src/main/java/org/apache/hadoop/hbase/coprocessor/example/ZooKeeperScanPolicyObserver.java",0,0.918803418803419,2,2,4
"hbase-examples/src/main/java/org/apache/hadoop/hbase/coprocessor/example/generated/BulkDeleteProtos.java",0,1,0,1,1
"hbase-examples/src/main/java/org/apache/hadoop/hbase/coprocessor/example/generated/ExampleProtos.java",0,1,0,1,1
"hbase-examples/src/main/java/org/apache/hadoop/hbase/mapreduce/IndexBuilder.java",0,0.927631578947368,3,1,4
"hbase-examples/src/main/java/org/apache/hadoop/hbase/mapreduce/SampleUploader.java",0,0.72108843537415,0,2,2
"hbase-examples/src/main/java/org/apache/hadoop/hbase/thrift/DemoClient.java",0,0.975975975975976,2,1,3
"hbase-examples/src/main/java/org/apache/hadoop/hbase/thrift2/DemoClient.java",0,0.898989898989899,0,2,2
"hbase-examples/src/test/java/org/apache/hadoop/hbase/coprocessor/example/TestBulkDeleteProtocol.java",0,0.959550561797753,1,1,2
"hbase-examples/src/test/java/org/apache/hadoop/hbase/coprocessor/example/TestRowCountEndpoint.java",0,0.963302752293578,1,1,2
"hbase-examples/src/test/java/org/apache/hadoop/hbase/coprocessor/example/TestZooKeeperScanPolicyObserver.java",0,0.937984496124031,0,2,2
"hbase-hadoop-compat/src/main/java/org/apache/hadoop/hbase/CompatibilityFactory.java",0,1,0,1,1
"hbase-hadoop-compat/src/main/java/org/apache/hadoop/hbase/CompatibilitySingletonFactory.java",0,0.5,0,3,3
"hbase-hadoop-compat/src/main/java/org/apache/hadoop/hbase/ipc/MetricsHBaseServerSource.java",0,0.638888888888889,0,2,2
"hbase-hadoop-compat/src/main/java/org/apache/hadoop/hbase/ipc/MetricsHBaseServerSourceFactory.java",0,1,0,1,1
"hbase-hadoop-compat/src/main/java/org/apache/hadoop/hbase/ipc/MetricsHBaseServerWrapper.java",0,1,0,1,1
"hbase-hadoop-compat/src/main/java/org/apache/hadoop/hbase/master/MetricsMasterSource.java",0,0.46875,1,3,4
"hbase-hadoop-compat/src/main/java/org/apache/hadoop/hbase/master/MetricsMasterSourceFactory.java",0,0.857142857142857,0,2,2
"hbase-hadoop-compat/src/main/java/org/apache/hadoop/hbase/master/MetricsMasterWrapper.java",0,0.851063829787234,0,2,2
"hbase-hadoop-compat/src/main/java/org/apache/hadoop/hbase/metrics/BaseSource.java",0,0.495652173913044,0,3,3
"hbase-hadoop-compat/src/main/java/org/apache/hadoop/hbase/metrics/MBeanSource.java",0,0.973684210526316,1,1,2
"hbase-hadoop-compat/src/main/java/org/apache/hadoop/hbase/regionserver/MetricsRegionAggregateSource.java",0,0.548387096774194,0,3,3
"hbase-hadoop-compat/src/main/java/org/apache/hadoop/hbase/regionserver/MetricsRegionServerSource.java",0,0.583333333333333,0,2,2
"hbase-hadoop-compat/src/main/java/org/apache/hadoop/hbase/regionserver/MetricsRegionServerSourceFactory.java",0,0.731707317073171,0,2,2
"hbase-hadoop-compat/src/main/java/org/apache/hadoop/hbase/regionserver/MetricsRegionServerWrapper.java",0,0.970731707317073,1,1,2
"hbase-hadoop-compat/src/main/java/org/apache/hadoop/hbase/regionserver/MetricsRegionSource.java",0,0.520547945205479,0,2,2
"hbase-hadoop-compat/src/main/java/org/apache/hadoop/hbase/regionserver/MetricsRegionWrapper.java",0,1,0,1,1
"hbase-hadoop-compat/src/main/java/org/apache/hadoop/hbase/regionserver/wal/MetricsEditsReplaySource.java",0,1,0,1,1
"hbase-hadoop-compat/src/main/java/org/apache/hadoop/hbase/regionserver/wal/MetricsWALSource.java",0,0.813953488372093,0,2,2
"hbase-hadoop-compat/src/main/java/org/apache/hadoop/hbase/replication/regionserver/MetricsReplicationSource.java",0,0.770833333333333,0,3,3
"hbase-hadoop-compat/src/main/java/org/apache/hadoop/hbase/rest/MetricsRESTSource.java",0,0.897959183673469,0,2,2
"hbase-hadoop-compat/src/main/java/org/apache/hadoop/hbase/thrift/MetricsThriftServerSource.java",0,0.961538461538462,1,1,2
"hbase-hadoop-compat/src/main/java/org/apache/hadoop/hbase/thrift/MetricsThriftServerSourceFactory.java",0,0.621621621621622,0,3,3
"hbase-hadoop-compat/src/main/java/org/apache/hadoop/metrics2/MetricHistogram.java",0,0.813953488372093,0,2,2
"hbase-hadoop-compat/src/main/java/org/apache/hadoop/metrics2/MetricsExecutor.java",0,0.9375,0,2,2
"hbase-hadoop-compat/src/test/java/org/apache/hadoop/hbase/HadoopShims.java",0,1,0,1,1
"hbase-hadoop-compat/src/test/java/org/apache/hadoop/hbase/RandomStringGenerator.java",0,1,0,1,1
"hbase-hadoop-compat/src/test/java/org/apache/hadoop/hbase/RandomStringGeneratorImpl.java",0,1,0,1,1
"hbase-hadoop-compat/src/test/java/org/apache/hadoop/hbase/TestCompatibilitySingletonFactory.java",0,1,0,1,1
"hbase-hadoop-compat/src/test/java/org/apache/hadoop/hbase/master/TestMetricsMasterSourceFactory.java",0,0.805555555555556,1,2,3
"hbase-hadoop-compat/src/test/java/org/apache/hadoop/hbase/regionserver/TestMetricsRegionServerSourceFactory.java",0,0.805555555555556,1,2,3
"hbase-hadoop-compat/src/test/java/org/apache/hadoop/hbase/regionserver/wal/TestMetricsHLogSource.java",0,1,0,1,1
"hbase-hadoop-compat/src/test/java/org/apache/hadoop/hbase/replication/regionserver/TestMetricsReplicationSourceFactory.java",0,0.857142857142857,0,2,2
"hbase-hadoop-compat/src/test/java/org/apache/hadoop/hbase/rest/TestMetricsRESTSource.java",0,0.810810810810811,0,3,3
"hbase-hadoop-compat/src/test/java/org/apache/hadoop/hbase/test/MetricsAssertHelper.java",0,0.91304347826087,0,2,2
"hbase-hadoop-compat/src/test/java/org/apache/hadoop/hbase/thrift/TestMetricsThriftServerSourceFactory.java",0,0.783783783783784,0,3,3
"hbase-hadoop1-compat/src/main/java/org/apache/hadoop/hbase/ipc/MetricsHBaseServerSourceFactoryImpl.java",0,1,0,1,1
"hbase-hadoop1-compat/src/main/java/org/apache/hadoop/hbase/ipc/MetricsHBaseServerSourceImpl.java",0,1,0,1,1
"hbase-hadoop1-compat/src/main/java/org/apache/hadoop/hbase/mapreduce/JobUtil.java",0,1,0,1,1
"hbase-hadoop1-compat/src/main/java/org/apache/hadoop/hbase/master/MetricsMasterSourceFactoryImpl.java",0,0.783783783783784,0,2,2
"hbase-hadoop1-compat/src/main/java/org/apache/hadoop/hbase/master/MetricsMasterSourceImpl.java",0,0.485549132947977,0,4,4
"hbase-hadoop1-compat/src/main/java/org/apache/hadoop/hbase/metrics/BaseSourceImpl.java",0,0.543478260869565,0,3,3
"hbase-hadoop1-compat/src/main/java/org/apache/hadoop/hbase/metrics/MBeanSourceImpl.java",0,1,0,1,1
"hbase-hadoop1-compat/src/main/java/org/apache/hadoop/hbase/regionserver/MetricsRegionAggregateSourceImpl.java",0,0.775510204081633,0,2,2
"hbase-hadoop1-compat/src/main/java/org/apache/hadoop/hbase/regionserver/MetricsRegionServerSourceFactoryImpl.java",0,1,0,1,1
"hbase-hadoop1-compat/src/main/java/org/apache/hadoop/hbase/regionserver/MetricsRegionServerSourceImpl.java",0,0.946601941747573,0,2,2
"hbase-hadoop1-compat/src/main/java/org/apache/hadoop/hbase/regionserver/MetricsRegionSourceImpl.java",0,0.96195652173913,1,1,2
"hbase-hadoop1-compat/src/main/java/org/apache/hadoop/hbase/regionserver/wal/MetricsEditsReplaySourceImpl.java",0,1,0,1,1
"hbase-hadoop1-compat/src/main/java/org/apache/hadoop/hbase/regionserver/wal/MetricsWALSourceImpl.java",0,1,0,1,1
"hbase-hadoop1-compat/src/main/java/org/apache/hadoop/hbase/replication/regionserver/MetricsReplicationSourceImpl.java",0,0.666666666666667,0,3,3
"hbase-hadoop1-compat/src/main/java/org/apache/hadoop/hbase/rest/MetricsRESTSourceImpl.java",0,0.929292929292929,0,2,2
"hbase-hadoop1-compat/src/main/java/org/apache/hadoop/hbase/thrift/MetricsThriftServerSourceFactoryImpl.java",0,0.884615384615385,0,2,2
"hbase-hadoop1-compat/src/main/java/org/apache/hadoop/hbase/thrift/MetricsThriftServerSourceImpl.java",0,0.918367346938776,0,2,2
"hbase-hadoop1-compat/src/main/java/org/apache/hadoop/metrics2/impl/JmxCacheBuster.java",0,0.961538461538462,1,1,2
"hbase-hadoop1-compat/src/main/java/org/apache/hadoop/metrics2/lib/DynamicMetricsRegistry.java",0,0.795045045045045,1,2,3
"hbase-hadoop1-compat/src/main/java/org/apache/hadoop/metrics2/lib/MetricMutableHistogram.java",0,0.991735537190083,1,1,2
"hbase-hadoop1-compat/src/main/java/org/apache/hadoop/metrics2/lib/MetricMutableQuantiles.java",0,0.985611510791367,1,1,2
"hbase-hadoop1-compat/src/main/java/org/apache/hadoop/metrics2/lib/MetricsExecutorImpl.java",0,0.984848484848485,1,1,2
"hbase-hadoop1-compat/src/main/java/org/apache/hadoop/metrics2/util/MetricQuantile.java",0,1,0,1,1
"hbase-hadoop1-compat/src/main/java/org/apache/hadoop/metrics2/util/MetricSampleQuantiles.java",0,1,0,1,1
"hbase-hadoop1-compat/src/test/java/org/apache/hadoop/hbase/HadoopShimsImpl.java",0,1,0,1,1
"hbase-hadoop1-compat/src/test/java/org/apache/hadoop/hbase/master/TestMetricsMasterSourceImpl.java",0,0.75,0,2,2
"hbase-hadoop1-compat/src/test/java/org/apache/hadoop/hbase/metrics/TestBaseSourceImpl.java",0,0.934065934065934,0,2,2
"hbase-hadoop1-compat/src/test/java/org/apache/hadoop/hbase/regionserver/TestMetricsRegionServerSourceImpl.java",0,0.647058823529412,0,2,2
"hbase-hadoop1-compat/src/test/java/org/apache/hadoop/hbase/regionserver/TestMetricsRegionSourceImpl.java",0,1,0,1,1
"hbase-hadoop1-compat/src/test/java/org/apache/hadoop/hbase/regionserver/wal/TestMetricsWALSourceImpl.java",0,1,0,1,1
"hbase-hadoop1-compat/src/test/java/org/apache/hadoop/hbase/replication/regionserver/TestReplicationMetricsSourceImpl.java",0,0.794871794871795,1,2,3
"hbase-hadoop1-compat/src/test/java/org/apache/hadoop/hbase/rest/TestRESTMetricsSourceImpl.java",0,0.75,0,3,3
"hbase-hadoop1-compat/src/test/java/org/apache/hadoop/hbase/test/MetricsAssertHelperImpl.java",0,0.888392857142857,0,2,2
"hbase-hadoop1-compat/src/test/java/org/apache/hadoop/hbase/thrift/TestThriftServerMetricsSourceFactoryImpl.java",0,0.818181818181818,0,2,2
"hbase-hadoop2-compat/src/main/java/org/apache/hadoop/hbase/ipc/MetricsHBaseServerSourceFactoryImpl.java",0,1,0,1,1
"hbase-hadoop2-compat/src/main/java/org/apache/hadoop/hbase/ipc/MetricsHBaseServerSourceImpl.java",0,1,0,1,1
"hbase-hadoop2-compat/src/main/java/org/apache/hadoop/hbase/mapreduce/JobUtil.java",0,1,0,1,1
"hbase-hadoop2-compat/src/main/java/org/apache/hadoop/hbase/master/MetricsMasterSourceFactoryImpl.java",0,0.783783783783784,0,2,2
"hbase-hadoop2-compat/src/main/java/org/apache/hadoop/hbase/master/MetricsMasterSourceImpl.java",0,0.461988304093567,0,4,4
"hbase-hadoop2-compat/src/main/java/org/apache/hadoop/hbase/metrics/BaseSourceImpl.java",0,0.494318181818182,0,3,3
"hbase-hadoop2-compat/src/main/java/org/apache/hadoop/hbase/metrics/MBeanSourceImpl.java",0,1,0,1,1
"hbase-hadoop2-compat/src/main/java/org/apache/hadoop/hbase/regionserver/MetricsRegionAggregateSourceImpl.java",0,0.783505154639175,0,2,2
"hbase-hadoop2-compat/src/main/java/org/apache/hadoop/hbase/regionserver/MetricsRegionServerSourceFactoryImpl.java",0,0.98,1,1,2
"hbase-hadoop2-compat/src/main/java/org/apache/hadoop/hbase/regionserver/MetricsRegionServerSourceImpl.java",0,0.94392523364486,0,2,2
"hbase-hadoop2-compat/src/main/java/org/apache/hadoop/hbase/regionserver/MetricsRegionSourceImpl.java",0,0.961538461538462,1,1,2
"hbase-hadoop2-compat/src/main/java/org/apache/hadoop/hbase/regionserver/wal/MetricsEditsReplaySourceImpl.java",0,1,0,1,1
"hbase-hadoop2-compat/src/main/java/org/apache/hadoop/hbase/regionserver/wal/MetricsWALSourceImpl.java",0,1,0,1,1
"hbase-hadoop2-compat/src/main/java/org/apache/hadoop/hbase/replication/regionserver/MetricsReplicationSourceImpl.java",0,0.651162790697674,0,3,3
"hbase-hadoop2-compat/src/main/java/org/apache/hadoop/hbase/rest/MetricsRESTSourceImpl.java",0,0.919191919191919,0,2,2
"hbase-hadoop2-compat/src/main/java/org/apache/hadoop/hbase/thrift/MetricsThriftServerSourceFactoryImpl.java",0,0.862745098039216,0,2,2
"hbase-hadoop2-compat/src/main/java/org/apache/hadoop/hbase/thrift/MetricsThriftServerSourceImpl.java",0,0.898989898989899,0,2,2
"hbase-hadoop2-compat/src/main/java/org/apache/hadoop/metrics2/impl/JmxCacheBuster.java",0,0.962025316455696,1,1,2
"hbase-hadoop2-compat/src/main/java/org/apache/hadoop/metrics2/lib/DynamicMetricsRegistry.java",0,0.84981684981685,1,2,3
"hbase-hadoop2-compat/src/main/java/org/apache/hadoop/metrics2/lib/MetricMutableQuantiles.java",0,0.987261146496815,1,1,2
"hbase-hadoop2-compat/src/main/java/org/apache/hadoop/metrics2/lib/MetricsExecutorImpl.java",0,0.984848484848485,1,1,2
"hbase-hadoop2-compat/src/main/java/org/apache/hadoop/metrics2/lib/MutableHistogram.java",0,0.992424242424242,1,1,2
"hbase-hadoop2-compat/src/main/java/org/apache/hadoop/metrics2/util/MetricQuantile.java",0,1,0,1,1
"hbase-hadoop2-compat/src/main/java/org/apache/hadoop/metrics2/util/MetricSampleQuantiles.java",0,1,0,1,1
"hbase-hadoop2-compat/src/test/java/org/apache/hadoop/hbase/HadoopShimsImpl.java",0,1,0,1,1
"hbase-hadoop2-compat/src/test/java/org/apache/hadoop/hbase/master/TestMetricsMasterSourceImpl.java",0,0.75,0,2,2
"hbase-hadoop2-compat/src/test/java/org/apache/hadoop/hbase/metrics/TestBaseSourceImpl.java",0,0.928571428571429,0,2,2
"hbase-hadoop2-compat/src/test/java/org/apache/hadoop/hbase/regionserver/TestMetricsRegionServerSourceImpl.java",0,0.66,0,2,2
"hbase-hadoop2-compat/src/test/java/org/apache/hadoop/hbase/regionserver/TestMetricsRegionSourceImpl.java",0,1,0,1,1
"hbase-hadoop2-compat/src/test/java/org/apache/hadoop/hbase/regionserver/wal/TestMetricsWALSourceImpl.java",0,0.527777777777778,0,2,2
"hbase-hadoop2-compat/src/test/java/org/apache/hadoop/hbase/replication/regionserver/TestMetricsReplicationSourceImpl.java",0,0.783783783783784,0,2,2
"hbase-hadoop2-compat/src/test/java/org/apache/hadoop/hbase/rest/TestMetricsRESTSourceImpl.java",0,0.75,0,3,3
"hbase-hadoop2-compat/src/test/java/org/apache/hadoop/hbase/test/MetricsAssertHelperImpl.java",0,0.897959183673469,0,2,2
"hbase-hadoop2-compat/src/test/java/org/apache/hadoop/hbase/thrift/TestMetricsThriftServerSourceFactoryImpl.java",0,0.8,0,2,2
"hbase-it/src/test/java/org/apache/hadoop/hbase/ClusterManager.java",0,1,0,1,1
"hbase-it/src/test/java/org/apache/hadoop/hbase/DistributedHBaseCluster.java",0,0.877358490566038,2,3,5
"hbase-it/src/test/java/org/apache/hadoop/hbase/HBaseClusterManager.java",0,0.792035398230089,0,3,3
"hbase-it/src/test/java/org/apache/hadoop/hbase/IntegrationTestBase.java",0,1,0,1,1
"hbase-it/src/test/java/org/apache/hadoop/hbase/IntegrationTestIngest.java",0,0.653631284916201,1,3,4
"hbase-it/src/test/java/org/apache/hadoop/hbase/IntegrationTestLazyCfLoading.java",0,0.97864768683274,2,1,3
"hbase-it/src/test/java/org/apache/hadoop/hbase/IntegrationTestManyRegions.java",0,0.981366459627329,1,1,2
"hbase-it/src/test/java/org/apache/hadoop/hbase/IntegrationTestingUtility.java",0,0.928057553956835,0,2,2
"hbase-it/src/test/java/org/apache/hadoop/hbase/IntegrationTestsDriver.java",0,0.982456140350877,1,1,2
"hbase-it/src/test/java/org/apache/hadoop/hbase/chaos/actions/Action.java",0,1,0,1,1
"hbase-it/src/test/java/org/apache/hadoop/hbase/chaos/actions/AddColumnAction.java",0,1,0,1,1
"hbase-it/src/test/java/org/apache/hadoop/hbase/chaos/actions/BatchRestartRsAction.java",0,1,0,1,1
"hbase-it/src/test/java/org/apache/hadoop/hbase/chaos/actions/ChangeEncodingAction.java",0,1,0,1,1
"hbase-it/src/test/java/org/apache/hadoop/hbase/chaos/actions/ChangeVersionsAction.java",0,1,0,1,1
"hbase-it/src/test/java/org/apache/hadoop/hbase/chaos/actions/CompactRandomRegionOfTableAction.java",0,1,0,1,1
"hbase-it/src/test/java/org/apache/hadoop/hbase/chaos/actions/CompactTableAction.java",0,1,0,1,1
"hbase-it/src/test/java/org/apache/hadoop/hbase/chaos/actions/FlushRandomRegionOfTableAction.java",0,1,0,1,1
"hbase-it/src/test/java/org/apache/hadoop/hbase/chaos/actions/FlushTableAction.java",0,1,0,1,1
"hbase-it/src/test/java/org/apache/hadoop/hbase/chaos/actions/ForceBalancerAction.java",0,1,0,1,1
"hbase-it/src/test/java/org/apache/hadoop/hbase/chaos/actions/MergeRandomAdjacentRegionsOfTableAction.java",0,1,0,1,1
"hbase-it/src/test/java/org/apache/hadoop/hbase/chaos/actions/MoveRandomRegionOfTableAction.java",0,1,0,1,1
"hbase-it/src/test/java/org/apache/hadoop/hbase/chaos/actions/MoveRegionsOfTableAction.java",0,1,0,1,1
"hbase-it/src/test/java/org/apache/hadoop/hbase/chaos/actions/RemoveColumnAction.java",0,1,0,1,1
"hbase-it/src/test/java/org/apache/hadoop/hbase/chaos/actions/RestartActionBaseAction.java",0,1,0,1,1
"hbase-it/src/test/java/org/apache/hadoop/hbase/chaos/actions/RestartActiveMasterAction.java",0,1,0,1,1
"hbase-it/src/test/java/org/apache/hadoop/hbase/chaos/actions/RestartRandomRsAction.java",0,1,0,1,1
"hbase-it/src/test/java/org/apache/hadoop/hbase/chaos/actions/RestartRsHoldingMetaAction.java",0,1,0,1,1
"hbase-it/src/test/java/org/apache/hadoop/hbase/chaos/actions/RestartRsHoldingTableAction.java",0,1,0,1,1
"hbase-it/src/test/java/org/apache/hadoop/hbase/chaos/actions/RollingBatchRestartRsAction.java",0,1,0,1,1
"hbase-it/src/test/java/org/apache/hadoop/hbase/chaos/actions/SnapshotTableAction.java",0,1,0,1,1
"hbase-it/src/test/java/org/apache/hadoop/hbase/chaos/actions/SplitRandomRegionOfTableAction.java",0,1,0,1,1
"hbase-it/src/test/java/org/apache/hadoop/hbase/chaos/actions/UnbalanceKillAndRebalanceAction.java",0,1,0,1,1
"hbase-it/src/test/java/org/apache/hadoop/hbase/chaos/actions/UnbalanceRegionsAction.java",0,1,0,1,1
"hbase-it/src/test/java/org/apache/hadoop/hbase/chaos/factories/CalmMonkeyFactory.java",0,1,0,1,1
"hbase-it/src/test/java/org/apache/hadoop/hbase/chaos/factories/MonkeyFactory.java",0,1,0,1,1
"hbase-it/src/test/java/org/apache/hadoop/hbase/chaos/factories/SlowDeterministicMonkeyFactory.java",0,1,0,1,1
"hbase-it/src/test/java/org/apache/hadoop/hbase/chaos/factories/UnbalanceMonkeyFactory.java",0,1,0,1,1
"hbase-it/src/test/java/org/apache/hadoop/hbase/chaos/monkies/CalmChaosMonkey.java",0,1,0,1,1
"hbase-it/src/test/java/org/apache/hadoop/hbase/chaos/monkies/ChaosMonkey.java",0,1,0,1,1
"hbase-it/src/test/java/org/apache/hadoop/hbase/chaos/monkies/PolicyBasedChaosMonkey.java",0,1,0,1,1
"hbase-it/src/test/java/org/apache/hadoop/hbase/chaos/policies/CompositeSequentialPolicy.java",0,1,0,1,1
"hbase-it/src/test/java/org/apache/hadoop/hbase/chaos/policies/DoActionsOncePolicy.java",0,1,0,1,1
"hbase-it/src/test/java/org/apache/hadoop/hbase/chaos/policies/PeriodicPolicy.java",0,1,0,1,1
"hbase-it/src/test/java/org/apache/hadoop/hbase/chaos/policies/PeriodicRandomActionPolicy.java",0,1,0,1,1
"hbase-it/src/test/java/org/apache/hadoop/hbase/chaos/policies/Policy.java",0,1,0,1,1
"hbase-it/src/test/java/org/apache/hadoop/hbase/mapreduce/IntegrationTestBulkLoad.java",0,1,0,1,1
"hbase-it/src/test/java/org/apache/hadoop/hbase/mapreduce/IntegrationTestImportTsv.java",0,0.473145780051151,2,3,5
"hbase-it/src/test/java/org/apache/hadoop/hbase/mttr/IntegrationTestMTTR.java",0,0.970037453183521,1,1,2
"hbase-it/src/test/java/org/apache/hadoop/hbase/test/IntegrationTestBigLinkedList.java",0,0.779707495429616,2,2,4
"hbase-it/src/test/java/org/apache/hadoop/hbase/test/IntegrationTestLoadAndVerify.java",0,0.883720930232558,1,2,3
"hbase-it/src/test/java/org/apache/hadoop/hbase/trace/IntegrationTestSendTraceRequests.java",0,1,0,1,1
"hbase-prefix-tree/src/main/java/org/apache/hadoop/hbase/codec/prefixtree/PrefixTreeBlockMeta.java",0,0.995243757431629,1,1,2
"hbase-prefix-tree/src/main/java/org/apache/hadoop/hbase/codec/prefixtree/PrefixTreeCodec.java",0,0.931372549019608,0,2,2
"hbase-prefix-tree/src/main/java/org/apache/hadoop/hbase/codec/prefixtree/PrefixTreeSeeker.java",0,0.85972850678733,1,2,3
"hbase-prefix-tree/src/main/java/org/apache/hadoop/hbase/codec/prefixtree/decode/ArraySearcherPool.java",0,0.984126984126984,1,1,2
"hbase-prefix-tree/src/main/java/org/apache/hadoop/hbase/codec/prefixtree/decode/DecoderFactory.java",0,0.966292134831461,1,1,2
"hbase-prefix-tree/src/main/java/org/apache/hadoop/hbase/codec/prefixtree/decode/PrefixTreeArrayReversibleScanner.java",0,0.979166666666667,1,1,2
"hbase-prefix-tree/src/main/java/org/apache/hadoop/hbase/codec/prefixtree/decode/PrefixTreeArrayScanner.java",0,0.964426877470356,1,1,2
"hbase-prefix-tree/src/main/java/org/apache/hadoop/hbase/codec/prefixtree/decode/PrefixTreeArraySearcher.java",0,0.948655256723716,2,1,3
"hbase-prefix-tree/src/main/java/org/apache/hadoop/hbase/codec/prefixtree/decode/PrefixTreeCell.java",0,0.90521327014218,0,2,2
"hbase-prefix-tree/src/main/java/org/apache/hadoop/hbase/codec/prefixtree/decode/column/ColumnNodeReader.java",0,0.961538461538462,1,1,2
"hbase-prefix-tree/src/main/java/org/apache/hadoop/hbase/codec/prefixtree/decode/column/ColumnReader.java",0,0.980769230769231,1,1,2
"hbase-prefix-tree/src/main/java/org/apache/hadoop/hbase/codec/prefixtree/decode/row/RowNodeReader.java",0,0.97752808988764,2,1,3
"hbase-prefix-tree/src/main/java/org/apache/hadoop/hbase/codec/prefixtree/decode/timestamp/MvccVersionDecoder.java",0,0.947368421052632,0,2,2
"hbase-prefix-tree/src/main/java/org/apache/hadoop/hbase/codec/prefixtree/decode/timestamp/TimestampDecoder.java",0,0.947368421052632,0,2,2
"hbase-prefix-tree/src/main/java/org/apache/hadoop/hbase/codec/prefixtree/encode/EncoderFactory.java",0,0.982142857142857,1,1,2
"hbase-prefix-tree/src/main/java/org/apache/hadoop/hbase/codec/prefixtree/encode/EncoderPool.java",0,0.96875,1,1,2
"hbase-prefix-tree/src/main/java/org/apache/hadoop/hbase/codec/prefixtree/encode/PrefixTreeEncoder.java",0,0.94949494949495,2,1,3
"hbase-prefix-tree/src/main/java/org/apache/hadoop/hbase/codec/prefixtree/encode/ThreadLocalEncoderPool.java",0,0.984375,1,1,2
"hbase-prefix-tree/src/main/java/org/apache/hadoop/hbase/codec/prefixtree/encode/column/ColumnNodeWriter.java",0,0.961832061068702,1,1,2
"hbase-prefix-tree/src/main/java/org/apache/hadoop/hbase/codec/prefixtree/encode/column/ColumnSectionWriter.java",0,0.975124378109453,1,1,2
"hbase-prefix-tree/src/main/java/org/apache/hadoop/hbase/codec/prefixtree/encode/other/CellTypeEncoder.java",0,0.985294117647059,1,1,2
"hbase-prefix-tree/src/main/java/org/apache/hadoop/hbase/codec/prefixtree/encode/other/LongEncoder.java",0,0.989071038251366,1,1,2
"hbase-prefix-tree/src/main/java/org/apache/hadoop/hbase/codec/prefixtree/encode/row/RowNodeWriter.java",0,0.971929824561404,2,1,3
"hbase-prefix-tree/src/main/java/org/apache/hadoop/hbase/codec/prefixtree/encode/row/RowSectionWriter.java",0,0.977168949771689,1,1,2
"hbase-prefix-tree/src/main/java/org/apache/hadoop/hbase/codec/prefixtree/encode/tokenize/TokenDepthComparator.java",0,0.984375,1,1,2
"hbase-prefix-tree/src/main/java/org/apache/hadoop/hbase/codec/prefixtree/encode/tokenize/Tokenizer.java",0,0.99581589958159,1,1,2
"hbase-prefix-tree/src/main/java/org/apache/hadoop/hbase/codec/prefixtree/encode/tokenize/TokenizerNode.java",0,0.990536277602524,2,1,3
"hbase-prefix-tree/src/main/java/org/apache/hadoop/hbase/codec/prefixtree/encode/tokenize/TokenizerRowSearchPosition.java",0,0.973684210526316,1,1,2
"hbase-prefix-tree/src/main/java/org/apache/hadoop/hbase/codec/prefixtree/encode/tokenize/TokenizerRowSearchResult.java",0,0.986301369863014,1,1,2
"hbase-prefix-tree/src/main/java/org/apache/hadoop/hbase/codec/prefixtree/scanner/CellScannerPosition.java",0,1,0,1,1
"hbase-prefix-tree/src/main/java/org/apache/hadoop/hbase/codec/prefixtree/scanner/CellSearcher.java",0,0.936363636363636,0,2,2
"hbase-prefix-tree/src/main/java/org/apache/hadoop/hbase/codec/prefixtree/scanner/ReversibleCellScanner.java",0,0.8,0,2,2
"hbase-prefix-tree/src/main/java/org/apache/hadoop/hbase/util/byterange/ByteRangeSet.java",0,0.972375690607735,2,1,3
"hbase-prefix-tree/src/main/java/org/apache/hadoop/hbase/util/byterange/impl/ByteRangeHashSet.java",0,0.964912280701754,1,1,2
"hbase-prefix-tree/src/main/java/org/apache/hadoop/hbase/util/byterange/impl/ByteRangeTreeSet.java",0,0.944444444444444,2,1,3
"hbase-prefix-tree/src/main/java/org/apache/hadoop/hbase/util/vint/UFIntTool.java",0,0.991379310344828,1,1,2
"hbase-prefix-tree/src/main/java/org/apache/hadoop/hbase/util/vint/UVIntTool.java",0,0.991304347826087,1,1,2
"hbase-prefix-tree/src/main/java/org/apache/hadoop/hbase/util/vint/UVLongTool.java",0,0.991150442477876,1,1,2
"hbase-prefix-tree/src/test/java/org/apache/hadoop/hbase/codec/keyvalue/TestKeyValueTool.java",0,0.963636363636364,1,1,2
"hbase-prefix-tree/src/test/java/org/apache/hadoop/hbase/codec/prefixtree/PrefixTreeTestConstants.java",0,0.962962962962963,1,1,2
"hbase-prefix-tree/src/test/java/org/apache/hadoop/hbase/codec/prefixtree/blockmeta/TestBlockMeta.java",0,0.975609756097561,1,1,2
"hbase-prefix-tree/src/test/java/org/apache/hadoop/hbase/codec/prefixtree/builder/TestTokenizer.java",0,0.918918918918919,1,2,3
"hbase-prefix-tree/src/test/java/org/apache/hadoop/hbase/codec/prefixtree/builder/TestTokenizerData.java",0,0.904761904761905,0,2,2
"hbase-prefix-tree/src/test/java/org/apache/hadoop/hbase/codec/prefixtree/builder/TestTreeDepth.java",0,0.952941176470588,2,1,3
"hbase-prefix-tree/src/test/java/org/apache/hadoop/hbase/codec/prefixtree/builder/data/TestTokenizerDataBasic.java",0,0.96078431372549,1,1,2
"hbase-prefix-tree/src/test/java/org/apache/hadoop/hbase/codec/prefixtree/builder/data/TestTokenizerDataEdgeCase.java",0,0.962264150943396,1,1,2
"hbase-prefix-tree/src/test/java/org/apache/hadoop/hbase/codec/prefixtree/column/TestColumnBuilder.java",0,0.925,1,2,3
"hbase-prefix-tree/src/test/java/org/apache/hadoop/hbase/codec/prefixtree/column/TestColumnData.java",0,0.911111111111111,0,2,2
"hbase-prefix-tree/src/test/java/org/apache/hadoop/hbase/codec/prefixtree/column/data/TestColumnDataRandom.java",0,0.903225806451613,1,2,3
"hbase-prefix-tree/src/test/java/org/apache/hadoop/hbase/codec/prefixtree/column/data/TestColumnDataSimple.java",0,0.903846153846154,1,2,3
"hbase-prefix-tree/src/test/java/org/apache/hadoop/hbase/codec/prefixtree/row/BaseTestRowData.java",0,0.925925925925926,0,2,2
"hbase-prefix-tree/src/test/java/org/apache/hadoop/hbase/codec/prefixtree/row/TestPrefixTreeSearcher.java",0,0.73469387755102,0,3,3
"hbase-prefix-tree/src/test/java/org/apache/hadoop/hbase/codec/prefixtree/row/TestRowData.java",0,0.804123711340206,0,2,2
"hbase-prefix-tree/src/test/java/org/apache/hadoop/hbase/codec/prefixtree/row/TestRowEncoder.java",0,0.940860215053763,0,2,2
"hbase-prefix-tree/src/test/java/org/apache/hadoop/hbase/codec/prefixtree/row/data/TestRowDataComplexQualifiers.java",0,0.955223880597015,1,1,2
"hbase-prefix-tree/src/test/java/org/apache/hadoop/hbase/codec/prefixtree/row/data/TestRowDataDeeper.java",0,0.916666666666667,0,2,2
"hbase-prefix-tree/src/test/java/org/apache/hadoop/hbase/codec/prefixtree/row/data/TestRowDataDifferentTimestamps.java",0,0.968085106382979,1,1,2
"hbase-prefix-tree/src/test/java/org/apache/hadoop/hbase/codec/prefixtree/row/data/TestRowDataEmpty.java",0,0.953488372093023,1,1,2
"hbase-prefix-tree/src/test/java/org/apache/hadoop/hbase/codec/prefixtree/row/data/TestRowDataExerciseFInts.java",0,0.930434782608696,2,1,3
"hbase-prefix-tree/src/test/java/org/apache/hadoop/hbase/codec/prefixtree/row/data/TestRowDataMultiFamilies.java",0,0.966666666666667,1,1,2
"hbase-prefix-tree/src/test/java/org/apache/hadoop/hbase/codec/prefixtree/row/data/TestRowDataNub.java",0,0.949152542372881,0,2,2
"hbase-prefix-tree/src/test/java/org/apache/hadoop/hbase/codec/prefixtree/row/data/TestRowDataNumberStrings.java",0,0.950819672131147,1,1,2
"hbase-prefix-tree/src/test/java/org/apache/hadoop/hbase/codec/prefixtree/row/data/TestRowDataQualifierByteOrdering.java",0,0.96551724137931,1,1,2
"hbase-prefix-tree/src/test/java/org/apache/hadoop/hbase/codec/prefixtree/row/data/TestRowDataRandomKeyValues.java",0,0.952380952380952,1,1,2
"hbase-prefix-tree/src/test/java/org/apache/hadoop/hbase/codec/prefixtree/row/data/TestRowDataSearcherRowMiss.java",0,0.8515625,0,2,2
"hbase-prefix-tree/src/test/java/org/apache/hadoop/hbase/codec/prefixtree/row/data/TestRowDataSimple.java",0,0.837606837606838,0,2,2
"hbase-prefix-tree/src/test/java/org/apache/hadoop/hbase/codec/prefixtree/row/data/TestRowDataSingleQualifier.java",0,0.942307692307692,0,2,2
"hbase-prefix-tree/src/test/java/org/apache/hadoop/hbase/codec/prefixtree/row/data/TestRowDataTrivial.java",0,0.917808219178082,0,2,2
"hbase-prefix-tree/src/test/java/org/apache/hadoop/hbase/codec/prefixtree/row/data/TestRowDataUrls.java",0,0.929292929292929,2,1,3
"hbase-prefix-tree/src/test/java/org/apache/hadoop/hbase/codec/prefixtree/row/data/TestRowDataUrlsExample.java",0,0.952380952380952,1,1,2
"hbase-prefix-tree/src/test/java/org/apache/hadoop/hbase/codec/prefixtree/timestamp/TestTimestampData.java",0,0.888888888888889,0,2,2
"hbase-prefix-tree/src/test/java/org/apache/hadoop/hbase/codec/prefixtree/timestamp/TestTimestampEncoder.java",0,0.956521739130435,1,1,2
"hbase-prefix-tree/src/test/java/org/apache/hadoop/hbase/codec/prefixtree/timestamp/data/TestTimestampDataBasic.java",0,0.962962962962963,1,1,2
"hbase-prefix-tree/src/test/java/org/apache/hadoop/hbase/codec/prefixtree/timestamp/data/TestTimestampDataNumbers.java",0,0.964285714285714,1,1,2
"hbase-prefix-tree/src/test/java/org/apache/hadoop/hbase/codec/prefixtree/timestamp/data/TestTimestampDataRepeats.java",0,0.961538461538462,1,1,2
"hbase-prefix-tree/src/test/java/org/apache/hadoop/hbase/util/bytes/TestByteRange.java",0,0.914285714285714,1,2,3
"hbase-prefix-tree/src/test/java/org/apache/hadoop/hbase/util/comparator/ByteArrayComparator.java",0,0.96875,1,1,2
"hbase-prefix-tree/src/test/java/org/apache/hadoop/hbase/util/number/NumberFormatter.java",0,0.96969696969697,1,1,2
"hbase-prefix-tree/src/test/java/org/apache/hadoop/hbase/util/number/RandomNumberUtils.java",0,0.970588235294118,1,1,2
"hbase-prefix-tree/src/test/java/org/apache/hadoop/hbase/util/vint/TestFIntTool.java",0,0.983739837398374,1,1,2
"hbase-prefix-tree/src/test/java/org/apache/hadoop/hbase/util/vint/TestVIntTool.java",0,0.97979797979798,1,1,2
"hbase-prefix-tree/src/test/java/org/apache/hadoop/hbase/util/vint/TestVLongTool.java",0,0.971698113207547,1,1,2
"hbase-protocol/src/main/java/org/apache/hadoop/hbase/protobuf/generated/AccessControlProtos.java",0,0.693701857725419,0,2,2
"hbase-protocol/src/main/java/org/apache/hadoop/hbase/protobuf/generated/AdminProtos.java",0,0.848815105816753,6,2,8
"hbase-protocol/src/main/java/org/apache/hadoop/hbase/protobuf/generated/AggregateProtos.java",0,0.80098414434117,0,2,2
"hbase-protocol/src/main/java/org/apache/hadoop/hbase/protobuf/generated/AuthenticationProtos.java",0,0.75383814728077,0,2,2
"hbase-protocol/src/main/java/org/apache/hadoop/hbase/protobuf/generated/CellProtos.java",0,1,0,1,1
"hbase-protocol/src/main/java/org/apache/hadoop/hbase/protobuf/generated/ClientProtos.java",0,0.806654717588124,4,3,7
"hbase-protocol/src/main/java/org/apache/hadoop/hbase/protobuf/generated/ClusterIdProtos.java",0,1,0,1,1
"hbase-protocol/src/main/java/org/apache/hadoop/hbase/protobuf/generated/ClusterStatusProtos.java",0,0.990871369294606,2,1,3
"hbase-protocol/src/main/java/org/apache/hadoop/hbase/protobuf/generated/ComparatorProtos.java",0,1,0,1,1
"hbase-protocol/src/main/java/org/apache/hadoop/hbase/protobuf/generated/ErrorHandlingProtos.java",0,0.759725400457666,0,2,2
"hbase-protocol/src/main/java/org/apache/hadoop/hbase/protobuf/generated/FSProtos.java",0,1,0,1,1
"hbase-protocol/src/main/java/org/apache/hadoop/hbase/protobuf/generated/FilterProtos.java",0,0.602554526441589,0,2,2
"hbase-protocol/src/main/java/org/apache/hadoop/hbase/protobuf/generated/HBaseProtos.java",0,0.858977719528178,5,2,7
"hbase-protocol/src/main/java/org/apache/hadoop/hbase/protobuf/generated/HFileProtos.java",0,0.51330376940133,0,2,2
"hbase-protocol/src/main/java/org/apache/hadoop/hbase/protobuf/generated/LoadBalancerProtos.java",0,0.72877358490566,0,2,2
"hbase-protocol/src/main/java/org/apache/hadoop/hbase/protobuf/generated/MapReduceProtos.java",0,0.828346456692913,0,2,2
"hbase-protocol/src/main/java/org/apache/hadoop/hbase/protobuf/generated/MasterAdminProtos.java",0,0.78088935254613,3,2,5
"hbase-protocol/src/main/java/org/apache/hadoop/hbase/protobuf/generated/MasterMonitorProtos.java",0,0.770346860122421,0,2,2
"hbase-protocol/src/main/java/org/apache/hadoop/hbase/protobuf/generated/MasterProtos.java",0,1,0,1,1
"hbase-protocol/src/main/java/org/apache/hadoop/hbase/protobuf/generated/MultiRowMutation.java",0,0.767932489451477,0,2,2
"hbase-protocol/src/main/java/org/apache/hadoop/hbase/protobuf/generated/MultiRowMutationProcessorProtos.java",0,0.709145427286357,0,2,2
"hbase-protocol/src/main/java/org/apache/hadoop/hbase/protobuf/generated/RPCProtos.java",0,0.973400431344357,1,1,2
"hbase-protocol/src/main/java/org/apache/hadoop/hbase/protobuf/generated/RegionServerStatusProtos.java",0,0.853709752683154,0,2,2
"hbase-protocol/src/main/java/org/apache/hadoop/hbase/protobuf/generated/RowProcessorProtos.java",0,0.749802058590657,0,2,2
"hbase-protocol/src/main/java/org/apache/hadoop/hbase/protobuf/generated/SecureBulkLoadProtos.java",0,0.733038348082596,0,2,2
"hbase-protocol/src/main/java/org/apache/hadoop/hbase/protobuf/generated/Tracing.java",0,1,0,1,1
"hbase-protocol/src/main/java/org/apache/hadoop/hbase/protobuf/generated/WALProtos.java",0,0.87998799879988,1,2,3
"hbase-protocol/src/main/java/org/apache/hadoop/hbase/protobuf/generated/ZooKeeperProtos.java",0,0.884746688515636,2,2,4
"hbase-server/src/main/java/org/apache/hadoop/hbase/BaseConfigurable.java",0,1,0,1,1
"hbase-server/src/main/java/org/apache/hadoop/hbase/DaemonThreadFactory.java",0,0.979591836734694,1,1,2
"hbase-server/src/main/java/org/apache/hadoop/hbase/HDFSBlocksDistribution.java",0,0.966804979253112,1,1,2
"hbase-server/src/main/java/org/apache/hadoop/hbase/HealthCheckChore.java",0,0.989473684210526,1,1,2
"hbase-server/src/main/java/org/apache/hadoop/hbase/HealthChecker.java",0,0.937984496124031,2,1,3
"hbase-server/src/main/java/org/apache/hadoop/hbase/HealthReport.java",0,0.934782608695652,0,2,2
"hbase-server/src/main/java/org/apache/hadoop/hbase/InterProcessLock.java",0,0.923809523809524,0,2,2
"hbase-server/src/main/java/org/apache/hadoop/hbase/InterProcessReadWriteLock.java",0,0.957446808510638,1,1,2
"hbase-server/src/main/java/org/apache/hadoop/hbase/LocalHBaseCluster.java",0,0.538293216630197,6,2,8
"hbase-server/src/main/java/org/apache/hadoop/hbase/SplitLogCounters.java",0,0.553191489361702,1,2,3
"hbase-server/src/main/java/org/apache/hadoop/hbase/SplitLogTask.java",0,0.994219653179191,1,1,2
"hbase-server/src/main/java/org/apache/hadoop/hbase/TableDescriptors.java",0,0.972602739726027,1,1,2
"hbase-server/src/main/java/org/apache/hadoop/hbase/ZKNamespaceManager.java",0,1,0,1,1
"hbase-server/src/main/java/org/apache/hadoop/hbase/ZNodeClearer.java",0,1,0,1,1
"hbase-server/src/main/java/org/apache/hadoop/hbase/backup/HFileArchiver.java",0,0.803183791606368,3,2,5
"hbase-server/src/main/java/org/apache/hadoop/hbase/backup/example/HFileArchiveManager.java",0,0.988165680473373,2,1,3
"hbase-server/src/main/java/org/apache/hadoop/hbase/backup/example/HFileArchiveTableMonitor.java",0,1,0,1,1
"hbase-server/src/main/java/org/apache/hadoop/hbase/backup/example/LongTermArchivingHFileCleaner.java",0,0.897196261682243,0,2,2
"hbase-server/src/main/java/org/apache/hadoop/hbase/backup/example/TableHFileArchiveTracker.java",0,0.99625468164794,1,1,2
"hbase-server/src/main/java/org/apache/hadoop/hbase/backup/example/ZKTableArchiveClient.java",0,0.993548387096774,1,1,2
"hbase-server/src/main/java/org/apache/hadoop/hbase/catalog/MetaEditor.java",0,0.507547169811321,2,4,6
"hbase-server/src/main/java/org/apache/hadoop/hbase/catalog/MetaMigrationConvertingToPB.java",0,0.994350282485876,1,1,2
"hbase-server/src/main/java/org/apache/hadoop/hbase/client/coprocessor/RowProcessorClient.java",0,0.56,0,2,2
"hbase-server/src/main/java/org/apache/hadoop/hbase/codec/MessageCodec.java",0,1,0,1,1
"hbase-server/src/main/java/org/apache/hadoop/hbase/constraint/BaseConstraint.java",0,0.933333333333333,0,2,2
"hbase-server/src/main/java/org/apache/hadoop/hbase/constraint/Constraint.java",0,0.869047619047619,1,2,3
"hbase-server/src/main/java/org/apache/hadoop/hbase/constraint/ConstraintException.java",0,0.895833333333333,1,2,3
"hbase-server/src/main/java/org/apache/hadoop/hbase/constraint/ConstraintProcessor.java",0,0.945652173913043,2,1,3
"hbase-server/src/main/java/org/apache/hadoop/hbase/constraint/Constraints.java",0,0.995192307692308,1,1,2
"hbase-server/src/main/java/org/apache/hadoop/hbase/constraint/package-info.java",0,0.799242424242424,0,2,2
"hbase-server/src/main/java/org/apache/hadoop/hbase/coprocessor/BaseMasterObserver.java",0,0.3359375,3,4,7
"hbase-server/src/main/java/org/apache/hadoop/hbase/coprocessor/BaseRegionObserver.java",0,0.492574257425743,5,5,10
"hbase-server/src/main/java/org/apache/hadoop/hbase/coprocessor/BaseRowProcessorEndpoint.java",0,0.689189189189189,1,2,3
"hbase-server/src/main/java/org/apache/hadoop/hbase/coprocessor/CoprocessorHost.java",0,0.582210242587601,3,4,7
"hbase-server/src/main/java/org/apache/hadoop/hbase/coprocessor/CoprocessorService.java",0,0.96969696969697,1,1,2
"hbase-server/src/main/java/org/apache/hadoop/hbase/coprocessor/MasterCoprocessorEnvironment.java",0,0.84375,0,2,2
"hbase-server/src/main/java/org/apache/hadoop/hbase/coprocessor/MasterObserver.java",0,0.364296081277213,3,4,7
"hbase-server/src/main/java/org/apache/hadoop/hbase/coprocessor/MultiRowMutationEndpoint.java",0,0.662162162162162,2,2,4
"hbase-server/src/main/java/org/apache/hadoop/hbase/coprocessor/ObserverContext.java",0,0.946902654867257,0,2,2
"hbase-server/src/main/java/org/apache/hadoop/hbase/coprocessor/RegionCoprocessorEnvironment.java",0,0.714285714285714,0,3,3
"hbase-server/src/main/java/org/apache/hadoop/hbase/coprocessor/RegionObserver.java",0,0.473575129533679,5,5,10
"hbase-server/src/main/java/org/apache/hadoop/hbase/coprocessor/RegionServerCoprocessorEnvironment.java",0,1,0,1,1
"hbase-server/src/main/java/org/apache/hadoop/hbase/coprocessor/RegionServerObserver.java",0,1,0,1,1
"hbase-server/src/main/java/org/apache/hadoop/hbase/coprocessor/WALCoprocessorEnvironment.java",0,0.8125,0,2,2
"hbase-server/src/main/java/org/apache/hadoop/hbase/coprocessor/WALObserver.java",0,0.873239436619718,0,3,3
"hbase-server/src/main/java/org/apache/hadoop/hbase/coprocessor/package-info.java",0,0.916083916083916,1,2,3
"hbase-server/src/main/java/org/apache/hadoop/hbase/errorhandling/ForeignException.java",0,0.95360824742268,1,1,2
"hbase-server/src/main/java/org/apache/hadoop/hbase/errorhandling/ForeignExceptionDispatcher.java",0,0.949579831932773,0,2,2
"hbase-server/src/main/java/org/apache/hadoop/hbase/errorhandling/ForeignExceptionListener.java",0,0.95,0,2,2
"hbase-server/src/main/java/org/apache/hadoop/hbase/errorhandling/ForeignExceptionSnare.java",0,0.955223880597015,1,1,2
"hbase-server/src/main/java/org/apache/hadoop/hbase/errorhandling/TimeoutException.java",0,0.985074626865672,1,1,2
"hbase-server/src/main/java/org/apache/hadoop/hbase/errorhandling/TimeoutExceptionInjector.java",0,1,0,1,1
"hbase-server/src/main/java/org/apache/hadoop/hbase/executor/EventHandler.java",0,0.780269058295964,4,3,7
"hbase-server/src/main/java/org/apache/hadoop/hbase/executor/ExecutorService.java",0,0.534818941504178,3,2,5
"hbase-server/src/main/java/org/apache/hadoop/hbase/fs/HFileSystem.java",0,0.448275862068966,4,3,7
"hbase-server/src/main/java/org/apache/hadoop/hbase/io/DataInputInputStream.java",0,1,0,1,1
"hbase-server/src/main/java/org/apache/hadoop/hbase/io/DataOutputOutputStream.java",0,1,0,1,1
"hbase-server/src/main/java/org/apache/hadoop/hbase/io/DoubleOutputStream.java",0,0.960526315789474,1,1,2
"hbase-server/src/main/java/org/apache/hadoop/hbase/io/FSDataInputStreamWrapper.java",0,1,0,1,1
"hbase-server/src/main/java/org/apache/hadoop/hbase/io/FileLink.java",0,0.993421052631579,2,1,3
"hbase-server/src/main/java/org/apache/hadoop/hbase/io/HFileLink.java",0,0.801007556675063,2,2,4
"hbase-server/src/main/java/org/apache/hadoop/hbase/io/HLogLink.java",0,1,0,1,1
"hbase-server/src/main/java/org/apache/hadoop/hbase/io/HalfStoreFileReader.java",0,0.695266272189349,4,4,8
"hbase-server/src/main/java/org/apache/hadoop/hbase/io/Reference.java",0,0.894495412844037,2,2,4
"hbase-server/src/main/java/org/apache/hadoop/hbase/io/WritableWithSize.java",0,0.894736842105263,0,2,2
"hbase-server/src/main/java/org/apache/hadoop/hbase/io/hfile/AbstractHFileReader.java",0,0.812688821752266,6,2,8
"hbase-server/src/main/java/org/apache/hadoop/hbase/io/hfile/AbstractHFileWriter.java",0,0.874074074074074,8,1,9
"hbase-server/src/main/java/org/apache/hadoop/hbase/io/hfile/BlockCache.java",0,0.535433070866142,0,4,4
"hbase-server/src/main/java/org/apache/hadoop/hbase/io/hfile/BlockCacheColumnFamilySummary.java",0,0.991902834008097,1,1,2
"hbase-server/src/main/java/org/apache/hadoop/hbase/io/hfile/BlockCacheKey.java",0,0.66,2,2,4
"hbase-server/src/main/java/org/apache/hadoop/hbase/io/hfile/BlockWithScanInfo.java",0,1,0,1,1
"hbase-server/src/main/java/org/apache/hadoop/hbase/io/hfile/CacheConfig.java",0,0.755924170616114,4,2,6
"hbase-server/src/main/java/org/apache/hadoop/hbase/io/hfile/CacheStats.java",0,0.55607476635514,0,3,3
"hbase-server/src/main/java/org/apache/hadoop/hbase/io/hfile/Cacheable.java",0,0.921875,1,2,3
"hbase-server/src/main/java/org/apache/hadoop/hbase/io/hfile/CacheableDeserializer.java",0,0.722222222222222,0,2,2
"hbase-server/src/main/java/org/apache/hadoop/hbase/io/hfile/CacheableDeserializerIdManager.java",0,1,0,1,1
"hbase-server/src/main/java/org/apache/hadoop/hbase/io/hfile/CachedBlock.java",0,0.8828125,2,2,4
"hbase-server/src/main/java/org/apache/hadoop/hbase/io/hfile/CachedBlockQueue.java",0,0.853211009174312,1,2,3
"hbase-server/src/main/java/org/apache/hadoop/hbase/io/hfile/ChecksumUtil.java",0,0.995708154506438,1,1,2
"hbase-server/src/main/java/org/apache/hadoop/hbase/io/hfile/CombinedBlockCache.java",0,1,0,1,1
"hbase-server/src/main/java/org/apache/hadoop/hbase/io/hfile/CorruptHFileException.java",0,0.894736842105263,0,3,3
"hbase-server/src/main/java/org/apache/hadoop/hbase/io/hfile/DoubleBlockCache.java",0,0.868571428571429,2,2,4
"hbase-server/src/main/java/org/apache/hadoop/hbase/io/hfile/FixedFileTrailer.java",0,0.569620253164557,5,3,8
"hbase-server/src/main/java/org/apache/hadoop/hbase/io/hfile/HFile.java",0,0.559012875536481,13,3,16
"hbase-server/src/main/java/org/apache/hadoop/hbase/io/hfile/HFileBlock.java",0,0.469060773480663,9,2,11
"hbase-server/src/main/java/org/apache/hadoop/hbase/io/hfile/HFileBlockIndex.java",0,0.937106918238994,5,1,6
"hbase-server/src/main/java/org/apache/hadoop/hbase/io/hfile/HFileDataBlockEncoder.java",0,0.764227642276423,2,2,4
"hbase-server/src/main/java/org/apache/hadoop/hbase/io/hfile/HFileDataBlockEncoderImpl.java",0,0.846153846153846,4,3,7
"hbase-server/src/main/java/org/apache/hadoop/hbase/io/hfile/HFilePrettyPrinter.java",0,0.645232815964523,3,3,6
"hbase-server/src/main/java/org/apache/hadoop/hbase/io/hfile/HFileReaderV2.java",0,0.473544973544974,7,3,10
"hbase-server/src/main/java/org/apache/hadoop/hbase/io/hfile/HFileScanner.java",0,0.829931972789116,0,2,2
"hbase-server/src/main/java/org/apache/hadoop/hbase/io/hfile/HFileWriterV2.java",0,0.685831622176591,6,4,10
"hbase-server/src/main/java/org/apache/hadoop/hbase/io/hfile/InlineBlockWriter.java",0,0.931506849315068,0,2,2
"hbase-server/src/main/java/org/apache/hadoop/hbase/io/hfile/InvalidHFileException.java",0,0.906976744186046,1,2,3
"hbase-server/src/main/java/org/apache/hadoop/hbase/io/hfile/LruBlockCache.java",0,0.67836919592299,11,2,13
"hbase-server/src/main/java/org/apache/hadoop/hbase/io/hfile/NoOpDataBlockEncoder.java",0,0.954128440366973,4,1,5
"hbase-server/src/main/java/org/apache/hadoop/hbase/io/hfile/SimpleBlockCache.java",0,0.525179856115108,1,5,6
"hbase-server/src/main/java/org/apache/hadoop/hbase/io/hfile/bucket/BucketAllocator.java",0,1,0,1,1
"hbase-server/src/main/java/org/apache/hadoop/hbase/io/hfile/bucket/BucketAllocatorException.java",0,1,0,1,1
"hbase-server/src/main/java/org/apache/hadoop/hbase/io/hfile/bucket/BucketCache.java",0,1,0,1,1
"hbase-server/src/main/java/org/apache/hadoop/hbase/io/hfile/bucket/BucketCacheStats.java",0,1,0,1,1
"hbase-server/src/main/java/org/apache/hadoop/hbase/io/hfile/bucket/ByteBufferIOEngine.java",0,1,0,1,1
"hbase-server/src/main/java/org/apache/hadoop/hbase/io/hfile/bucket/CacheFullException.java",0,1,0,1,1
"hbase-server/src/main/java/org/apache/hadoop/hbase/io/hfile/bucket/CachedEntryQueue.java",0,1,0,1,1
"hbase-server/src/main/java/org/apache/hadoop/hbase/io/hfile/bucket/FileIOEngine.java",0,1,0,1,1
"hbase-server/src/main/java/org/apache/hadoop/hbase/io/hfile/bucket/IOEngine.java",0,1,0,1,1
"hbase-server/src/main/java/org/apache/hadoop/hbase/io/hfile/bucket/UniqueIndexMap.java",0,1,0,1,1
"hbase-server/src/main/java/org/apache/hadoop/hbase/io/hfile/slab/SingleSizeCache.java",0,0.768156424581006,3,2,5
"hbase-server/src/main/java/org/apache/hadoop/hbase/io/hfile/slab/Slab.java",0,0.925925925925926,0,2,2
"hbase-server/src/main/java/org/apache/hadoop/hbase/io/hfile/slab/SlabCache.java",0,0.812206572769953,2,3,5
"hbase-server/src/main/java/org/apache/hadoop/hbase/io/hfile/slab/SlabItemActionWatcher.java",0,0.91304347826087,0,2,2
"hbase-server/src/main/java/org/apache/hadoop/hbase/ipc/Delayable.java",0,0.671232876712329,0,2,2
"hbase-server/src/main/java/org/apache/hadoop/hbase/ipc/EmptyServiceNameException.java",0,0.857142857142857,0,2,2
"hbase-server/src/main/java/org/apache/hadoop/hbase/ipc/HBaseRPCErrorHandler.java",0,0.857142857142857,1,2,3
"hbase-server/src/main/java/org/apache/hadoop/hbase/ipc/MetricsHBaseServer.java",0,0.985507246376812,1,1,2
"hbase-server/src/main/java/org/apache/hadoop/hbase/ipc/MetricsHBaseServerWrapperImpl.java",0,0.971014492753623,1,1,2
"hbase-server/src/main/java/org/apache/hadoop/hbase/ipc/RequestContext.java",0,0.822368421052632,0,3,3
"hbase-server/src/main/java/org/apache/hadoop/hbase/ipc/RpcCallContext.java",0,0.928571428571429,2,1,3
"hbase-server/src/main/java/org/apache/hadoop/hbase/ipc/RpcServer.java",0,0.964594807238395,6,1,7
"hbase-server/src/main/java/org/apache/hadoop/hbase/ipc/RpcServerInterface.java",0,1,0,1,1
"hbase-server/src/main/java/org/apache/hadoop/hbase/ipc/UnknownServiceException.java",0,0.72,0,2,2
"hbase-server/src/main/java/org/apache/hadoop/hbase/mapred/Driver.java",0,0.925,0,2,2
"hbase-server/src/main/java/org/apache/hadoop/hbase/mapred/GroupingTableMap.java",0,0.987096774193548,2,1,3
"hbase-server/src/main/java/org/apache/hadoop/hbase/mapred/HRegionPartitioner.java",0,0.977777777777778,1,1,2
"hbase-server/src/main/java/org/apache/hadoop/hbase/mapred/IdentityTableMap.java",0,0.986666666666667,1,1,2
"hbase-server/src/main/java/org/apache/hadoop/hbase/mapred/IdentityTableReduce.java",0,0.983333333333333,1,1,2
"hbase-server/src/main/java/org/apache/hadoop/hbase/mapred/RowCounter.java",0,0.967479674796748,1,1,2
"hbase-server/src/main/java/org/apache/hadoop/hbase/mapred/TableInputFormat.java",0,0.975609756097561,1,1,2
"hbase-server/src/main/java/org/apache/hadoop/hbase/mapred/TableInputFormatBase.java",0,0.978723404255319,1,1,2
"hbase-server/src/main/java/org/apache/hadoop/hbase/mapred/TableMap.java",0,0.947368421052632,2,1,3
"hbase-server/src/main/java/org/apache/hadoop/hbase/mapred/TableMapReduceUtil.java",0,0.602941176470588,1,3,4
"hbase-server/src/main/java/org/apache/hadoop/hbase/mapred/TableOutputFormat.java",0,0.961904761904762,1,1,2
"hbase-server/src/main/java/org/apache/hadoop/hbase/mapred/TableRecordReader.java",0,1,0,1,1
"hbase-server/src/main/java/org/apache/hadoop/hbase/mapred/TableRecordReaderImpl.java",0,0.73469387755102,3,2,5
"hbase-server/src/main/java/org/apache/hadoop/hbase/mapred/TableReduce.java",0,0.947368421052632,2,1,3
"hbase-server/src/main/java/org/apache/hadoop/hbase/mapred/TableSplit.java",0,0.772058823529412,0,2,2
"hbase-server/src/main/java/org/apache/hadoop/hbase/mapred/package-info.java",0,0.910569105691057,0,2,2
"hbase-server/src/main/java/org/apache/hadoop/hbase/mapreduce/CellCounter.java",0,0.916349809885932,0,2,2
"hbase-server/src/main/java/org/apache/hadoop/hbase/mapreduce/CopyTable.java",0,0.610108303249097,2,4,6
"hbase-server/src/main/java/org/apache/hadoop/hbase/mapreduce/Driver.java",0,0.631578947368421,0,4,4
"hbase-server/src/main/java/org/apache/hadoop/hbase/mapreduce/Export.java",0,0.868131868131868,1,3,4
"hbase-server/src/main/java/org/apache/hadoop/hbase/mapreduce/GroupingTableMapper.java",0,0.988700564971751,2,1,3
"hbase-server/src/main/java/org/apache/hadoop/hbase/mapreduce/HFileOutputFormat.java",0,0.528957528957529,3,4,7
"hbase-server/src/main/java/org/apache/hadoop/hbase/mapreduce/HLogInputFormat.java",0,0.977777777777778,2,1,3
"hbase-server/src/main/java/org/apache/hadoop/hbase/mapreduce/HRegionPartitioner.java",0,0.540740740740741,0,2,2
"hbase-server/src/main/java/org/apache/hadoop/hbase/mapreduce/IdentityTableMapper.java",0,1,0,1,1
"hbase-server/src/main/java/org/apache/hadoop/hbase/mapreduce/IdentityTableReducer.java",0,0.951219512195122,1,1,2
"hbase-server/src/main/java/org/apache/hadoop/hbase/mapreduce/Import.java",0,0.350993377483444,3,3,6
"hbase-server/src/main/java/org/apache/hadoop/hbase/mapreduce/ImportTsv.java",0,0.455102040816327,1,4,5
"hbase-server/src/main/java/org/apache/hadoop/hbase/mapreduce/KeyValueSerialization.java",0,1,0,1,1
"hbase-server/src/main/java/org/apache/hadoop/hbase/mapreduce/KeyValueSortReducer.java",0,1,0,1,1
"hbase-server/src/main/java/org/apache/hadoop/hbase/mapreduce/LoadIncrementalHFiles.java",0,0.365079365079365,10,3,13
"hbase-server/src/main/java/org/apache/hadoop/hbase/mapreduce/MultiTableInputFormat.java",0,1,0,1,1
"hbase-server/src/main/java/org/apache/hadoop/hbase/mapreduce/MultiTableInputFormatBase.java",0,0.81447963800905,0,2,2
"hbase-server/src/main/java/org/apache/hadoop/hbase/mapreduce/MultiTableOutputFormat.java",0,0.869047619047619,1,2,3
"hbase-server/src/main/java/org/apache/hadoop/hbase/mapreduce/MultithreadedTableMapper.java",0,0.822742474916388,2,2,4
"hbase-server/src/main/java/org/apache/hadoop/hbase/mapreduce/MutationSerialization.java",0,0.927083333333333,0,2,2
"hbase-server/src/main/java/org/apache/hadoop/hbase/mapreduce/PutCombiner.java",0,0.947368421052632,0,2,2
"hbase-server/src/main/java/org/apache/hadoop/hbase/mapreduce/PutSortReducer.java",0,0.577777777777778,2,3,5
"hbase-server/src/main/java/org/apache/hadoop/hbase/mapreduce/ResultSerialization.java",0,0.988372093023256,1,1,2
"hbase-server/src/main/java/org/apache/hadoop/hbase/mapreduce/RowCounter.java",0,0.345549738219895,2,4,6
"hbase-server/src/main/java/org/apache/hadoop/hbase/mapreduce/SimpleTotalOrderPartitioner.java",0,0.654929577464789,0,2,2
"hbase-server/src/main/java/org/apache/hadoop/hbase/mapreduce/TableInputFormat.java",0,0.516746411483254,1,3,4
"hbase-server/src/main/java/org/apache/hadoop/hbase/mapreduce/TableInputFormatBase.java",0,0.47,3,3,6
"hbase-server/src/main/java/org/apache/hadoop/hbase/mapreduce/TableMapReduceUtil.java",0,0.435825105782793,2,6,8
"hbase-server/src/main/java/org/apache/hadoop/hbase/mapreduce/TableMapper.java",0,1,0,1,1
"hbase-server/src/main/java/org/apache/hadoop/hbase/mapreduce/TableOutputCommitter.java",0,1,0,1,1
"hbase-server/src/main/java/org/apache/hadoop/hbase/mapreduce/TableOutputFormat.java",0,0.602803738317757,3,3,6
"hbase-server/src/main/java/org/apache/hadoop/hbase/mapreduce/TableRecordReader.java",0,0.993377483443709,1,1,2
"hbase-server/src/main/java/org/apache/hadoop/hbase/mapreduce/TableRecordReaderImpl.java",0,0.476190476190476,4,3,7
"hbase-server/src/main/java/org/apache/hadoop/hbase/mapreduce/TableReducer.java",0,0.957446808510638,1,1,2
"hbase-server/src/main/java/org/apache/hadoop/hbase/mapreduce/TableSplit.java",0,0.408783783783784,0,3,3
"hbase-server/src/main/java/org/apache/hadoop/hbase/mapreduce/TextSortReducer.java",0,1,0,1,1
"hbase-server/src/main/java/org/apache/hadoop/hbase/mapreduce/TsvImporterMapper.java",0,0.948863636363636,0,2,2
"hbase-server/src/main/java/org/apache/hadoop/hbase/mapreduce/TsvImporterTextMapper.java",0,1,0,1,1
"hbase-server/src/main/java/org/apache/hadoop/hbase/mapreduce/WALPlayer.java",0,0.964630225080386,3,1,4
"hbase-server/src/main/java/org/apache/hadoop/hbase/mapreduce/hadoopbackport/JarFinder.java",0,1,0,1,1
"hbase-server/src/main/java/org/apache/hadoop/hbase/mapreduce/package-info.java",0,0.552147239263804,0,2,2
"hbase-server/src/main/java/org/apache/hadoop/hbase/mapreduce/replication/VerifyReplication.java",0,0.870748299319728,1,2,3
"hbase-server/src/main/java/org/apache/hadoop/hbase/master/ActiveMasterManager.java",0,0.729537366548043,3,3,6
"hbase-server/src/main/java/org/apache/hadoop/hbase/master/AssignCallable.java",0,0.979166666666667,1,1,2
"hbase-server/src/main/java/org/apache/hadoop/hbase/master/AssignmentManager.java",0,0.350468702751739,14,4,18
"hbase-server/src/main/java/org/apache/hadoop/hbase/master/BulkAssigner.java",0,0.901639344262295,0,2,2
"hbase-server/src/main/java/org/apache/hadoop/hbase/master/BulkReOpen.java",0,0.89,2,2,4
"hbase-server/src/main/java/org/apache/hadoop/hbase/master/CatalogJanitor.java",0,0.583333333333333,3,3,6
"hbase-server/src/main/java/org/apache/hadoop/hbase/master/ClusterStatusPublisher.java",0,0.986159169550173,1,1,2
"hbase-server/src/main/java/org/apache/hadoop/hbase/master/DeadServer.java",0,0.491803278688525,2,3,5
"hbase-server/src/main/java/org/apache/hadoop/hbase/master/GeneralBulkAssigner.java",0,0.970338983050847,1,1,2
"hbase-server/src/main/java/org/apache/hadoop/hbase/master/HMaster.java",0,0.513875598086124,21,4,25
"hbase-server/src/main/java/org/apache/hadoop/hbase/master/HMasterCommandLine.java",0,0.624087591240876,6,2,8
"hbase-server/src/main/java/org/apache/hadoop/hbase/master/LoadBalancer.java",0,0.964601769911504,3,1,4
"hbase-server/src/main/java/org/apache/hadoop/hbase/master/MasterCoprocessorHost.java",0,0.335164835164835,3,5,8
"hbase-server/src/main/java/org/apache/hadoop/hbase/master/MasterDumpServlet.java",0,0.932773109243697,2,1,3
"hbase-server/src/main/java/org/apache/hadoop/hbase/master/MasterFileSystem.java",0,0.581632653061224,9,5,14
"hbase-server/src/main/java/org/apache/hadoop/hbase/master/MasterServices.java",0,0.538775510204082,6,3,9
"hbase-server/src/main/java/org/apache/hadoop/hbase/master/MasterStatusServlet.java",0,0.627118644067797,1,3,4
"hbase-server/src/main/java/org/apache/hadoop/hbase/master/MetricsMaster.java",0,0.468253968253968,1,4,5
"hbase-server/src/main/java/org/apache/hadoop/hbase/master/MetricsMasterWrapperImpl.java",0,0.702970297029703,1,2,3
"hbase-server/src/main/java/org/apache/hadoop/hbase/master/NamespaceJanitor.java",0,1,0,1,1
"hbase-server/src/main/java/org/apache/hadoop/hbase/master/OfflineCallback.java",0,1,0,1,1
"hbase-server/src/main/java/org/apache/hadoop/hbase/master/RackManager.java",0,1,0,1,1
"hbase-server/src/main/java/org/apache/hadoop/hbase/master/RegionPlan.java",0,0.978102189781022,1,1,2
"hbase-server/src/main/java/org/apache/hadoop/hbase/master/RegionStates.java",0,0.952299829642249,2,1,3
"hbase-server/src/main/java/org/apache/hadoop/hbase/master/ServerManager.java",0,0.548895899053628,10,4,14
"hbase-server/src/main/java/org/apache/hadoop/hbase/master/SnapshotSentinel.java",0,0.768115942028985,0,3,3
"hbase-server/src/main/java/org/apache/hadoop/hbase/master/SplitLogManager.java",0,0.771141336487286,8,2,10
"hbase-server/src/main/java/org/apache/hadoop/hbase/master/TableLockManager.java",0,0.923076923076923,1,2,3
"hbase-server/src/main/java/org/apache/hadoop/hbase/master/TableNamespaceManager.java",0,0.995535714285714,1,1,2
"hbase-server/src/main/java/org/apache/hadoop/hbase/master/UnAssignCallable.java",0,0.978723404255319,1,1,2
"hbase-server/src/main/java/org/apache/hadoop/hbase/master/balancer/BalancerChore.java",0,0.981132075471698,1,1,2
"hbase-server/src/main/java/org/apache/hadoop/hbase/master/balancer/BaseLoadBalancer.java",0,0.455197132616487,2,3,5
"hbase-server/src/main/java/org/apache/hadoop/hbase/master/balancer/ClusterLoadState.java",0,1,0,1,1
"hbase-server/src/main/java/org/apache/hadoop/hbase/master/balancer/ClusterStatusChore.java",0,1,0,1,1
"hbase-server/src/main/java/org/apache/hadoop/hbase/master/balancer/DefaultLoadBalancer.java",0,0.956120092378753,4,1,5
"hbase-server/src/main/java/org/apache/hadoop/hbase/master/balancer/FavoredNodeAssignmentHelper.java",0,0.991379310344828,1,1,2
"hbase-server/src/main/java/org/apache/hadoop/hbase/master/balancer/FavoredNodeLoadBalancer.java",0,1,0,1,1
"hbase-server/src/main/java/org/apache/hadoop/hbase/master/balancer/FavoredNodes.java",0,1,0,1,1
"hbase-server/src/main/java/org/apache/hadoop/hbase/master/balancer/LoadBalancerFactory.java",0,0.956521739130435,2,1,3
"hbase-server/src/main/java/org/apache/hadoop/hbase/master/balancer/RegionInfoComparator.java",0,1,0,1,1
"hbase-server/src/main/java/org/apache/hadoop/hbase/master/balancer/RegionLocationFinder.java",0,0.994791666666667,1,1,2
"hbase-server/src/main/java/org/apache/hadoop/hbase/master/balancer/ServerAndLoad.java",0,1,0,1,1
"hbase-server/src/main/java/org/apache/hadoop/hbase/master/balancer/StochasticLoadBalancer.java",0,0.681675392670157,3,2,5
"hbase-server/src/main/java/org/apache/hadoop/hbase/master/cleaner/BaseHFileCleanerDelegate.java",0,0.981132075471698,1,1,2
"hbase-server/src/main/java/org/apache/hadoop/hbase/master/cleaner/BaseLogCleanerDelegate.java",0,0.406779661016949,0,3,3
"hbase-server/src/main/java/org/apache/hadoop/hbase/master/cleaner/CleanerChore.java",0,0.670542635658915,1,3,4
"hbase-server/src/main/java/org/apache/hadoop/hbase/master/cleaner/FileCleanerDelegate.java",0,0.921052631578947,0,2,2
"hbase-server/src/main/java/org/apache/hadoop/hbase/master/cleaner/HFileCleaner.java",0,0.765625,1,2,3
"hbase-server/src/main/java/org/apache/hadoop/hbase/master/cleaner/HFileLinkCleaner.java",0,1,0,1,1
"hbase-server/src/main/java/org/apache/hadoop/hbase/master/cleaner/LogCleaner.java",0,0.964912280701754,1,1,2
"hbase-server/src/main/java/org/apache/hadoop/hbase/master/cleaner/TimeToLiveHFileCleaner.java",0,0.80952380952381,1,3,4
"hbase-server/src/main/java/org/apache/hadoop/hbase/master/cleaner/TimeToLiveLogCleaner.java",0,0.555555555555556,0,3,3
"hbase-server/src/main/java/org/apache/hadoop/hbase/master/handler/ClosedRegionHandler.java",0,0.915094339622642,4,1,5
"hbase-server/src/main/java/org/apache/hadoop/hbase/master/handler/CreateTableHandler.java",0,0.41044776119403,5,4,9
"hbase-server/src/main/java/org/apache/hadoop/hbase/master/handler/DeleteTableHandler.java",0,0.516778523489933,4,5,9
"hbase-server/src/main/java/org/apache/hadoop/hbase/master/handler/DisableTableHandler.java",0,0.620253164556962,7,2,9
"hbase-server/src/main/java/org/apache/hadoop/hbase/master/handler/DispatchMergingRegionHandler.java",0,0.781914893617021,0,3,3
"hbase-server/src/main/java/org/apache/hadoop/hbase/master/handler/EnableTableHandler.java",0,0.484076433121019,3,5,8
"hbase-server/src/main/java/org/apache/hadoop/hbase/master/handler/LogReplayHandler.java",0,1,0,1,1
"hbase-server/src/main/java/org/apache/hadoop/hbase/master/handler/MergedRegionHandler.java",0,0.957264957264957,1,1,2
"hbase-server/src/main/java/org/apache/hadoop/hbase/master/handler/MetaServerShutdownHandler.java",0,0.474747474747475,2,3,5
"hbase-server/src/main/java/org/apache/hadoop/hbase/master/handler/ModifyTableHandler.java",0,0.523364485981308,3,4,7
"hbase-server/src/main/java/org/apache/hadoop/hbase/master/handler/OpenedRegionHandler.java",0,0.69281045751634,5,2,7
"hbase-server/src/main/java/org/apache/hadoop/hbase/master/handler/ServerShutdownHandler.java",0,0.403361344537815,4,5,9
"hbase-server/src/main/java/org/apache/hadoop/hbase/master/handler/SplitRegionHandler.java",0,0.793388429752066,2,3,5
"hbase-server/src/main/java/org/apache/hadoop/hbase/master/handler/TableAddFamilyHandler.java",0,0.741573033707865,4,3,7
"hbase-server/src/main/java/org/apache/hadoop/hbase/master/handler/TableDeleteFamilyHandler.java",0,0.688888888888889,2,4,6
"hbase-server/src/main/java/org/apache/hadoop/hbase/master/handler/TableEventHandler.java",0,0.502024291497976,5,3,8
"hbase-server/src/main/java/org/apache/hadoop/hbase/master/handler/TableModifyFamilyHandler.java",0,0.761904761904762,2,3,5
"hbase-server/src/main/java/org/apache/hadoop/hbase/master/handler/TotesHRegionInfo.java",0,0.567567567567568,0,2,2
"hbase-server/src/main/java/org/apache/hadoop/hbase/master/snapshot/CloneSnapshotHandler.java",0,0.71505376344086,5,2,7
"hbase-server/src/main/java/org/apache/hadoop/hbase/master/snapshot/DisabledTableSnapshotHandler.java",0,0.738562091503268,4,2,6
"hbase-server/src/main/java/org/apache/hadoop/hbase/master/snapshot/EnabledTableSnapshotHandler.java",0,0.893203883495146,4,1,5
"hbase-server/src/main/java/org/apache/hadoop/hbase/master/snapshot/MasterSnapshotVerifier.java",0,0.902654867256637,4,1,5
"hbase-server/src/main/java/org/apache/hadoop/hbase/master/snapshot/RestoreSnapshotHandler.java",0,0.697435897435897,5,2,7
"hbase-server/src/main/java/org/apache/hadoop/hbase/master/snapshot/SnapshotFileCache.java",0,0.939102564102564,2,1,3
"hbase-server/src/main/java/org/apache/hadoop/hbase/master/snapshot/SnapshotHFileCleaner.java",0,0.933333333333333,2,1,3
"hbase-server/src/main/java/org/apache/hadoop/hbase/master/snapshot/SnapshotLogCleaner.java",0,0.922330097087379,2,1,3
"hbase-server/src/main/java/org/apache/hadoop/hbase/master/snapshot/SnapshotManager.java",0,0.700803212851406,5,2,7
"hbase-server/src/main/java/org/apache/hadoop/hbase/master/snapshot/TakeSnapshotHandler.java",0,0.703947368421053,4,3,7
"hbase-server/src/main/java/org/apache/hadoop/hbase/metrics/ExactCounterMetric.java",0,1,0,1,1
"hbase-server/src/main/java/org/apache/hadoop/hbase/metrics/MetricsMBeanBase.java",0,0.604938271604938,1,3,4
"hbase-server/src/main/java/org/apache/hadoop/hbase/metrics/MetricsRate.java",0,0.876404494382023,0,2,2
"hbase-server/src/main/java/org/apache/hadoop/hbase/metrics/MetricsString.java",0,1,0,1,1
"hbase-server/src/main/java/org/apache/hadoop/hbase/metrics/PersistentMetricsTimeVaryingRate.java",0,0.99290780141844,1,1,2
"hbase-server/src/main/java/org/apache/hadoop/hbase/metrics/histogram/MetricsHistogram.java",0,0.916666666666667,0,2,2
"hbase-server/src/main/java/org/apache/hadoop/hbase/migration/NamespaceUpgrade.java",0,1,0,1,1
"hbase-server/src/main/java/org/apache/hadoop/hbase/monitoring/LogMonitoring.java",0,0.948453608247423,2,1,3
"hbase-server/src/main/java/org/apache/hadoop/hbase/monitoring/MemoryBoundedLogMessageBuffer.java",0,0.96551724137931,1,1,2
"hbase-server/src/main/java/org/apache/hadoop/hbase/monitoring/MonitoredRPCHandler.java",0,1,0,1,1
"hbase-server/src/main/java/org/apache/hadoop/hbase/monitoring/MonitoredRPCHandlerImpl.java",0,1,0,1,1
"hbase-server/src/main/java/org/apache/hadoop/hbase/monitoring/MonitoredTask.java",0,0.551282051282051,0,2,2
"hbase-server/src/main/java/org/apache/hadoop/hbase/monitoring/MonitoredTaskImpl.java",0,0.541436464088398,0,2,2
"hbase-server/src/main/java/org/apache/hadoop/hbase/monitoring/StateDumpServlet.java",0,0.952380952380952,1,1,2
"hbase-server/src/main/java/org/apache/hadoop/hbase/monitoring/TaskMonitor.java",0,0.887387387387387,0,2,2
"hbase-server/src/main/java/org/apache/hadoop/hbase/monitoring/ThreadMonitoring.java",0,0.938775510204082,0,2,2
"hbase-server/src/main/java/org/apache/hadoop/hbase/procedure/Procedure.java",0,0.976253298153034,2,1,3
"hbase-server/src/main/java/org/apache/hadoop/hbase/procedure/ProcedureCoordinator.java",0,0.834415584415584,2,2,4
"hbase-server/src/main/java/org/apache/hadoop/hbase/procedure/ProcedureCoordinatorRpcs.java",0,0.941176470588235,0,2,2
"hbase-server/src/main/java/org/apache/hadoop/hbase/procedure/ProcedureMember.java",0,0.884462151394422,1,2,3
"hbase-server/src/main/java/org/apache/hadoop/hbase/procedure/ProcedureMemberRpcs.java",0,0.917808219178082,0,2,2
"hbase-server/src/main/java/org/apache/hadoop/hbase/procedure/Subprocedure.java",0,0.993939393939394,2,1,3
"hbase-server/src/main/java/org/apache/hadoop/hbase/procedure/SubprocedureFactory.java",0,0.975,1,1,2
"hbase-server/src/main/java/org/apache/hadoop/hbase/procedure/ZKProcedureCoordinatorRpcs.java",0,0.921933085501859,2,2,4
"hbase-server/src/main/java/org/apache/hadoop/hbase/procedure/ZKProcedureMemberRpcs.java",0,0.894586894586895,2,2,4
"hbase-server/src/main/java/org/apache/hadoop/hbase/procedure/ZKProcedureUtil.java",0,0.985559566787004,2,1,3
"hbase-server/src/main/java/org/apache/hadoop/hbase/protobuf/ReplicationProtbufUtil.java",0,0.517948717948718,1,3,4
"hbase-server/src/main/java/org/apache/hadoop/hbase/regionserver/BaseRowProcessor.java",0,0.859649122807018,0,2,2
"hbase-server/src/main/java/org/apache/hadoop/hbase/regionserver/ChangedReadersObserver.java",0,0.648648648648649,2,2,4
"hbase-server/src/main/java/org/apache/hadoop/hbase/regionserver/ColumnCount.java",0,0.792792792792793,0,3,3
"hbase-server/src/main/java/org/apache/hadoop/hbase/regionserver/ColumnTracker.java",0,0.5,2,2,4
"hbase-server/src/main/java/org/apache/hadoop/hbase/regionserver/CompactSplitThread.java",0,0.392789373814042,4,6,10
"hbase-server/src/main/java/org/apache/hadoop/hbase/regionserver/CompactionRequestor.java",0,0.3125,2,5,7
"hbase-server/src/main/java/org/apache/hadoop/hbase/regionserver/CompactionTool.java",0,0.878205128205128,2,2,4
"hbase-server/src/main/java/org/apache/hadoop/hbase/regionserver/ConstantSizeRegionSplitPolicy.java",0,0.723684210526316,2,3,5
"hbase-server/src/main/java/org/apache/hadoop/hbase/regionserver/DefaultStoreEngine.java",0,0.68141592920354,1,2,3
"hbase-server/src/main/java/org/apache/hadoop/hbase/regionserver/DefaultStoreFileManager.java",0,0.909722222222222,0,2,2
"hbase-server/src/main/java/org/apache/hadoop/hbase/regionserver/DefaultStoreFlusher.java",0,0.968421052631579,1,1,2
"hbase-server/src/main/java/org/apache/hadoop/hbase/regionserver/DeleteTracker.java",0,0.68695652173913,1,3,4
"hbase-server/src/main/java/org/apache/hadoop/hbase/regionserver/DelimitedKeyPrefixRegionSplitPolicy.java",0,0.977272727272727,2,1,3
"hbase-server/src/main/java/org/apache/hadoop/hbase/regionserver/DisabledRegionSplitPolicy.java",0,1,0,1,1
"hbase-server/src/main/java/org/apache/hadoop/hbase/regionserver/ExplicitColumnTracker.java",0,0.281746031746032,3,4,7
"hbase-server/src/main/java/org/apache/hadoop/hbase/regionserver/FavoredNodesForRegion.java",0,1,0,1,1
"hbase-server/src/main/java/org/apache/hadoop/hbase/regionserver/FlushRequester.java",0,0.619047619047619,1,3,4
"hbase-server/src/main/java/org/apache/hadoop/hbase/regionserver/GetClosestRowBeforeTracker.java",0,0.991666666666667,2,1,3
"hbase-server/src/main/java/org/apache/hadoop/hbase/regionserver/HRegion.java",0,0.277316857899382,23,4,27
"hbase-server/src/main/java/org/apache/hadoop/hbase/regionserver/HRegionFileSystem.java",0,0.81330685203575,4,2,6
"hbase-server/src/main/java/org/apache/hadoop/hbase/regionserver/HRegionServer.java",0,0.582526509912402,23,3,26
"hbase-server/src/main/java/org/apache/hadoop/hbase/regionserver/HRegionServerCommandLine.java",0,0.752577319587629,1,2,3
"hbase-server/src/main/java/org/apache/hadoop/hbase/regionserver/HRegionThriftServer.java",0,0.641975308641975,1,3,4
"hbase-server/src/main/java/org/apache/hadoop/hbase/regionserver/HStore.java",0,0.547418335089568,8,5,13
"hbase-server/src/main/java/org/apache/hadoop/hbase/regionserver/IncreasingToUpperBoundRegionSplitPolicy.java",0,0.914529914529915,1,2,3
"hbase-server/src/main/java/org/apache/hadoop/hbase/regionserver/InternalScan.java",0,0.962025316455696,1,1,2
"hbase-server/src/main/java/org/apache/hadoop/hbase/regionserver/InternalScanner.java",0,0.26865671641791,0,6,6
"hbase-server/src/main/java/org/apache/hadoop/hbase/regionserver/KeyPrefixRegionSplitPolicy.java",0,0.802325581395349,0,3,3
"hbase-server/src/main/java/org/apache/hadoop/hbase/regionserver/KeyValueHeap.java",0,0.431524547803618,4,3,7
"hbase-server/src/main/java/org/apache/hadoop/hbase/regionserver/KeyValueScanner.java",0,0.325396825396825,1,4,5
"hbase-server/src/main/java/org/apache/hadoop/hbase/regionserver/KeyValueSkipListSet.java",0,0.956521739130435,2,1,3
"hbase-server/src/main/java/org/apache/hadoop/hbase/regionserver/LastSequenceId.java",0,0.909090909090909,0,2,2
"hbase-server/src/main/java/org/apache/hadoop/hbase/regionserver/LeaseListener.java",0,0.583333333333333,0,3,3
"hbase-server/src/main/java/org/apache/hadoop/hbase/regionserver/Leases.java",0,0.262295081967213,1,5,6
"hbase-server/src/main/java/org/apache/hadoop/hbase/regionserver/LogRoller.java",0,0.54679802955665,7,3,10
"hbase-server/src/main/java/org/apache/hadoop/hbase/regionserver/LruHashMap.java",0,0.922727272727273,1,2,3
"hbase-server/src/main/java/org/apache/hadoop/hbase/regionserver/MemStore.java",0,0.431861804222649,9,6,15
"hbase-server/src/main/java/org/apache/hadoop/hbase/regionserver/MemStoreChunkPool.java",0,1,0,1,1
"hbase-server/src/main/java/org/apache/hadoop/hbase/regionserver/MemStoreFlusher.java",0,0.409495548961424,10,4,14
"hbase-server/src/main/java/org/apache/hadoop/hbase/regionserver/MemStoreLAB.java",0,0.719298245614035,3,2,5
"hbase-server/src/main/java/org/apache/hadoop/hbase/regionserver/MetaLogRoller.java",0,1,0,1,1
"hbase-server/src/main/java/org/apache/hadoop/hbase/regionserver/MetricsRegion.java",0,1,0,1,1
"hbase-server/src/main/java/org/apache/hadoop/hbase/regionserver/MetricsRegionServer.java",0,0.958762886597938,1,1,2
"hbase-server/src/main/java/org/apache/hadoop/hbase/regionserver/MetricsRegionServerWrapperImpl.java",0,0.98547215496368,1,1,2
"hbase-server/src/main/java/org/apache/hadoop/hbase/regionserver/MetricsRegionWrapperImpl.java",0,0.887218045112782,1,2,3
"hbase-server/src/main/java/org/apache/hadoop/hbase/regionserver/MiniBatchOperationInProgress.java",0,1,0,1,1
"hbase-server/src/main/java/org/apache/hadoop/hbase/regionserver/MultiRowMutationProcessor.java",0,0.836477987421384,3,2,5
"hbase-server/src/main/java/org/apache/hadoop/hbase/regionserver/MultiVersionConsistencyControl.java",0,0.466101694915254,0,6,6
"hbase-server/src/main/java/org/apache/hadoop/hbase/regionserver/NonLazyKeyValueScanner.java",0,0.614285714285714,1,2,3
"hbase-server/src/main/java/org/apache/hadoop/hbase/regionserver/OnlineRegions.java",0,0.880597014925373,1,2,3
"hbase-server/src/main/java/org/apache/hadoop/hbase/regionserver/OperationStatus.java",0,0.972972972972973,1,1,2
"hbase-server/src/main/java/org/apache/hadoop/hbase/regionserver/QosFunction.java",0,0.994845360824742,1,1,2
"hbase-server/src/main/java/org/apache/hadoop/hbase/regionserver/RSDumpServlet.java",0,0.728070175438597,0,2,2
"hbase-server/src/main/java/org/apache/hadoop/hbase/regionserver/RSStatusServlet.java",0,0.826923076923077,0,2,2
"hbase-server/src/main/java/org/apache/hadoop/hbase/regionserver/RegionCoprocessorHost.java",0,0.368913857677903,8,4,12
"hbase-server/src/main/java/org/apache/hadoop/hbase/regionserver/RegionMergeRequest.java",0,0.805755395683453,1,2,3
"hbase-server/src/main/java/org/apache/hadoop/hbase/regionserver/RegionMergeTransaction.java",0,0.918444165621079,3,1,4
"hbase-server/src/main/java/org/apache/hadoop/hbase/regionserver/RegionScanner.java",0,0.405660377358491,1,4,5
"hbase-server/src/main/java/org/apache/hadoop/hbase/regionserver/RegionServerAccounting.java",0,0.51,0,2,2
"hbase-server/src/main/java/org/apache/hadoop/hbase/regionserver/RegionServerCoprocessorHost.java",0,1,0,1,1
"hbase-server/src/main/java/org/apache/hadoop/hbase/regionserver/RegionServerServices.java",0,0.663793103448276,8,3,11
"hbase-server/src/main/java/org/apache/hadoop/hbase/regionserver/RegionSplitPolicy.java",0,0.811023622047244,1,3,4
"hbase-server/src/main/java/org/apache/hadoop/hbase/regionserver/ReplicationService.java",0,0.872727272727273,0,2,2
"hbase-server/src/main/java/org/apache/hadoop/hbase/regionserver/ReplicationSinkService.java",0,0.761904761904762,0,2,2
"hbase-server/src/main/java/org/apache/hadoop/hbase/regionserver/ReplicationSourceService.java",0,0.888888888888889,0,2,2
"hbase-server/src/main/java/org/apache/hadoop/hbase/regionserver/RowProcessor.java",0,0.669014084507042,2,2,4
"hbase-server/src/main/java/org/apache/hadoop/hbase/regionserver/ScanDeleteTracker.java",0,0.702247191011236,1,3,4
"hbase-server/src/main/java/org/apache/hadoop/hbase/regionserver/ScanInfo.java",0,0.990566037735849,1,1,2
"hbase-server/src/main/java/org/apache/hadoop/hbase/regionserver/ScanQueryMatcher.java",0,0.400696864111498,6,5,11
"hbase-server/src/main/java/org/apache/hadoop/hbase/regionserver/ScanType.java",0,0.933333333333333,0,2,2
"hbase-server/src/main/java/org/apache/hadoop/hbase/regionserver/ScanWildcardColumnTracker.java",0,0.411167512690355,3,4,7
"hbase-server/src/main/java/org/apache/hadoop/hbase/regionserver/ShutdownHook.java",0,0.921052631578947,1,2,3
"hbase-server/src/main/java/org/apache/hadoop/hbase/regionserver/SplitLogWorker.java",0,0.839393939393939,8,2,10
"hbase-server/src/main/java/org/apache/hadoop/hbase/regionserver/SplitRequest.java",0,0.392857142857143,2,5,7
"hbase-server/src/main/java/org/apache/hadoop/hbase/regionserver/SplitTransaction.java",0,0.575903614457831,8,4,12
"hbase-server/src/main/java/org/apache/hadoop/hbase/regionserver/Store.java",0,0.680115273775216,15,2,17
"hbase-server/src/main/java/org/apache/hadoop/hbase/regionserver/StoreConfigInformation.java",0,0.672727272727273,0,4,4
"hbase-server/src/main/java/org/apache/hadoop/hbase/regionserver/StoreEngine.java",0,0.67741935483871,0,2,2
"hbase-server/src/main/java/org/apache/hadoop/hbase/regionserver/StoreFile.java",0,0.225078369905956,12,6,18
"hbase-server/src/main/java/org/apache/hadoop/hbase/regionserver/StoreFileInfo.java",0,0.938375350140056,1,2,3
"hbase-server/src/main/java/org/apache/hadoop/hbase/regionserver/StoreFileManager.java",0,0.816793893129771,1,2,3
"hbase-server/src/main/java/org/apache/hadoop/hbase/regionserver/StoreFileScanner.java",0,0.264935064935065,6,6,12
"hbase-server/src/main/java/org/apache/hadoop/hbase/regionserver/StoreFlushContext.java",0,1,0,1,1
"hbase-server/src/main/java/org/apache/hadoop/hbase/regionserver/StoreFlusher.java",0,0.727272727272727,3,2,5
"hbase-server/src/main/java/org/apache/hadoop/hbase/regionserver/StoreScanner.java",0,0.188905547226387,7,7,14
"hbase-server/src/main/java/org/apache/hadoop/hbase/regionserver/StoreUtils.java",0,0.705882352941177,0,2,2
"hbase-server/src/main/java/org/apache/hadoop/hbase/regionserver/TimeRangeTracker.java",0,0.947019867549669,2,1,3
"hbase-server/src/main/java/org/apache/hadoop/hbase/regionserver/compactions/CompactionConfiguration.java",0,0.948863636363636,2,1,3
"hbase-server/src/main/java/org/apache/hadoop/hbase/regionserver/compactions/CompactionContext.java",0,1,0,1,1
"hbase-server/src/main/java/org/apache/hadoop/hbase/regionserver/compactions/CompactionPolicy.java",0,0.561643835616438,0,3,3
"hbase-server/src/main/java/org/apache/hadoop/hbase/regionserver/compactions/CompactionProgress.java",0,0.768115942028985,1,2,3
"hbase-server/src/main/java/org/apache/hadoop/hbase/regionserver/compactions/CompactionRequest.java",0,0.789473684210526,1,3,4
"hbase-server/src/main/java/org/apache/hadoop/hbase/regionserver/compactions/Compactor.java",0,0.689243027888446,3,3,6
"hbase-server/src/main/java/org/apache/hadoop/hbase/regionserver/compactions/CurrentHourProvider.java",0,1,0,1,1
"hbase-server/src/main/java/org/apache/hadoop/hbase/regionserver/compactions/DefaultCompactor.java",0,0.505154639175258,4,3,7
"hbase-server/src/main/java/org/apache/hadoop/hbase/regionserver/compactions/ExploringCompactionPolicy.java",0,0.811428571428571,0,2,2
"hbase-server/src/main/java/org/apache/hadoop/hbase/regionserver/compactions/OffPeakHours.java",0,1,0,1,1
"hbase-server/src/main/java/org/apache/hadoop/hbase/regionserver/compactions/RatioBasedCompactionPolicy.java",0,0.753148614609572,1,3,4
"hbase-server/src/main/java/org/apache/hadoop/hbase/regionserver/handler/CloseMetaHandler.java",0,0.869565217391304,1,2,3
"hbase-server/src/main/java/org/apache/hadoop/hbase/regionserver/handler/CloseRegionHandler.java",0,0.608490566037736,4,3,7
"hbase-server/src/main/java/org/apache/hadoop/hbase/regionserver/handler/OpenMetaHandler.java",0,0.5,1,2,3
"hbase-server/src/main/java/org/apache/hadoop/hbase/regionserver/handler/OpenRegionHandler.java",0,0.612389380530973,7,3,10
"hbase-server/src/main/java/org/apache/hadoop/hbase/regionserver/handler/ParallelSeekHandler.java",0,0.986486486486487,1,1,2
"hbase-server/src/main/java/org/apache/hadoop/hbase/regionserver/snapshot/FlushSnapshotSubprocedure.java",0,0.968944099378882,2,1,3
"hbase-server/src/main/java/org/apache/hadoop/hbase/regionserver/snapshot/RegionServerSnapshotManager.java",0,0.954787234042553,4,1,5
"hbase-server/src/main/java/org/apache/hadoop/hbase/regionserver/wal/CompressionContext.java",0,0.818181818181818,0,2,2
"hbase-server/src/main/java/org/apache/hadoop/hbase/regionserver/wal/Compressor.java",0,0.861386138613861,2,2,4
"hbase-server/src/main/java/org/apache/hadoop/hbase/regionserver/wal/Dictionary.java",0,0.986111111111111,1,1,2
"hbase-server/src/main/java/org/apache/hadoop/hbase/regionserver/wal/FSHLog.java",0,0.70709219858156,8,2,10
"hbase-server/src/main/java/org/apache/hadoop/hbase/regionserver/wal/HLog.java",0,0.46866485013624,6,5,11
"hbase-server/src/main/java/org/apache/hadoop/hbase/regionserver/wal/HLogFactory.java",0,0.471204188481675,2,3,5
"hbase-server/src/main/java/org/apache/hadoop/hbase/regionserver/wal/HLogKey.java",0,0.470308788598575,2,5,7
"hbase-server/src/main/java/org/apache/hadoop/hbase/regionserver/wal/HLogPrettyPrinter.java",0,0.978835978835979,2,1,3
"hbase-server/src/main/java/org/apache/hadoop/hbase/regionserver/wal/HLogSplitter.java",0,0.793659322944653,10,3,13
"hbase-server/src/main/java/org/apache/hadoop/hbase/regionserver/wal/HLogUtil.java",0,0.881040892193309,4,2,6
"hbase-server/src/main/java/org/apache/hadoop/hbase/regionserver/wal/KeyValueCompression.java",0,0.976744186046512,1,1,2
"hbase-server/src/main/java/org/apache/hadoop/hbase/regionserver/wal/LRUDictionary.java",0,0.941441441441441,0,2,2
"hbase-server/src/main/java/org/apache/hadoop/hbase/regionserver/wal/MetricsWAL.java",0,1,0,1,1
"hbase-server/src/main/java/org/apache/hadoop/hbase/regionserver/wal/MetricsWALEditsReplay.java",0,1,0,1,1
"hbase-server/src/main/java/org/apache/hadoop/hbase/regionserver/wal/OrphanHLogAfterSplitException.java",0,0.818181818181818,3,2,5
"hbase-server/src/main/java/org/apache/hadoop/hbase/regionserver/wal/ProtobufLogReader.java",0,0.675090252707581,1,2,3
"hbase-server/src/main/java/org/apache/hadoop/hbase/regionserver/wal/ProtobufLogWriter.java",0,0.69375,4,2,6
"hbase-server/src/main/java/org/apache/hadoop/hbase/regionserver/wal/ReaderBase.java",0,0.894039735099338,1,2,3
"hbase-server/src/main/java/org/apache/hadoop/hbase/regionserver/wal/SequenceFileLogReader.java",0,0.397769516728625,2,3,5
"hbase-server/src/main/java/org/apache/hadoop/hbase/regionserver/wal/WALActionsListener.java",0,0.705263157894737,1,2,3
"hbase-server/src/main/java/org/apache/hadoop/hbase/regionserver/wal/WALCellCodec.java",0,0.912087912087912,1,2,3
"hbase-server/src/main/java/org/apache/hadoop/hbase/regionserver/wal/WALCoprocessorHost.java",0,0.764705882352941,1,3,4
"hbase-server/src/main/java/org/apache/hadoop/hbase/regionserver/wal/WALEdit.java",0,0.361313868613139,0,5,5
"hbase-server/src/main/java/org/apache/hadoop/hbase/regionserver/wal/WALEditsReplaySink.java",0,0.910931174089069,2,2,4
"hbase-server/src/main/java/org/apache/hadoop/hbase/regionserver/wal/WriterBase.java",0,1,0,1,1
"hbase-server/src/main/java/org/apache/hadoop/hbase/replication/master/ReplicationLogCleaner.java",0,0.668674698795181,2,2,4
"hbase-server/src/main/java/org/apache/hadoop/hbase/replication/regionserver/MetricsSink.java",0,0.72,0,3,3
"hbase-server/src/main/java/org/apache/hadoop/hbase/replication/regionserver/MetricsSource.java",0,0.924528301886792,0,2,2
"hbase-server/src/main/java/org/apache/hadoop/hbase/replication/regionserver/Replication.java",0,0.557926829268293,2,3,5
"hbase-server/src/main/java/org/apache/hadoop/hbase/replication/regionserver/ReplicationHLogReaderManager.java",0,0.904761904761905,4,1,5
"hbase-server/src/main/java/org/apache/hadoop/hbase/replication/regionserver/ReplicationSink.java",0,0.435483870967742,3,3,6
"hbase-server/src/main/java/org/apache/hadoop/hbase/replication/regionserver/ReplicationSinkManager.java",0,1,0,1,1
"hbase-server/src/main/java/org/apache/hadoop/hbase/replication/regionserver/ReplicationSource.java",0,0.75,6,2,8
"hbase-server/src/main/java/org/apache/hadoop/hbase/replication/regionserver/ReplicationSourceInterface.java",0,0.773584905660377,0,2,2
"hbase-server/src/main/java/org/apache/hadoop/hbase/replication/regionserver/ReplicationSourceManager.java",0,0.682882882882883,1,3,4
"hbase-server/src/main/java/org/apache/hadoop/hbase/rest/Constants.java",0,0.45,0,3,3
"hbase-server/src/main/java/org/apache/hadoop/hbase/rest/ExistsResource.java",0,0.96,1,1,2
"hbase-server/src/main/java/org/apache/hadoop/hbase/rest/MetricsREST.java",0,0.404494382022472,0,4,4
"hbase-server/src/main/java/org/apache/hadoop/hbase/rest/MultiRowResource.java",0,0.849056603773585,2,2,4
"hbase-server/src/main/java/org/apache/hadoop/hbase/rest/ProtobufMessageHandler.java",0,0.869565217391304,0,2,2
"hbase-server/src/main/java/org/apache/hadoop/hbase/rest/RESTServer.java",0,0.346774193548387,2,3,5
"hbase-server/src/main/java/org/apache/hadoop/hbase/rest/RESTServlet.java",0,0.375838926174497,2,4,6
"hbase-server/src/main/java/org/apache/hadoop/hbase/rest/RESTServletContainer.java",0,1,0,1,1
"hbase-server/src/main/java/org/apache/hadoop/hbase/rest/RegionsResource.java",0,0.836538461538462,2,3,5
"hbase-server/src/main/java/org/apache/hadoop/hbase/rest/ResourceBase.java",0,0.911764705882353,0,2,2
"hbase-server/src/main/java/org/apache/hadoop/hbase/rest/ResourceConfig.java",0,0.903225806451613,0,2,2
"hbase-server/src/main/java/org/apache/hadoop/hbase/rest/ResultGenerator.java",0,0.959183673469388,1,1,2
"hbase-server/src/main/java/org/apache/hadoop/hbase/rest/RootResource.java",0,0.953703703703704,2,1,3
"hbase-server/src/main/java/org/apache/hadoop/hbase/rest/RowResource.java",0,0.714285714285714,3,2,5
"hbase-server/src/main/java/org/apache/hadoop/hbase/rest/RowResultGenerator.java",0,0.966666666666667,3,1,4
"hbase-server/src/main/java/org/apache/hadoop/hbase/rest/RowSpec.java",0,0.995024875621891,1,1,2
"hbase-server/src/main/java/org/apache/hadoop/hbase/rest/ScannerInstanceResource.java",0,0.884422110552764,1,2,3
"hbase-server/src/main/java/org/apache/hadoop/hbase/rest/ScannerResource.java",0,0.891025641025641,3,2,5
"hbase-server/src/main/java/org/apache/hadoop/hbase/rest/ScannerResultGenerator.java",0,0.92817679558011,3,1,4
"hbase-server/src/main/java/org/apache/hadoop/hbase/rest/SchemaResource.java",0,0.918518518518519,3,1,4
"hbase-server/src/main/java/org/apache/hadoop/hbase/rest/StorageClusterStatusResource.java",0,0.807339449541284,1,3,4
"hbase-server/src/main/java/org/apache/hadoop/hbase/rest/StorageClusterVersionResource.java",0,0.949367088607595,2,1,3
"hbase-server/src/main/java/org/apache/hadoop/hbase/rest/TableResource.java",0,0.882978723404255,0,2,2
"hbase-server/src/main/java/org/apache/hadoop/hbase/rest/VersionResource.java",0,0.971153846153846,2,1,3
"hbase-server/src/main/java/org/apache/hadoop/hbase/rest/client/Client.java",0,0.892857142857143,1,2,3
"hbase-server/src/main/java/org/apache/hadoop/hbase/rest/client/Cluster.java",0,0.932038834951456,0,2,2
"hbase-server/src/main/java/org/apache/hadoop/hbase/rest/client/RemoteAdmin.java",0,0.587179487179487,1,2,3
"hbase-server/src/main/java/org/apache/hadoop/hbase/rest/client/RemoteHTable.java",0,0.751918158567775,7,2,9
"hbase-server/src/main/java/org/apache/hadoop/hbase/rest/client/Response.java",0,0.968992248062015,1,1,2
"hbase-server/src/main/java/org/apache/hadoop/hbase/rest/filter/AuthFilter.java",0,1,0,1,1
"hbase-server/src/main/java/org/apache/hadoop/hbase/rest/filter/GZIPRequestStream.java",0,0.931034482758621,0,2,2
"hbase-server/src/main/java/org/apache/hadoop/hbase/rest/filter/GZIPRequestWrapper.java",0,0.923076923076923,0,2,2
"hbase-server/src/main/java/org/apache/hadoop/hbase/rest/filter/GZIPResponseStream.java",0,0.948717948717949,0,2,2
"hbase-server/src/main/java/org/apache/hadoop/hbase/rest/filter/GZIPResponseWrapper.java",0,0.972789115646258,1,1,2
"hbase-server/src/main/java/org/apache/hadoop/hbase/rest/filter/GzipFilter.java",0,0.952380952380952,1,1,2
"hbase-server/src/main/java/org/apache/hadoop/hbase/rest/model/CellModel.java",0,0.949748743718593,2,1,3
"hbase-server/src/main/java/org/apache/hadoop/hbase/rest/model/CellSetModel.java",0,0.986666666666667,1,1,2
"hbase-server/src/main/java/org/apache/hadoop/hbase/rest/model/ColumnSchemaModel.java",0,0.962025316455696,1,1,2
"hbase-server/src/main/java/org/apache/hadoop/hbase/rest/model/RowModel.java",0,0.986013986013986,1,1,2
"hbase-server/src/main/java/org/apache/hadoop/hbase/rest/model/ScannerModel.java",0,0.937743190661479,3,1,4
"hbase-server/src/main/java/org/apache/hadoop/hbase/rest/model/StorageClusterStatusModel.java",0,0.776649746192893,2,2,4
"hbase-server/src/main/java/org/apache/hadoop/hbase/rest/model/StorageClusterVersionModel.java",0,0.955223880597015,1,1,2
"hbase-server/src/main/java/org/apache/hadoop/hbase/rest/model/TableInfoModel.java",0,0.98125,1,1,2
"hbase-server/src/main/java/org/apache/hadoop/hbase/rest/model/TableListModel.java",0,0.982300884955752,1,1,2
"hbase-server/src/main/java/org/apache/hadoop/hbase/rest/model/TableModel.java",0,0.964285714285714,1,1,2
"hbase-server/src/main/java/org/apache/hadoop/hbase/rest/model/TableRegionModel.java",0,0.919191919191919,0,2,2
"hbase-server/src/main/java/org/apache/hadoop/hbase/rest/model/TableSchemaModel.java",0,0.983098591549296,1,1,2
"hbase-server/src/main/java/org/apache/hadoop/hbase/rest/model/VersionModel.java",0,0.990430622009569,1,1,2
"hbase-server/src/main/java/org/apache/hadoop/hbase/rest/protobuf/generated/CellMessage.java",0,0.46584938704028,0,3,3
"hbase-server/src/main/java/org/apache/hadoop/hbase/rest/protobuf/generated/CellSetMessage.java",0,0.478884462151394,0,3,3
"hbase-server/src/main/java/org/apache/hadoop/hbase/rest/protobuf/generated/ColumnSchemaMessage.java",0,0.438510189739986,0,3,3
"hbase-server/src/main/java/org/apache/hadoop/hbase/rest/protobuf/generated/ScannerMessage.java",0,0.385106382978723,0,4,4
"hbase-server/src/main/java/org/apache/hadoop/hbase/rest/protobuf/generated/StorageClusterStatusMessage.java",0,0.398886181691612,0,4,4
"hbase-server/src/main/java/org/apache/hadoop/hbase/rest/protobuf/generated/TableInfoMessage.java",0,0.432782171099928,0,3,3
"hbase-server/src/main/java/org/apache/hadoop/hbase/rest/protobuf/generated/TableListMessage.java",0,0.494331065759637,0,3,3
"hbase-server/src/main/java/org/apache/hadoop/hbase/rest/protobuf/generated/TableSchemaMessage.java",0,0.49721706864564,0,3,3
"hbase-server/src/main/java/org/apache/hadoop/hbase/rest/protobuf/generated/VersionMessage.java",0,0.388819875776398,0,3,3
"hbase-server/src/main/java/org/apache/hadoop/hbase/rest/provider/JAXBContextResolver.java",0,0.97752808988764,1,1,2
"hbase-server/src/main/java/org/apache/hadoop/hbase/rest/provider/consumer/ProtobufMessageBodyConsumer.java",0,0.977272727272727,1,1,2
"hbase-server/src/main/java/org/apache/hadoop/hbase/rest/provider/producer/PlainTextMessageBodyProducer.java",0,0.972972972972973,1,1,2
"hbase-server/src/main/java/org/apache/hadoop/hbase/rest/provider/producer/ProtobufMessageBodyProducer.java",0,0.975308641975309,1,1,2
"hbase-server/src/main/java/org/apache/hadoop/hbase/security/HBasePolicyProvider.java",0,0.894736842105263,2,2,4
"hbase-server/src/main/java/org/apache/hadoop/hbase/security/HBaseSaslRpcServer.java",0,0.964824120603015,2,1,3
"hbase-server/src/main/java/org/apache/hadoop/hbase/security/access/AccessControlFilter.java",0,0.8,1,2,3
"hbase-server/src/main/java/org/apache/hadoop/hbase/security/access/AccessControlLists.java",0,0.531851851851852,3,3,6
"hbase-server/src/main/java/org/apache/hadoop/hbase/security/access/AccessController.java",0,0.440185062789161,10,4,14
"hbase-server/src/main/java/org/apache/hadoop/hbase/security/access/AuthResult.java",0,0.809954751131222,0,2,2
"hbase-server/src/main/java/org/apache/hadoop/hbase/security/access/CodeToClassAndBackFor96Migration.java",0,0.974025974025974,1,1,2
"hbase-server/src/main/java/org/apache/hadoop/hbase/security/access/HbaseObjectWritableFor96Migration.java",0,0.701970443349754,10,3,13
"hbase-server/src/main/java/org/apache/hadoop/hbase/security/access/SecureBulkLoadEndpoint.java",0,0.966573816155989,3,1,4
"hbase-server/src/main/java/org/apache/hadoop/hbase/security/access/TableAuthManager.java",0,0.692653673163418,3,2,5
"hbase-server/src/main/java/org/apache/hadoop/hbase/security/access/ZKPermissionWatcher.java",0,0.982857142857143,2,1,3
"hbase-server/src/main/java/org/apache/hadoop/hbase/security/token/AuthenticationKey.java",0,1,0,1,1
"hbase-server/src/main/java/org/apache/hadoop/hbase/security/token/AuthenticationTokenSecretManager.java",0,0.979041916167665,1,1,2
"hbase-server/src/main/java/org/apache/hadoop/hbase/security/token/TokenProvider.java",0,0.82,3,2,5
"hbase-server/src/main/java/org/apache/hadoop/hbase/security/token/TokenUtil.java",0,0.989795918367347,1,1,2
"hbase-server/src/main/java/org/apache/hadoop/hbase/security/token/ZKSecretWatcher.java",0,1,0,1,1
"hbase-server/src/main/java/org/apache/hadoop/hbase/snapshot/CopyRecoveredEditsTask.java",0,1,0,1,1
"hbase-server/src/main/java/org/apache/hadoop/hbase/snapshot/ExportSnapshot.java",0,0.95014245014245,3,1,4
"hbase-server/src/main/java/org/apache/hadoop/hbase/snapshot/ReferenceRegionHFilesTask.java",0,1,0,1,1
"hbase-server/src/main/java/org/apache/hadoop/hbase/snapshot/ReferenceServerWALsTask.java",0,1,0,1,1
"hbase-server/src/main/java/org/apache/hadoop/hbase/snapshot/RestoreSnapshotHelper.java",0,0.911147011308562,3,1,4
"hbase-server/src/main/java/org/apache/hadoop/hbase/snapshot/SnapshotDescriptionUtils.java",0,0.96969696969697,3,1,4
"hbase-server/src/main/java/org/apache/hadoop/hbase/snapshot/SnapshotInfo.java",0,0.509433962264151,1,2,3
"hbase-server/src/main/java/org/apache/hadoop/hbase/snapshot/SnapshotLogSplitter.java",0,0.945,0,2,2
"hbase-server/src/main/java/org/apache/hadoop/hbase/snapshot/SnapshotReferenceUtil.java",0,1,0,1,1
"hbase-server/src/main/java/org/apache/hadoop/hbase/snapshot/SnapshotTask.java",0,0.970149253731343,1,1,2
"hbase-server/src/main/java/org/apache/hadoop/hbase/snapshot/TableInfoCopyTask.java",0,0.906666666666667,1,2,3
"hbase-server/src/main/java/org/apache/hadoop/hbase/snapshot/TakeSnapshotUtils.java",0,0.996763754045307,1,1,2
"hbase-server/src/main/java/org/apache/hadoop/hbase/thrift/CallQueue.java",0,0.99236641221374,1,1,2
"hbase-server/src/main/java/org/apache/hadoop/hbase/thrift/HThreadedSelectorServerArgs.java",0,0.947916666666667,0,2,2
"hbase-server/src/main/java/org/apache/hadoop/hbase/thrift/HbaseHandlerMetricsProxy.java",0,0.963414634146341,2,1,3
"hbase-server/src/main/java/org/apache/hadoop/hbase/thrift/IncrementCoalescer.java",0,0.991891891891892,2,1,3
"hbase-server/src/main/java/org/apache/hadoop/hbase/thrift/IncrementCoalescerMBean.java",0,1,0,1,1
"hbase-server/src/main/java/org/apache/hadoop/hbase/thrift/TBoundedThreadPoolServer.java",0,0.986970684039088,1,1,2
"hbase-server/src/main/java/org/apache/hadoop/hbase/thrift/ThriftMetrics.java",0,0.622222222222222,1,3,4
"hbase-server/src/main/java/org/apache/hadoop/hbase/thrift/ThriftServer.java",0,0.522267206477733,1,3,4
"hbase-server/src/main/java/org/apache/hadoop/hbase/thrift/ThriftServerRunner.java",0,0.877605917955615,5,2,7
"hbase-server/src/main/java/org/apache/hadoop/hbase/thrift/ThriftUtilities.java",0,0.485294117647059,4,4,8
"hbase-server/src/main/java/org/apache/hadoop/hbase/thrift/generated/AlreadyExists.java",0,0.453846153846154,0,4,4
"hbase-server/src/main/java/org/apache/hadoop/hbase/thrift/generated/BatchMutation.java",0,0.386980108499096,0,4,4
"hbase-server/src/main/java/org/apache/hadoop/hbase/thrift/generated/ColumnDescriptor.java",0,0.377422072451559,0,4,4
"hbase-server/src/main/java/org/apache/hadoop/hbase/thrift/generated/Hbase.java",0,0.371388857582929,1,4,5
"hbase-server/src/main/java/org/apache/hadoop/hbase/thrift/generated/IOError.java",0,0.48849104859335,0,4,4
"hbase-server/src/main/java/org/apache/hadoop/hbase/thrift/generated/IllegalArgument.java",0,0.487179487179487,0,4,4
"hbase-server/src/main/java/org/apache/hadoop/hbase/thrift/generated/Mutation.java",0,0.357446808510638,0,4,4
"hbase-server/src/main/java/org/apache/hadoop/hbase/thrift/generated/TCell.java",0,0.446,0,4,4
"hbase-server/src/main/java/org/apache/hadoop/hbase/thrift/generated/TColumn.java",0,1,0,1,1
"hbase-server/src/main/java/org/apache/hadoop/hbase/thrift/generated/TIncrement.java",0,0.984679665738162,1,1,2
"hbase-server/src/main/java/org/apache/hadoop/hbase/thrift/generated/TRegionInfo.java",0,0.298522167487685,0,5,5
"hbase-server/src/main/java/org/apache/hadoop/hbase/thrift/generated/TRowResult.java",0,0.269709543568465,0,5,5
"hbase-server/src/main/java/org/apache/hadoop/hbase/thrift/generated/TScan.java",0,0.59792924935289,0,3,3
"hbase-server/src/main/java/org/apache/hadoop/hbase/thrift2/ThriftHBaseServiceHandler.java",0,0.758904109589041,1,2,3
"hbase-server/src/main/java/org/apache/hadoop/hbase/thrift2/ThriftServer.java",0,0.755485893416928,1,3,4
"hbase-server/src/main/java/org/apache/hadoop/hbase/thrift2/ThriftUtilities.java",0,0.687203791469194,1,3,4
"hbase-server/src/main/java/org/apache/hadoop/hbase/thrift2/generated/TColumn.java",0,1,0,1,1
"hbase-server/src/main/java/org/apache/hadoop/hbase/thrift2/generated/TColumnIncrement.java",0,1,0,1,1
"hbase-server/src/main/java/org/apache/hadoop/hbase/thrift2/generated/TColumnValue.java",0,1,0,1,1
"hbase-server/src/main/java/org/apache/hadoop/hbase/thrift2/generated/TDelete.java",0,0.728029602220167,0,2,2
"hbase-server/src/main/java/org/apache/hadoop/hbase/thrift2/generated/TDeleteType.java",0,1,0,1,1
"hbase-server/src/main/java/org/apache/hadoop/hbase/thrift2/generated/TDurability.java",0,1,0,1,1
"hbase-server/src/main/java/org/apache/hadoop/hbase/thrift2/generated/TGet.java",0,0.741258741258741,0,2,2
"hbase-server/src/main/java/org/apache/hadoop/hbase/thrift2/generated/THBaseService.java",0,0.865313653136531,0,2,2
"hbase-server/src/main/java/org/apache/hadoop/hbase/thrift2/generated/TIOError.java",0,1,0,1,1
"hbase-server/src/main/java/org/apache/hadoop/hbase/thrift2/generated/TIllegalArgument.java",0,1,0,1,1
"hbase-server/src/main/java/org/apache/hadoop/hbase/thrift2/generated/TIncrement.java",0,0.648325358851675,0,2,2
"hbase-server/src/main/java/org/apache/hadoop/hbase/thrift2/generated/TMutation.java",0,1,0,1,1
"hbase-server/src/main/java/org/apache/hadoop/hbase/thrift2/generated/TPut.java",0,0.687234042553192,0,2,2
"hbase-server/src/main/java/org/apache/hadoop/hbase/thrift2/generated/TResult.java",0,1,0,1,1
"hbase-server/src/main/java/org/apache/hadoop/hbase/thrift2/generated/TRowMutations.java",0,1,0,1,1
"hbase-server/src/main/java/org/apache/hadoop/hbase/thrift2/generated/TScan.java",0,0.705052005943536,0,2,2
"hbase-server/src/main/java/org/apache/hadoop/hbase/thrift2/generated/TTimeRange.java",0,1,0,1,1
"hbase-server/src/main/java/org/apache/hadoop/hbase/tool/Canary.java",0,0.993288590604027,2,1,3
"hbase-server/src/main/java/org/apache/hadoop/hbase/trace/HBaseHTraceConfiguration.java",0,1,0,1,1
"hbase-server/src/main/java/org/apache/hadoop/hbase/trace/SpanReceiverHost.java",0,0.699300699300699,0,2,2
"hbase-server/src/main/java/org/apache/hadoop/hbase/util/AbstractHBaseTool.java",0,0.858585858585859,2,2,4
"hbase-server/src/main/java/org/apache/hadoop/hbase/util/BloomFilter.java",0,0.634920634920635,0,3,3
"hbase-server/src/main/java/org/apache/hadoop/hbase/util/BloomFilterBase.java",0,0.964912280701754,1,1,2
"hbase-server/src/main/java/org/apache/hadoop/hbase/util/BloomFilterFactory.java",0,0.647058823529412,3,3,6
"hbase-server/src/main/java/org/apache/hadoop/hbase/util/BloomFilterWriter.java",0,0.967741935483871,1,1,2
"hbase-server/src/main/java/org/apache/hadoop/hbase/util/ByteBloomFilter.java",0,0.546969696969697,2,2,4
"hbase-server/src/main/java/org/apache/hadoop/hbase/util/CancelableProgressable.java",0,0.871794871794872,0,2,2
"hbase-server/src/main/java/org/apache/hadoop/hbase/util/ChecksumFactory.java",0,0.989690721649485,1,1,2
"hbase-server/src/main/java/org/apache/hadoop/hbase/util/ChecksumType.java",0,0.977777777777778,2,1,3
"hbase-server/src/main/java/org/apache/hadoop/hbase/util/CollectionBackedScanner.java",0,0.984615384615385,1,1,2
"hbase-server/src/main/java/org/apache/hadoop/hbase/util/CompoundBloomFilter.java",0,0.966292134831461,2,1,3
"hbase-server/src/main/java/org/apache/hadoop/hbase/util/CompoundBloomFilterBase.java",0,0.96875,1,1,2
"hbase-server/src/main/java/org/apache/hadoop/hbase/util/CompoundBloomFilterWriter.java",0,0.974729241877256,2,1,3
"hbase-server/src/main/java/org/apache/hadoop/hbase/util/CompressionTest.java",0,0.370860927152318,5,3,8
"hbase-server/src/main/java/org/apache/hadoop/hbase/util/DirectMemoryUtils.java",0,1,0,1,1
"hbase-server/src/main/java/org/apache/hadoop/hbase/util/FSHDFSUtils.java",0,0.805429864253394,3,2,5
"hbase-server/src/main/java/org/apache/hadoop/hbase/util/FSMapRUtils.java",0,0.933333333333333,0,2,2
"hbase-server/src/main/java/org/apache/hadoop/hbase/util/FSTableDescriptorMigrationToSubdir.java",0,1,0,1,1
"hbase-server/src/main/java/org/apache/hadoop/hbase/util/FSTableDescriptors.java",0,0.926795580110497,6,1,7
"hbase-server/src/main/java/org/apache/hadoop/hbase/util/FSUtils.java",0,0.479717813051146,13,5,18
"hbase-server/src/main/java/org/apache/hadoop/hbase/util/FSVisitor.java",0,0.994845360824742,1,1,2
"hbase-server/src/main/java/org/apache/hadoop/hbase/util/GetJavaProperty.java",0,1,0,1,1
"hbase-server/src/main/java/org/apache/hadoop/hbase/util/HBaseConfTool.java",0,0.69047619047619,0,2,2
"hbase-server/src/main/java/org/apache/hadoop/hbase/util/HBaseFsck.java",0,0.489968321013728,10,4,14
"hbase-server/src/main/java/org/apache/hadoop/hbase/util/HBaseFsckRepair.java",0,0.515,5,3,8
"hbase-server/src/main/java/org/apache/hadoop/hbase/util/HFileArchiveUtil.java",0,0.452229299363057,2,3,5
"hbase-server/src/main/java/org/apache/hadoop/hbase/util/HFileV1Detector.java",0,1,0,1,1
"hbase-server/src/main/java/org/apache/hadoop/hbase/util/HMerge.java",0,0.461538461538462,6,2,8
"hbase-server/src/main/java/org/apache/hadoop/hbase/util/HashedBytes.java",0,1,0,1,1
"hbase-server/src/main/java/org/apache/hadoop/hbase/util/IdLock.java",0,0.975409836065574,1,1,2
"hbase-server/src/main/java/org/apache/hadoop/hbase/util/InfoServer.java",0,0.870229007633588,6,1,7
"hbase-server/src/main/java/org/apache/hadoop/hbase/util/JVMClusterUtil.java",0,0.624223602484472,3,3,6
"hbase-server/src/main/java/org/apache/hadoop/hbase/util/JvmVersion.java",0,1,0,1,1
"hbase-server/src/main/java/org/apache/hadoop/hbase/util/KeyRange.java",0,0.838709677419355,0,2,2
"hbase-server/src/main/java/org/apache/hadoop/hbase/util/Keying.java",0,0.975,2,1,3
"hbase-server/src/main/java/org/apache/hadoop/hbase/util/ManualEnvironmentEdge.java",0,0.844444444444444,0,3,3
"hbase-server/src/main/java/org/apache/hadoop/hbase/util/Merge.java",0,0.56701030927835,4,2,6
"hbase-server/src/main/java/org/apache/hadoop/hbase/util/MetaUtils.java",0,0.470967741935484,0,3,3
"hbase-server/src/main/java/org/apache/hadoop/hbase/util/ModifyRegionUtils.java",0,0.983050847457627,2,1,3
"hbase-server/src/main/java/org/apache/hadoop/hbase/util/ProtoUtil.java",0,1,0,1,1
"hbase-server/src/main/java/org/apache/hadoop/hbase/util/RegionSplitCalculator.java",0,0.675105485232067,1,2,3
"hbase-server/src/main/java/org/apache/hadoop/hbase/util/RegionSplitter.java",0,0.896091515729266,8,1,9
"hbase-server/src/main/java/org/apache/hadoop/hbase/util/ServerCommandLine.java",0,0.873563218390805,1,2,3
"hbase-server/src/main/java/org/apache/hadoop/hbase/util/ShutdownHookManager.java",0,1,0,1,1
"hbase-server/src/main/java/org/apache/hadoop/hbase/util/SortedCopyOnWriteSet.java",0,0.966480446927374,1,1,2
"hbase-server/src/main/java/org/apache/hadoop/hbase/util/hbck/HFileCorruptionChecker.java",0,0.956989247311828,3,1,4
"hbase-server/src/main/java/org/apache/hadoop/hbase/util/hbck/OfflineMetaRepair.java",0,0.844961240310077,2,2,4
"hbase-server/src/main/java/org/apache/hadoop/hbase/util/hbck/TableIntegrityErrorHandler.java",0,0.910891089108911,0,2,2
"hbase-server/src/main/java/org/apache/hadoop/hbase/util/hbck/TableIntegrityErrorHandlerImpl.java",0,0.932038834951456,0,2,2
"hbase-server/src/main/java/org/apache/hadoop/hbase/util/hbck/TableLockChecker.java",0,1,0,1,1
"hbase-server/src/main/java/org/apache/hadoop/hbase/zookeeper/ClusterStatusTracker.java",0,0.99,1,1,2
"hbase-server/src/main/java/org/apache/hadoop/hbase/zookeeper/DeletionListener.java",0,1,0,1,1
"hbase-server/src/main/java/org/apache/hadoop/hbase/zookeeper/DrainingServerTracker.java",0,0.991735537190083,1,1,2
"hbase-server/src/main/java/org/apache/hadoop/hbase/zookeeper/LoadBalancerTracker.java",0,0.968085106382979,2,1,3
"hbase-server/src/main/java/org/apache/hadoop/hbase/zookeeper/MiniZooKeeperCluster.java",0,0.721938775510204,4,3,7
"hbase-server/src/main/java/org/apache/hadoop/hbase/zookeeper/RecoveringRegionWatcher.java",0,1,0,1,1
"hbase-server/src/main/java/org/apache/hadoop/hbase/zookeeper/RegionServerTracker.java",0,0.938931297709924,0,2,2
"hbase-server/src/main/java/org/apache/hadoop/hbase/zookeeper/ZKServerTool.java",0,0.350877192982456,1,3,4
"hbase-server/src/main/java/org/apache/hadoop/hbase/zookeeper/ZKSplitLog.java",0,0.943089430894309,0,2,2
"hbase-server/src/main/java/org/apache/hadoop/hbase/zookeeper/ZooKeeperMainServer.java",0,0.725,0,3,3
"hbase-server/src/main/java/org/apache/hadoop/hbase/zookeeper/lock/ZKInterProcessLockBase.java",0,0.982417582417582,2,1,3
"hbase-server/src/main/java/org/apache/hadoop/hbase/zookeeper/lock/ZKInterProcessReadLock.java",0,1,0,1,1
"hbase-server/src/main/java/org/apache/hadoop/hbase/zookeeper/lock/ZKInterProcessReadWriteLock.java",0,1,0,1,1
"hbase-server/src/main/java/org/apache/hadoop/hbase/zookeeper/lock/ZKInterProcessWriteLock.java",0,1,0,1,1
"hbase-server/src/test/java/org/apache/hadoop/hbase/HBaseCluster.java",0,0.96271186440678,1,1,2
"hbase-server/src/test/java/org/apache/hadoop/hbase/HBaseTestCase.java",0,0.470845481049563,6,4,10
"hbase-server/src/test/java/org/apache/hadoop/hbase/HBaseTestingUtility.java",0,0.488270777479893,16,5,21
"hbase-server/src/test/java/org/apache/hadoop/hbase/HFilePerformanceEvaluation.java",0,0.970189701897019,4,1,5
"hbase-server/src/test/java/org/apache/hadoop/hbase/HServerLoad092.java",0,1,0,1,1
"hbase-server/src/test/java/org/apache/hadoop/hbase/HTestConst.java",0,0.971014492753623,1,1,2
"hbase-server/src/test/java/org/apache/hadoop/hbase/MapFilePerformanceEvaluation.java",0,0.991379310344828,2,1,3
"hbase-server/src/test/java/org/apache/hadoop/hbase/MiniHBaseCluster.java",0,0.540871934604905,11,3,14
"hbase-server/src/test/java/org/apache/hadoop/hbase/MultithreadedTestUtil.java",0,0.74468085106383,1,2,3
"hbase-server/src/test/java/org/apache/hadoop/hbase/PerformanceEvaluation.java",0,0.768910478834143,8,3,11
"hbase-server/src/test/java/org/apache/hadoop/hbase/PerformanceEvaluationCommons.java",0,1,0,1,1
"hbase-server/src/test/java/org/apache/hadoop/hbase/ServerResourceCheckerJUnitListener.java",0,0.619047619047619,0,2,2
"hbase-server/src/test/java/org/apache/hadoop/hbase/TestAcidGuarantees.java",0,0.751256281407035,6,3,9
"hbase-server/src/test/java/org/apache/hadoop/hbase/TestCheckTestClasses.java",0,1,0,1,1
"hbase-server/src/test/java/org/apache/hadoop/hbase/TestClusterBootOrder.java",0,1,0,1,1
"hbase-server/src/test/java/org/apache/hadoop/hbase/TestCompare.java",0,0.305084745762712,1,4,5
"hbase-server/src/test/java/org/apache/hadoop/hbase/TestDrainingServer.java",0,0.569131832797428,0,3,3
"hbase-server/src/test/java/org/apache/hadoop/hbase/TestFSTableDescriptorForceCreation.java",0,0.96,1,1,2
"hbase-server/src/test/java/org/apache/hadoop/hbase/TestFullLogReconstruction.java",0,0.758928571428571,3,2,5
"hbase-server/src/test/java/org/apache/hadoop/hbase/TestGlobalMemStoreSize.java",0,0.960893854748603,2,1,3
"hbase-server/src/test/java/org/apache/hadoop/hbase/TestHBaseTestingUtility.java",0,0.960176991150443,1,1,2
"hbase-server/src/test/java/org/apache/hadoop/hbase/TestHColumnDescriptor.java",0,0.77319587628866,3,2,5
"hbase-server/src/test/java/org/apache/hadoop/hbase/TestHDFSBlocksDistribution.java",0,1,0,1,1
"hbase-server/src/test/java/org/apache/hadoop/hbase/TestHRegionLocation.java",0,0.825,3,2,5
"hbase-server/src/test/java/org/apache/hadoop/hbase/TestHTableDescriptor.java",0,0.278846153846154,3,5,8
"hbase-server/src/test/java/org/apache/hadoop/hbase/TestIOFencing.java",0,0.924050632911392,4,1,5
"hbase-server/src/test/java/org/apache/hadoop/hbase/TestIPv6NIOServerSocketChannel.java",0,0.886792452830189,0,2,2
"hbase-server/src/test/java/org/apache/hadoop/hbase/TestInfoServers.java",0,0.472222222222222,4,3,7
"hbase-server/src/test/java/org/apache/hadoop/hbase/TestLocalHBaseCluster.java",0,1,0,1,1
"hbase-server/src/test/java/org/apache/hadoop/hbase/TestMultiVersions.java",0,0.961309523809524,2,1,3
"hbase-server/src/test/java/org/apache/hadoop/hbase/TestNamespace.java",0,0.996774193548387,1,1,2
"hbase-server/src/test/java/org/apache/hadoop/hbase/TestNodeHealthCheckChore.java",0,0.602409638554217,1,3,4
"hbase-server/src/test/java/org/apache/hadoop/hbase/TestRegionRebalancing.java",0,0.504032258064516,4,2,6
"hbase-server/src/test/java/org/apache/hadoop/hbase/TestSerialization.java",0,0.458110516934046,5,3,8
"hbase-server/src/test/java/org/apache/hadoop/hbase/TestServerLoad.java",0,0.964705882352941,1,1,2
"hbase-server/src/test/java/org/apache/hadoop/hbase/TestServerName.java",0,0.972727272727273,1,1,2
"hbase-server/src/test/java/org/apache/hadoop/hbase/TestZooKeeper.java",0,0.504378283712785,5,4,9
"hbase-server/src/test/java/org/apache/hadoop/hbase/TimestampTestBase.java",0,0.584837545126354,1,4,5
"hbase-server/src/test/java/org/apache/hadoop/hbase/backup/TestHFileArchiving.java",0,0.591324200913242,2,4,6
"hbase-server/src/test/java/org/apache/hadoop/hbase/backup/example/TestZooKeeperTableArchiveClient.java",0,0.723557692307692,0,2,2
"hbase-server/src/test/java/org/apache/hadoop/hbase/catalog/MetaMockingUtil.java",0,1,0,1,1
"hbase-server/src/test/java/org/apache/hadoop/hbase/catalog/TestCatalogTracker.java",0,0.879310344827586,6,2,8
"hbase-server/src/test/java/org/apache/hadoop/hbase/catalog/TestMetaMigrationConvertingToPB.java",0,0.95,3,1,4
"hbase-server/src/test/java/org/apache/hadoop/hbase/catalog/TestMetaReaderEditor.java",0,0.805369127516778,1,2,3
"hbase-server/src/test/java/org/apache/hadoop/hbase/catalog/TestMetaReaderEditorNoCluster.java",0,0.960352422907489,5,1,6
"hbase-server/src/test/java/org/apache/hadoop/hbase/client/HConnectionTestingUtility.java",0,0.942675159235669,4,1,5
"hbase-server/src/test/java/org/apache/hadoop/hbase/client/TestAdmin.java",0,0.590487238979118,13,4,17
"hbase-server/src/test/java/org/apache/hadoop/hbase/client/TestClientScannerRPCTimeout.java",0,1,0,1,1
"hbase-server/src/test/java/org/apache/hadoop/hbase/client/TestClientTimeouts.java",0,0.453947368421053,1,3,4
"hbase-server/src/test/java/org/apache/hadoop/hbase/client/TestCloneSnapshotFromClient.java",0,0.827004219409283,1,3,4
"hbase-server/src/test/java/org/apache/hadoop/hbase/client/TestConnectionUtils.java",0,1,0,1,1
"hbase-server/src/test/java/org/apache/hadoop/hbase/client/TestFromClientSide.java",0,0.417181467181467,10,4,14
"hbase-server/src/test/java/org/apache/hadoop/hbase/client/TestFromClientSide3.java",0,0.55609756097561,1,3,4
"hbase-server/src/test/java/org/apache/hadoop/hbase/client/TestFromClientSideWithCoprocessor.java",0,0.976190476190476,1,1,2
"hbase-server/src/test/java/org/apache/hadoop/hbase/client/TestHBaseAdminNoCluster.java",0,0.967391304347826,1,1,2
"hbase-server/src/test/java/org/apache/hadoop/hbase/client/TestHCM.java",0,0.228880157170923,4,6,10
"hbase-server/src/test/java/org/apache/hadoop/hbase/client/TestHTableMultiplexer.java",0,0.788321167883212,1,3,4
"hbase-server/src/test/java/org/apache/hadoop/hbase/client/TestHTablePool.java",0,0.881868131868132,2,2,4
"hbase-server/src/test/java/org/apache/hadoop/hbase/client/TestHTableUtil.java",0,0.976923076923077,1,1,2
"hbase-server/src/test/java/org/apache/hadoop/hbase/client/TestIntraRowPagination.java",0,0.971698113207547,1,1,2
"hbase-server/src/test/java/org/apache/hadoop/hbase/client/TestMetaScanner.java",0,0.643724696356275,3,2,5
"hbase-server/src/test/java/org/apache/hadoop/hbase/client/TestMultiParallel.java",0,0.687188019966722,4,4,8
"hbase-server/src/test/java/org/apache/hadoop/hbase/client/TestMultipleTimestamps.java",0,0.510948905109489,2,3,5
"hbase-server/src/test/java/org/apache/hadoop/hbase/client/TestPutDeleteEtcCellIteration.java",0,1,0,1,1
"hbase-server/src/test/java/org/apache/hadoop/hbase/client/TestRestoreSnapshotFromClient.java",0,0.868217054263566,3,2,5
"hbase-server/src/test/java/org/apache/hadoop/hbase/client/TestResult.java",0,0.590747330960854,1,3,4
"hbase-server/src/test/java/org/apache/hadoop/hbase/client/TestScannerTimeout.java",0,0.650862068965517,2,4,6
"hbase-server/src/test/java/org/apache/hadoop/hbase/client/TestScannersFromClientSide.java",0,0.931567328918322,1,2,3
"hbase-server/src/test/java/org/apache/hadoop/hbase/client/TestShell.java",0,0.959459459459459,1,1,2
"hbase-server/src/test/java/org/apache/hadoop/hbase/client/TestSnapshotCloneIndependence.java",0,0.903743315508021,2,2,4
"hbase-server/src/test/java/org/apache/hadoop/hbase/client/TestSnapshotFromClient.java",0,0.801526717557252,3,2,5
"hbase-server/src/test/java/org/apache/hadoop/hbase/client/TestSnapshotMetadata.java",0,0.949152542372881,0,2,2
"hbase-server/src/test/java/org/apache/hadoop/hbase/client/TestTimestampsFilter.java",0,0.839378238341969,2,2,4
"hbase-server/src/test/java/org/apache/hadoop/hbase/client/replication/TestReplicationAdmin.java",0,0.785123966942149,0,3,3
"hbase-server/src/test/java/org/apache/hadoop/hbase/codec/CodecPerformance.java",0,1,0,1,1
"hbase-server/src/test/java/org/apache/hadoop/hbase/codec/TestCellMessageCodec.java",0,1,0,1,1
"hbase-server/src/test/java/org/apache/hadoop/hbase/constraint/AllFailConstraint.java",0,1,0,1,1
"hbase-server/src/test/java/org/apache/hadoop/hbase/constraint/AllPassConstraint.java",0,1,0,1,1
"hbase-server/src/test/java/org/apache/hadoop/hbase/constraint/CheckConfigurationConstraint.java",0,0.866666666666667,0,2,2
"hbase-server/src/test/java/org/apache/hadoop/hbase/constraint/RuntimeFailConstraint.java",0,0.515151515151515,0,2,2
"hbase-server/src/test/java/org/apache/hadoop/hbase/constraint/TestConstraint.java",0,0.965779467680608,2,1,3
"hbase-server/src/test/java/org/apache/hadoop/hbase/constraint/TestConstraints.java",0,0.951690821256039,1,1,2
"hbase-server/src/test/java/org/apache/hadoop/hbase/constraint/WorksConstraint.java",0,1,0,1,1
"hbase-server/src/test/java/org/apache/hadoop/hbase/coprocessor/ColumnAggregationEndpoint.java",0,0.539130434782609,0,3,3
"hbase-server/src/test/java/org/apache/hadoop/hbase/coprocessor/ProtobufCoprocessorService.java",0,1,0,1,1
"hbase-server/src/test/java/org/apache/hadoop/hbase/coprocessor/SampleRegionWALObserver.java",0,0.91304347826087,2,1,3
"hbase-server/src/test/java/org/apache/hadoop/hbase/coprocessor/SimpleRegionObserver.java",0,0.342814371257485,4,5,9
"hbase-server/src/test/java/org/apache/hadoop/hbase/coprocessor/TestClassLoading.java",0,0.382246376811594,1,5,6
"hbase-server/src/test/java/org/apache/hadoop/hbase/coprocessor/TestCoprocessorEndpoint.java",0,0.373887240356083,0,4,4
"hbase-server/src/test/java/org/apache/hadoop/hbase/coprocessor/TestCoprocessorInterface.java",0,0.407920792079208,6,5,11
"hbase-server/src/test/java/org/apache/hadoop/hbase/coprocessor/TestMasterCoprocessorExceptionWithAbort.java",0,0.918803418803419,1,2,3
"hbase-server/src/test/java/org/apache/hadoop/hbase/coprocessor/TestMasterCoprocessorExceptionWithRemove.java",0,0.904347826086957,3,2,5
"hbase-server/src/test/java/org/apache/hadoop/hbase/coprocessor/TestMasterObserver.java",0,0.433357611070648,5,4,9
"hbase-server/src/test/java/org/apache/hadoop/hbase/coprocessor/TestOpenTableInCoprocessor.java",0,0.969924812030075,1,1,2
"hbase-server/src/test/java/org/apache/hadoop/hbase/coprocessor/TestRegionObserverBypass.java",0,0.820276497695853,5,2,7
"hbase-server/src/test/java/org/apache/hadoop/hbase/coprocessor/TestRegionObserverInterface.java",0,0.48256880733945,6,4,10
"hbase-server/src/test/java/org/apache/hadoop/hbase/coprocessor/TestRegionObserverScannerOpenHook.java",0,0.976744186046512,1,1,2
"hbase-server/src/test/java/org/apache/hadoop/hbase/coprocessor/TestRegionObserverStacking.java",0,0.722222222222222,4,2,6
"hbase-server/src/test/java/org/apache/hadoop/hbase/coprocessor/TestRegionServerCoprocessorExceptionWithAbort.java",0,0.87719298245614,3,2,5
"hbase-server/src/test/java/org/apache/hadoop/hbase/coprocessor/TestRegionServerCoprocessorExceptionWithRemove.java",0,0.895104895104895,4,2,6
"hbase-server/src/test/java/org/apache/hadoop/hbase/coprocessor/TestRowProcessorEndpoint.java",0,0.800613496932515,3,2,5
"hbase-server/src/test/java/org/apache/hadoop/hbase/coprocessor/TestWALObserver.java",0,0.692874692874693,4,2,6
"hbase-server/src/test/java/org/apache/hadoop/hbase/coprocessor/protobuf/generated/ColumnAggregationProtos.java",0,1,0,1,1
"hbase-server/src/test/java/org/apache/hadoop/hbase/coprocessor/protobuf/generated/IncrementCounterProcessorTestProtos.java",0,0.744525547445255,0,2,2
"hbase-server/src/test/java/org/apache/hadoop/hbase/coprocessor/protobuf/generated/PingProtos.java",0,1,0,1,1
"hbase-server/src/test/java/org/apache/hadoop/hbase/errorhandling/TestForeignExceptionDispatcher.java",0,1,0,1,1
"hbase-server/src/test/java/org/apache/hadoop/hbase/errorhandling/TestForeignExceptionSerialization.java",0,1,0,1,1
"hbase-server/src/test/java/org/apache/hadoop/hbase/errorhandling/TestTimeoutExceptionInjector.java",0,0.970873786407767,1,1,2
"hbase-server/src/test/java/org/apache/hadoop/hbase/executor/TestExecutorService.java",0,0.744318181818182,3,3,6
"hbase-server/src/test/java/org/apache/hadoop/hbase/filter/TestBitComparator.java",0,0.7,1,2,3
"hbase-server/src/test/java/org/apache/hadoop/hbase/filter/TestColumnPaginationFilter.java",0,0.959183673469388,1,1,2
"hbase-server/src/test/java/org/apache/hadoop/hbase/filter/TestColumnPrefixFilter.java",0,0.618556701030928,2,3,5
"hbase-server/src/test/java/org/apache/hadoop/hbase/filter/TestColumnRangeFilter.java",0,0.973076923076923,2,1,3
"hbase-server/src/test/java/org/apache/hadoop/hbase/filter/TestComparatorSerialization.java",0,1,0,1,1
"hbase-server/src/test/java/org/apache/hadoop/hbase/filter/TestDependentColumnFilter.java",0,0.792114695340502,1,3,4
"hbase-server/src/test/java/org/apache/hadoop/hbase/filter/TestFilter.java",0,0.510455764075067,4,4,8
"hbase-server/src/test/java/org/apache/hadoop/hbase/filter/TestFilterList.java",0,0.672199170124481,1,3,4
"hbase-server/src/test/java/org/apache/hadoop/hbase/filter/TestFilterSerialization.java",0,0.993788819875776,1,1,2
"hbase-server/src/test/java/org/apache/hadoop/hbase/filter/TestFilterWithScanLimits.java",0,0.912820512820513,2,2,4
"hbase-server/src/test/java/org/apache/hadoop/hbase/filter/TestFilterWrapper.java",0,0.95959595959596,3,1,4
"hbase-server/src/test/java/org/apache/hadoop/hbase/filter/TestFirstKeyValueMatchingQualifiersFilter.java",0,1,0,1,1
"hbase-server/src/test/java/org/apache/hadoop/hbase/filter/TestFuzzyRowAndColumnRangeFilter.java",0,1,0,1,1
"hbase-server/src/test/java/org/apache/hadoop/hbase/filter/TestFuzzyRowFilter.java",0,1,0,1,1
"hbase-server/src/test/java/org/apache/hadoop/hbase/filter/TestInclusiveStopFilter.java",0,0.945652173913043,2,1,3
"hbase-server/src/test/java/org/apache/hadoop/hbase/filter/TestMultipleColumnPrefixFilter.java",0,0.972868217054264,2,1,3
"hbase-server/src/test/java/org/apache/hadoop/hbase/filter/TestPageFilter.java",0,0.758241758241758,1,3,4
"hbase-server/src/test/java/org/apache/hadoop/hbase/filter/TestParseFilter.java",0,0.995508982035928,1,1,2
"hbase-server/src/test/java/org/apache/hadoop/hbase/filter/TestPrefixFilter.java",0,0.946808510638298,0,2,2
"hbase-server/src/test/java/org/apache/hadoop/hbase/filter/TestRandomRowFilter.java",0,0.815217391304348,1,2,3
"hbase-server/src/test/java/org/apache/hadoop/hbase/filter/TestSingleColumnValueExcludeFilter.java",0,0.793103448275862,0,2,2
"hbase-server/src/test/java/org/apache/hadoop/hbase/filter/TestSingleColumnValueFilter.java",0,0.690721649484536,0,3,3
"hbase-server/src/test/java/org/apache/hadoop/hbase/fs/TestBlockReorder.java",0,0.955710955710956,2,1,3
"hbase-server/src/test/java/org/apache/hadoop/hbase/io/TestFileLink.java",0,0.923694779116466,0,2,2
"hbase-server/src/test/java/org/apache/hadoop/hbase/io/TestHFileLink.java",0,1,0,1,1
"hbase-server/src/test/java/org/apache/hadoop/hbase/io/TestHalfStoreFileReader.java",0,0.470588235294118,1,4,5
"hbase-server/src/test/java/org/apache/hadoop/hbase/io/TestHeapSize.java",0,0.688654353562005,2,3,5
"hbase-server/src/test/java/org/apache/hadoop/hbase/io/TestImmutableBytesWritable.java",0,0.757352941176471,1,2,3
"hbase-server/src/test/java/org/apache/hadoop/hbase/io/TestReference.java",0,1,0,1,1
"hbase-server/src/test/java/org/apache/hadoop/hbase/io/encoding/TestBufferedDataBlockEncoder.java",0,0.953488372093023,1,1,2
"hbase-server/src/test/java/org/apache/hadoop/hbase/io/encoding/TestChangingEncoding.java",0,0.909747292418773,3,1,4
"hbase-server/src/test/java/org/apache/hadoop/hbase/io/encoding/TestDataBlockEncoders.java",0,0.984042553191489,3,1,4
"hbase-server/src/test/java/org/apache/hadoop/hbase/io/encoding/TestEncodedSeekers.java",0,0.590643274853801,1,3,4
"hbase-server/src/test/java/org/apache/hadoop/hbase/io/encoding/TestLoadAndSwitchEncodeOnDisk.java",0,0.743589743589744,1,2,3
"hbase-server/src/test/java/org/apache/hadoop/hbase/io/encoding/TestPrefixTreeEncoding.java",0,1,0,1,1
"hbase-server/src/test/java/org/apache/hadoop/hbase/io/hfile/CacheTestUtils.java",0,0.523160762942779,3,3,6
"hbase-server/src/test/java/org/apache/hadoop/hbase/io/hfile/KVGenerator.java",0,1,0,1,1
"hbase-server/src/test/java/org/apache/hadoop/hbase/io/hfile/KeySampler.java",0,1,0,1,1
"hbase-server/src/test/java/org/apache/hadoop/hbase/io/hfile/NanoTimer.java",0,1,0,1,1
"hbase-server/src/test/java/org/apache/hadoop/hbase/io/hfile/RandomDistribution.java",0,1,0,1,1
"hbase-server/src/test/java/org/apache/hadoop/hbase/io/hfile/RandomSeek.java",0,0.9453125,3,1,4
"hbase-server/src/test/java/org/apache/hadoop/hbase/io/hfile/TestBlockCacheColumnFamilySummary.java",0,0.983870967741935,1,1,2
"hbase-server/src/test/java/org/apache/hadoop/hbase/io/hfile/TestCacheOnWrite.java",0,0.493333333333333,6,2,8
"hbase-server/src/test/java/org/apache/hadoop/hbase/io/hfile/TestCachedBlockQueue.java",0,0.824324324324324,4,2,6
"hbase-server/src/test/java/org/apache/hadoop/hbase/io/hfile/TestChecksum.java",0,0.9375,4,1,5
"hbase-server/src/test/java/org/apache/hadoop/hbase/io/hfile/TestFixedFileTrailer.java",0,0.907488986784141,5,1,6
"hbase-server/src/test/java/org/apache/hadoop/hbase/io/hfile/TestForceCacheImportantBlocks.java",0,0.944827586206897,3,1,4
"hbase-server/src/test/java/org/apache/hadoop/hbase/io/hfile/TestHFile.java",0,0.638743455497382,5,3,8
"hbase-server/src/test/java/org/apache/hadoop/hbase/io/hfile/TestHFileBlock.java",0,0.516666666666667,7,2,9
"hbase-server/src/test/java/org/apache/hadoop/hbase/io/hfile/TestHFileBlockCompatibility.java",0,0.972451790633609,5,1,6
"hbase-server/src/test/java/org/apache/hadoop/hbase/io/hfile/TestHFileBlockIndex.java",0,0.948051948051948,5,1,6
"hbase-server/src/test/java/org/apache/hadoop/hbase/io/hfile/TestHFileDataBlockEncoder.java",0,0.785714285714286,5,2,7
"hbase-server/src/test/java/org/apache/hadoop/hbase/io/hfile/TestHFileInlineToRootChunkConversion.java",0,1,0,1,1
"hbase-server/src/test/java/org/apache/hadoop/hbase/io/hfile/TestHFilePerformance.java",0,0.961928934010152,3,1,4
"hbase-server/src/test/java/org/apache/hadoop/hbase/io/hfile/TestHFileSeek.java",0,0.900917431192661,4,2,6
"hbase-server/src/test/java/org/apache/hadoop/hbase/io/hfile/TestHFileWriterV2.java",0,0.692073170731707,1,5,6
"hbase-server/src/test/java/org/apache/hadoop/hbase/io/hfile/TestLruBlockCache.java",0,0.645112781954887,4,4,8
"hbase-server/src/test/java/org/apache/hadoop/hbase/io/hfile/TestReseekTo.java",0,0.797979797979798,3,2,5
"hbase-server/src/test/java/org/apache/hadoop/hbase/io/hfile/TestScannerSelectionUsingTTL.java",0,0.728395061728395,3,2,5
"hbase-server/src/test/java/org/apache/hadoop/hbase/io/hfile/TestSeekTo.java",0,0.493723849372385,2,3,5
"hbase-server/src/test/java/org/apache/hadoop/hbase/io/hfile/bucket/TestBucketCache.java",0,1,0,1,1
"hbase-server/src/test/java/org/apache/hadoop/hbase/io/hfile/bucket/TestByteBufferIOEngine.java",0,1,0,1,1
"hbase-server/src/test/java/org/apache/hadoop/hbase/io/hfile/bucket/TestFileIOEngine.java",0,1,0,1,1
"hbase-server/src/test/java/org/apache/hadoop/hbase/io/hfile/slab/TestSingleSizeCache.java",0,0.855421686746988,0,2,2
"hbase-server/src/test/java/org/apache/hadoop/hbase/io/hfile/slab/TestSlab.java",0,0.935064935064935,0,2,2
"hbase-server/src/test/java/org/apache/hadoop/hbase/io/hfile/slab/TestSlabCache.java",0,0.783783783783784,0,2,2
"hbase-server/src/test/java/org/apache/hadoop/hbase/ipc/MetricsHBaseServerWrapperStub.java",0,1,0,1,1
"hbase-server/src/test/java/org/apache/hadoop/hbase/ipc/TestDelayedRpc.java",0,0.697406340057637,2,3,5
"hbase-server/src/test/java/org/apache/hadoop/hbase/ipc/TestHBaseClient.java",0,0.962962962962963,1,1,2
"hbase-server/src/test/java/org/apache/hadoop/hbase/ipc/TestIPC.java",0,0.764705882352941,1,2,3
"hbase-server/src/test/java/org/apache/hadoop/hbase/ipc/TestProtoBufRpc.java",0,0.914285714285714,0,2,2
"hbase-server/src/test/java/org/apache/hadoop/hbase/ipc/TestRpcMetrics.java",0,1,0,1,1
"hbase-server/src/test/java/org/apache/hadoop/hbase/ipc/protobuf/generated/TestDelayedRpcProtos.java",0,1,0,1,1
"hbase-server/src/test/java/org/apache/hadoop/hbase/ipc/protobuf/generated/TestProtos.java",0,1,0,1,1
"hbase-server/src/test/java/org/apache/hadoop/hbase/ipc/protobuf/generated/TestRpcServiceProtos.java",0,1,0,1,1
"hbase-server/src/test/java/org/apache/hadoop/hbase/mapred/TestTableInputFormat.java",0,0.817480719794344,2,2,4
"hbase-server/src/test/java/org/apache/hadoop/hbase/mapred/TestTableMapReduce.java",0,0.802281368821293,0,3,3
"hbase-server/src/test/java/org/apache/hadoop/hbase/mapreduce/MapreduceTestingShim.java",0,1,0,1,1
"hbase-server/src/test/java/org/apache/hadoop/hbase/mapreduce/NMapInputFormat.java",0,0.888888888888889,0,2,2
"hbase-server/src/test/java/org/apache/hadoop/hbase/mapreduce/TestCopyTable.java",0,1,0,1,1
"hbase-server/src/test/java/org/apache/hadoop/hbase/mapreduce/TestHFileOutputFormat.java",0,0.451317296678121,4,5,9
"hbase-server/src/test/java/org/apache/hadoop/hbase/mapreduce/TestHLogRecordReader.java",0,0.858974358974359,2,2,4
"hbase-server/src/test/java/org/apache/hadoop/hbase/mapreduce/TestImportExport.java",0,0.398328690807799,2,4,6
"hbase-server/src/test/java/org/apache/hadoop/hbase/mapreduce/TestImportTsv.java",0,0.591891891891892,3,4,7
"hbase-server/src/test/java/org/apache/hadoop/hbase/mapreduce/TestImportTsvParser.java",0,0.75,0,3,3
"hbase-server/src/test/java/org/apache/hadoop/hbase/mapreduce/TestLoadIncrementalHFiles.java",0,0.358910891089109,5,4,9
"hbase-server/src/test/java/org/apache/hadoop/hbase/mapreduce/TestLoadIncrementalHFilesSplitRecovery.java",0,0.855036855036855,4,2,6
"hbase-server/src/test/java/org/apache/hadoop/hbase/mapreduce/TestMultithreadedTableMapper.java",0,0.941634241245136,0,2,2
"hbase-server/src/test/java/org/apache/hadoop/hbase/mapreduce/TestRowCounter.java",0,1,0,1,1
"hbase-server/src/test/java/org/apache/hadoop/hbase/mapreduce/TestSecureLoadIncrementalHFiles.java",0,0.982142857142857,1,1,2
"hbase-server/src/test/java/org/apache/hadoop/hbase/mapreduce/TestSecureLoadIncrementalHFilesSplitRecovery.java",0,0.984848484848485,1,1,2
"hbase-server/src/test/java/org/apache/hadoop/hbase/mapreduce/TestSimpleTotalOrderPartitioner.java",0,0.957142857142857,1,1,2
"hbase-server/src/test/java/org/apache/hadoop/hbase/mapreduce/TestTableInputFormatScan1.java",0,1,0,1,1
"hbase-server/src/test/java/org/apache/hadoop/hbase/mapreduce/TestTableInputFormatScan2.java",0,1,0,1,1
"hbase-server/src/test/java/org/apache/hadoop/hbase/mapreduce/TestTableInputFormatScanBase.java",0,0.769547325102881,2,2,4
"hbase-server/src/test/java/org/apache/hadoop/hbase/mapreduce/TestTableMapReduce.java",0,0.84641638225256,3,2,5
"hbase-server/src/test/java/org/apache/hadoop/hbase/mapreduce/TestTableSplit.java",0,0.938775510204082,0,2,2
"hbase-server/src/test/java/org/apache/hadoop/hbase/mapreduce/TestTimeRangeMapRed.java",0,0.947867298578199,5,1,6
"hbase-server/src/test/java/org/apache/hadoop/hbase/mapreduce/TestWALPlayer.java",0,0.990384615384615,1,1,2
"hbase-server/src/test/java/org/apache/hadoop/hbase/mapreduce/TsvImporterCustomTestMapper.java",0,0.975,1,1,2
"hbase-server/src/test/java/org/apache/hadoop/hbase/mapreduce/hadoopbackport/TestJarFinder.java",0,1,0,1,1
"hbase-server/src/test/java/org/apache/hadoop/hbase/master/MockRegionServer.java",0,0.864285714285714,6,2,8
"hbase-server/src/test/java/org/apache/hadoop/hbase/master/Mocking.java",0,0.671428571428571,1,3,4
"hbase-server/src/test/java/org/apache/hadoop/hbase/master/TestActiveMasterManager.java",0,0.833865814696486,2,2,4
"hbase-server/src/test/java/org/apache/hadoop/hbase/master/TestAssignmentManager.java",0,0.476923076923077,4,4,8
"hbase-server/src/test/java/org/apache/hadoop/hbase/master/TestAssignmentManagerOnCluster.java",0,0.87012987012987,0,3,3
"hbase-server/src/test/java/org/apache/hadoop/hbase/master/TestCatalogJanitor.java",0,0.707627118644068,9,3,12
"hbase-server/src/test/java/org/apache/hadoop/hbase/master/TestClockSkewDetection.java",0,0.707547169811321,2,2,4
"hbase-server/src/test/java/org/apache/hadoop/hbase/master/TestClusterStatusPublisher.java",0,1,0,1,1
"hbase-server/src/test/java/org/apache/hadoop/hbase/master/TestDeadServer.java",0,0.56198347107438,1,4,5
"hbase-server/src/test/java/org/apache/hadoop/hbase/master/TestDistributedLogSplitting.java",0,0.773529411764706,6,3,9
"hbase-server/src/test/java/org/apache/hadoop/hbase/master/TestHMasterRPCException.java",0,0.348314606741573,2,4,6
"hbase-server/src/test/java/org/apache/hadoop/hbase/master/TestMaster.java",0,0.409638554216867,1,4,5
"hbase-server/src/test/java/org/apache/hadoop/hbase/master/TestMasterFailover.java",0,0.607108549471662,7,2,9
"hbase-server/src/test/java/org/apache/hadoop/hbase/master/TestMasterFailoverBalancerPersistence.java",0,0.983471074380165,1,1,2
"hbase-server/src/test/java/org/apache/hadoop/hbase/master/TestMasterFileSystem.java",0,0.583333333333333,0,2,2
"hbase-server/src/test/java/org/apache/hadoop/hbase/master/TestMasterMetrics.java",0,0.912621359223301,0,2,2
"hbase-server/src/test/java/org/apache/hadoop/hbase/master/TestMasterMetricsWrapper.java",0,0.961538461538462,1,1,2
"hbase-server/src/test/java/org/apache/hadoop/hbase/master/TestMasterNoCluster.java",0,0.817102137767221,5,2,7
"hbase-server/src/test/java/org/apache/hadoop/hbase/master/TestMasterRestartAfterDisablingTable.java",0,0.881944444444444,0,2,2
"hbase-server/src/test/java/org/apache/hadoop/hbase/master/TestMasterShutdown.java",0,0.700729927007299,0,2,2
"hbase-server/src/test/java/org/apache/hadoop/hbase/master/TestMasterStatusServlet.java",0,0.753846153846154,3,3,6
"hbase-server/src/test/java/org/apache/hadoop/hbase/master/TestMasterTransitions.java",0,0.974545454545454,5,1,6
"hbase-server/src/test/java/org/apache/hadoop/hbase/master/TestOpenedRegionHandler.java",0,0.91588785046729,4,1,5
"hbase-server/src/test/java/org/apache/hadoop/hbase/master/TestRegionPlacement.java",0,0.962593516209476,1,1,2
"hbase-server/src/test/java/org/apache/hadoop/hbase/master/TestRestartCluster.java",0,0.666666666666667,4,2,6
"hbase-server/src/test/java/org/apache/hadoop/hbase/master/TestRollingRestart.java",0,0.892156862745098,5,1,6
"hbase-server/src/test/java/org/apache/hadoop/hbase/master/TestSplitLogManager.java",0,0.665420560747664,3,4,7
"hbase-server/src/test/java/org/apache/hadoop/hbase/master/TestTableLockManager.java",0,0.877647058823529,3,2,5
"hbase-server/src/test/java/org/apache/hadoop/hbase/master/TestZKBasedOpenCloseRegion.java",0,0.399390243902439,2,4,6
"hbase-server/src/test/java/org/apache/hadoop/hbase/master/balancer/BalancerTestBase.java",0,0.909465020576132,1,2,3
"hbase-server/src/test/java/org/apache/hadoop/hbase/master/balancer/TestBaseLoadBalancer.java",0,1,0,1,1
"hbase-server/src/test/java/org/apache/hadoop/hbase/master/balancer/TestDefaultLoadBalancer.java",0,0.992307692307692,1,1,2
"hbase-server/src/test/java/org/apache/hadoop/hbase/master/balancer/TestFavoredNodeAssignmentHelper.java",0,0.991666666666667,1,1,2
"hbase-server/src/test/java/org/apache/hadoop/hbase/master/balancer/TestStochasticLoadBalancer.java",0,0.477011494252874,0,3,3
"hbase-server/src/test/java/org/apache/hadoop/hbase/master/cleaner/TestCleanerChore.java",0,0.79874213836478,0,2,2
"hbase-server/src/test/java/org/apache/hadoop/hbase/master/cleaner/TestHFileCleaner.java",0,0.481171548117155,3,4,7
"hbase-server/src/test/java/org/apache/hadoop/hbase/master/cleaner/TestHFileLinkCleaner.java",0,0.976878612716763,2,1,3
"hbase-server/src/test/java/org/apache/hadoop/hbase/master/cleaner/TestLogsCleaner.java",0,0.621468926553672,3,3,6
"hbase-server/src/test/java/org/apache/hadoop/hbase/master/cleaner/TestSnapshotFromMaster.java",0,0.927461139896373,4,1,5
"hbase-server/src/test/java/org/apache/hadoop/hbase/master/handler/TestCreateTableHandler.java",0,0.927007299270073,0,2,2
"hbase-server/src/test/java/org/apache/hadoop/hbase/master/handler/TestTableDeleteFamilyHandler.java",0,0.881987577639752,0,2,2
"hbase-server/src/test/java/org/apache/hadoop/hbase/master/handler/TestTableDescriptorModification.java",0,0.937888198757764,0,2,2
"hbase-server/src/test/java/org/apache/hadoop/hbase/master/snapshot/TestSnapshotFileCache.java",0,1,0,1,1
"hbase-server/src/test/java/org/apache/hadoop/hbase/master/snapshot/TestSnapshotHFileCleaner.java",0,0.966292134831461,1,1,2
"hbase-server/src/test/java/org/apache/hadoop/hbase/master/snapshot/TestSnapshotLogCleaner.java",0,0.976470588235294,2,1,3
"hbase-server/src/test/java/org/apache/hadoop/hbase/master/snapshot/TestSnapshotManager.java",0,0.914110429447853,1,2,3
"hbase-server/src/test/java/org/apache/hadoop/hbase/migration/TestNamespaceUpgrade.java",0,1,0,1,1
"hbase-server/src/test/java/org/apache/hadoop/hbase/monitoring/TestMemoryBoundedLogMessageBuffer.java",0,0.844155844155844,3,2,5
"hbase-server/src/test/java/org/apache/hadoop/hbase/monitoring/TestTaskMonitor.java",0,0.933333333333333,3,1,4
"hbase-server/src/test/java/org/apache/hadoop/hbase/procedure/TestProcedure.java",0,0.982905982905983,1,1,2
"hbase-server/src/test/java/org/apache/hadoop/hbase/procedure/TestProcedureCoordinator.java",0,0.979942693409742,2,1,3
"hbase-server/src/test/java/org/apache/hadoop/hbase/procedure/TestProcedureMember.java",0,0.981981981981982,2,1,3
"hbase-server/src/test/java/org/apache/hadoop/hbase/procedure/TestZKProcedure.java",0,0.97799511002445,1,1,2
"hbase-server/src/test/java/org/apache/hadoop/hbase/procedure/TestZKProcedureControllers.java",0,0.976580796252927,2,1,3
"hbase-server/src/test/java/org/apache/hadoop/hbase/protobuf/TestProtobufUtil.java",0,0.973856209150327,1,1,2
"hbase-server/src/test/java/org/apache/hadoop/hbase/protobuf/TestReplicationProtobuf.java",0,0.960526315789474,1,1,2
"hbase-server/src/test/java/org/apache/hadoop/hbase/regionserver/CreateRandomStoreFile.java",0,0.947882736156352,4,1,5
"hbase-server/src/test/java/org/apache/hadoop/hbase/regionserver/DataBlockEncodingTool.java",0,0.988857938718663,3,1,4
"hbase-server/src/test/java/org/apache/hadoop/hbase/regionserver/EncodedSeekPerformanceTest.java",0,1,0,1,1
"hbase-server/src/test/java/org/apache/hadoop/hbase/regionserver/HFileReadWriteTest.java",0,0.983353151010702,6,1,7
"hbase-server/src/test/java/org/apache/hadoop/hbase/regionserver/KeyValueScanFixture.java",0,0.770833333333333,0,2,2
"hbase-server/src/test/java/org/apache/hadoop/hbase/regionserver/MetricsRegionServerWrapperStub.java",0,0.994845360824742,1,1,2
"hbase-server/src/test/java/org/apache/hadoop/hbase/regionserver/MetricsRegionWrapperStub.java",0,0.661290322580645,0,2,2
"hbase-server/src/test/java/org/apache/hadoop/hbase/regionserver/NoOpScanPolicyObserver.java",0,0.645569620253165,1,3,4
"hbase-server/src/test/java/org/apache/hadoop/hbase/regionserver/OOMERegionServer.java",0,0.863636363636364,6,1,7
"hbase-server/src/test/java/org/apache/hadoop/hbase/regionserver/StatefulStoreMockMaker.java",0,1,0,1,1
"hbase-server/src/test/java/org/apache/hadoop/hbase/regionserver/TestAtomicOperation.java",0,0.53323029366306,1,3,4
"hbase-server/src/test/java/org/apache/hadoop/hbase/regionserver/TestBlocksRead.java",0,0.471491228070175,4,3,7
"hbase-server/src/test/java/org/apache/hadoop/hbase/regionserver/TestBlocksScanned.java",0,0.955555555555556,3,1,4
"hbase-server/src/test/java/org/apache/hadoop/hbase/regionserver/TestCacheOnWriteInSchema.java",0,0.870175438596491,3,2,5
"hbase-server/src/test/java/org/apache/hadoop/hbase/regionserver/TestClusterId.java",0,0.991666666666667,1,1,2
"hbase-server/src/test/java/org/apache/hadoop/hbase/regionserver/TestColumnSeeking.java",0,0.63973063973064,3,2,5
"hbase-server/src/test/java/org/apache/hadoop/hbase/regionserver/TestCompaction.java",0,0.290224032586558,11,6,17
"hbase-server/src/test/java/org/apache/hadoop/hbase/regionserver/TestCompactionState.java",0,0.582978723404255,2,3,5
"hbase-server/src/test/java/org/apache/hadoop/hbase/regionserver/TestCompactionWithCoprocessor.java",0,1,0,1,1
"hbase-server/src/test/java/org/apache/hadoop/hbase/regionserver/TestCompoundBloomFilter.java",0,0.923497267759563,5,1,6
"hbase-server/src/test/java/org/apache/hadoop/hbase/regionserver/TestDefaultCompactSelection.java",0,0.728021978021978,2,4,6
"hbase-server/src/test/java/org/apache/hadoop/hbase/regionserver/TestDefaultStoreEngine.java",0,0.970588235294118,1,1,2
"hbase-server/src/test/java/org/apache/hadoop/hbase/regionserver/TestEndToEndSplitTransaction.java",0,0.53968253968254,2,3,5
"hbase-server/src/test/java/org/apache/hadoop/hbase/regionserver/TestExplicitColumnTracker.java",0,0.325,3,5,8
"hbase-server/src/test/java/org/apache/hadoop/hbase/regionserver/TestFSErrorsExposed.java",0,0.655677655677656,7,3,10
"hbase-server/src/test/java/org/apache/hadoop/hbase/regionserver/TestGetClosestAtOrBefore.java",0,0.971509971509972,4,1,5
"hbase-server/src/test/java/org/apache/hadoop/hbase/regionserver/TestHRegion.java",0,0.517895748258467,17,4,21
"hbase-server/src/test/java/org/apache/hadoop/hbase/regionserver/TestHRegionBusyWait.java",0,0.945652173913043,2,1,3
"hbase-server/src/test/java/org/apache/hadoop/hbase/regionserver/TestHRegionFileSystem.java",0,0.598326359832636,0,2,2
"hbase-server/src/test/java/org/apache/hadoop/hbase/regionserver/TestHRegionInfo.java",0,0.654320987654321,2,4,6
"hbase-server/src/test/java/org/apache/hadoop/hbase/regionserver/TestHRegionOnCluster.java",0,1,0,1,1
"hbase-server/src/test/java/org/apache/hadoop/hbase/regionserver/TestHRegionServerBulkLoad.java",0,0.868263473053892,4,2,6
"hbase-server/src/test/java/org/apache/hadoop/hbase/regionserver/TestJoinedScanners.java",0,0.932960893854749,1,2,3
"hbase-server/src/test/java/org/apache/hadoop/hbase/regionserver/TestKeepDeletes.java",0,0.863414634146341,2,3,5
"hbase-server/src/test/java/org/apache/hadoop/hbase/regionserver/TestKeyValueHeap.java",0,0.558441558441558,1,4,5
"hbase-server/src/test/java/org/apache/hadoop/hbase/regionserver/TestKeyValueScanFixture.java",0,0.885714285714286,1,2,3
"hbase-server/src/test/java/org/apache/hadoop/hbase/regionserver/TestKeyValueSkipListSet.java",0,0.973509933774834,1,1,2
"hbase-server/src/test/java/org/apache/hadoop/hbase/regionserver/TestMasterAddressManager.java",0,0.966101694915254,1,1,2
"hbase-server/src/test/java/org/apache/hadoop/hbase/regionserver/TestMemStore.java",0,0.447467166979362,6,4,10
"hbase-server/src/test/java/org/apache/hadoop/hbase/regionserver/TestMemStoreChunkPool.java",0,1,0,1,1
"hbase-server/src/test/java/org/apache/hadoop/hbase/regionserver/TestMemStoreLAB.java",0,0.971751412429379,2,1,3
"hbase-server/src/test/java/org/apache/hadoop/hbase/regionserver/TestMetricsRegion.java",0,1,0,1,1
"hbase-server/src/test/java/org/apache/hadoop/hbase/regionserver/TestMetricsRegionServer.java",0,0.840909090909091,0,2,2
"hbase-server/src/test/java/org/apache/hadoop/hbase/regionserver/TestMinVersions.java",0,0.955752212389381,2,1,3
"hbase-server/src/test/java/org/apache/hadoop/hbase/regionserver/TestMiniBatchOperationInProgress.java",0,1,0,1,1
"hbase-server/src/test/java/org/apache/hadoop/hbase/regionserver/TestMultiColumnScanner.java",0,0.752212389380531,6,3,9
"hbase-server/src/test/java/org/apache/hadoop/hbase/regionserver/TestMultiVersionConsistencyControl.java",0,0.681818181818182,1,4,5
"hbase-server/src/test/java/org/apache/hadoop/hbase/regionserver/TestParallelPut.java",0,0.954337899543379,3,1,4
"hbase-server/src/test/java/org/apache/hadoop/hbase/regionserver/TestPriorityRpc.java",0,0.959183673469388,3,1,4
"hbase-server/src/test/java/org/apache/hadoop/hbase/regionserver/TestQueryMatcher.java",0,0.411594202898551,4,4,8
"hbase-server/src/test/java/org/apache/hadoop/hbase/regionserver/TestRSStatusServlet.java",0,0.636363636363636,2,2,4
"hbase-server/src/test/java/org/apache/hadoop/hbase/regionserver/TestRegionFavoredNodes.java",0,0.981927710843373,1,1,2
"hbase-server/src/test/java/org/apache/hadoop/hbase/regionserver/TestRegionMergeTransaction.java",0,0.892933618843683,3,2,5
"hbase-server/src/test/java/org/apache/hadoop/hbase/regionserver/TestRegionMergeTransactionOnCluster.java",0,0.696891191709845,1,3,4
"hbase-server/src/test/java/org/apache/hadoop/hbase/regionserver/TestRegionServerMetrics.java",0,0.765536723163842,3,3,6
"hbase-server/src/test/java/org/apache/hadoop/hbase/regionserver/TestRegionServerNoMaster.java",0,0.925333333333333,3,2,5
"hbase-server/src/test/java/org/apache/hadoop/hbase/regionserver/TestRegionSplitPolicy.java",0,0.375862068965517,1,5,6
"hbase-server/src/test/java/org/apache/hadoop/hbase/regionserver/TestResettingCounters.java",0,0.635514018691589,1,3,4
"hbase-server/src/test/java/org/apache/hadoop/hbase/regionserver/TestScanDeleteTracker.java",0,0.474358974358974,1,4,5
"hbase-server/src/test/java/org/apache/hadoop/hbase/regionserver/TestScanWildcardColumnTracker.java",0,0.531746031746032,4,3,7
"hbase-server/src/test/java/org/apache/hadoop/hbase/regionserver/TestScanWithBloomError.java",0,0.883177570093458,4,2,6
"hbase-server/src/test/java/org/apache/hadoop/hbase/regionserver/TestScanner.java",0,0.624365482233503,7,4,11
"hbase-server/src/test/java/org/apache/hadoop/hbase/regionserver/TestSeekOptimizations.java",0,0.93141592920354,7,1,8
"hbase-server/src/test/java/org/apache/hadoop/hbase/regionserver/TestServerCustomProtocol.java",0,0.591101694915254,3,3,6
"hbase-server/src/test/java/org/apache/hadoop/hbase/regionserver/TestSplitLogWorker.java",0,0.863492063492064,4,2,6
"hbase-server/src/test/java/org/apache/hadoop/hbase/regionserver/TestSplitTransaction.java",0,0.815642458100559,5,2,7
"hbase-server/src/test/java/org/apache/hadoop/hbase/regionserver/TestSplitTransactionOnCluster.java",0,0.473399458972047,5,6,11
"hbase-server/src/test/java/org/apache/hadoop/hbase/regionserver/TestStore.java",0,0.464,11,4,15
"hbase-server/src/test/java/org/apache/hadoop/hbase/regionserver/TestStoreFile.java",0,0.315947843530592,4,7,11
"hbase-server/src/test/java/org/apache/hadoop/hbase/regionserver/TestStoreFileBlockCacheSummary.java",0,0.933333333333333,2,1,3
"hbase-server/src/test/java/org/apache/hadoop/hbase/regionserver/TestStoreFileInfo.java",0,1,0,1,1
"hbase-server/src/test/java/org/apache/hadoop/hbase/regionserver/TestStoreScanner.java",0,0.487889273356401,5,4,9
"hbase-server/src/test/java/org/apache/hadoop/hbase/regionserver/TestWideScanner.java",0,0.863309352517986,4,2,6
"hbase-server/src/test/java/org/apache/hadoop/hbase/regionserver/compactions/ConstantSizeFileListGenerator.java",0,1,0,1,1
"hbase-server/src/test/java/org/apache/hadoop/hbase/regionserver/compactions/EverythingPolicy.java",0,0.981481481481482,1,1,2
"hbase-server/src/test/java/org/apache/hadoop/hbase/regionserver/compactions/ExplicitFileListGenerator.java",0,1,0,1,1
"hbase-server/src/test/java/org/apache/hadoop/hbase/regionserver/compactions/GaussianFileListGenerator.java",0,1,0,1,1
"hbase-server/src/test/java/org/apache/hadoop/hbase/regionserver/compactions/MockStoreFileGenerator.java",0,1,0,1,1
"hbase-server/src/test/java/org/apache/hadoop/hbase/regionserver/compactions/PerfTestCompactionPolicies.java",0,0.966183574879227,2,1,3
"hbase-server/src/test/java/org/apache/hadoop/hbase/regionserver/compactions/SemiConstantSizeFileListGenerator.java",0,1,0,1,1
"hbase-server/src/test/java/org/apache/hadoop/hbase/regionserver/compactions/SinusoidalFileListGenerator.java",0,1,0,1,1
"hbase-server/src/test/java/org/apache/hadoop/hbase/regionserver/compactions/SpikyFileListGenerator.java",0,1,0,1,1
"hbase-server/src/test/java/org/apache/hadoop/hbase/regionserver/compactions/StoreFileListGenerator.java",0,1,0,1,1
"hbase-server/src/test/java/org/apache/hadoop/hbase/regionserver/compactions/TestOffPeakHours.java",0,1,0,1,1
"hbase-server/src/test/java/org/apache/hadoop/hbase/regionserver/handler/TestCloseRegionHandler.java",0,0.506726457399103,4,2,6
"hbase-server/src/test/java/org/apache/hadoop/hbase/regionserver/handler/TestOpenRegionHandler.java",0,0.554166666666667,4,3,7
"hbase-server/src/test/java/org/apache/hadoop/hbase/regionserver/wal/FaultySequenceFileLogReader.java",0,0.9375,2,1,3
"hbase-server/src/test/java/org/apache/hadoop/hbase/regionserver/wal/HLogPerformanceEvaluation.java",0,0.991803278688525,1,1,2
"hbase-server/src/test/java/org/apache/hadoop/hbase/regionserver/wal/HLogUtilsForTests.java",0,0.930232558139535,0,2,2
"hbase-server/src/test/java/org/apache/hadoop/hbase/regionserver/wal/InstrumentedSequenceFileLogWriter.java",0,0.925,0,2,2
"hbase-server/src/test/java/org/apache/hadoop/hbase/regionserver/wal/SequenceFileLogWriter.java",0,0.381165919282511,3,5,8
"hbase-server/src/test/java/org/apache/hadoop/hbase/regionserver/wal/TestCompressor.java",0,0.97752808988764,1,1,2
"hbase-server/src/test/java/org/apache/hadoop/hbase/regionserver/wal/TestCustomWALCellCodec.java",0,1,0,1,1
"hbase-server/src/test/java/org/apache/hadoop/hbase/regionserver/wal/TestDurability.java",0,0.982142857142857,1,1,2
"hbase-server/src/test/java/org/apache/hadoop/hbase/regionserver/wal/TestHLog.java",0,0.397344228804903,10,5,15
"hbase-server/src/test/java/org/apache/hadoop/hbase/regionserver/wal/TestHLogFiltering.java",0,0.974358974358974,2,1,3
"hbase-server/src/test/java/org/apache/hadoop/hbase/regionserver/wal/TestHLogMethods.java",0,0.940828402366864,2,1,3
"hbase-server/src/test/java/org/apache/hadoop/hbase/regionserver/wal/TestHLogSplit.java",0,0.69309462915601,7,3,10
"hbase-server/src/test/java/org/apache/hadoop/hbase/regionserver/wal/TestHLogSplitCompressed.java",0,1,0,1,1
"hbase-server/src/test/java/org/apache/hadoop/hbase/regionserver/wal/TestKeyValueCompression.java",0,0.987654320987654,1,1,2
"hbase-server/src/test/java/org/apache/hadoop/hbase/regionserver/wal/TestLRUDictionary.java",0,0.974358974358974,1,1,2
"hbase-server/src/test/java/org/apache/hadoop/hbase/regionserver/wal/TestLogRollAbort.java",0,1,0,1,1
"hbase-server/src/test/java/org/apache/hadoop/hbase/regionserver/wal/TestLogRolling.java",0,0.346094946401225,8,5,13
"hbase-server/src/test/java/org/apache/hadoop/hbase/regionserver/wal/TestLogRollingNoCluster.java",0,0.93006993006993,1,2,3
"hbase-server/src/test/java/org/apache/hadoop/hbase/regionserver/wal/TestWALActionsListener.java",0,0.525714285714286,0,3,3
"hbase-server/src/test/java/org/apache/hadoop/hbase/regionserver/wal/TestWALReplay.java",0,0.758264462809917,8,3,11
"hbase-server/src/test/java/org/apache/hadoop/hbase/regionserver/wal/TestWALReplayCompressed.java",0,1,0,1,1
"hbase-server/src/test/java/org/apache/hadoop/hbase/replication/ReplicationSourceDummy.java",0,0.910112359550562,1,2,3
"hbase-server/src/test/java/org/apache/hadoop/hbase/replication/TestMasterReplication.java",0,0.902298850574713,3,2,5
"hbase-server/src/test/java/org/apache/hadoop/hbase/replication/TestMultiSlaveReplication.java",0,0.884892086330935,1,2,3
"hbase-server/src/test/java/org/apache/hadoop/hbase/replication/TestReplicationBase.java",0,0.923566878980892,2,1,3
"hbase-server/src/test/java/org/apache/hadoop/hbase/replication/TestReplicationChangingPeerRegionservers.java",0,1,0,1,1
"hbase-server/src/test/java/org/apache/hadoop/hbase/replication/TestReplicationDisableInactivePeer.java",0,1,0,1,1
"hbase-server/src/test/java/org/apache/hadoop/hbase/replication/TestReplicationKillMasterRS.java",0,1,0,1,1
"hbase-server/src/test/java/org/apache/hadoop/hbase/replication/TestReplicationKillMasterRSCompressed.java",0,1,0,1,1
"hbase-server/src/test/java/org/apache/hadoop/hbase/replication/TestReplicationKillRS.java",0,1,0,1,1
"hbase-server/src/test/java/org/apache/hadoop/hbase/replication/TestReplicationKillSlaveRS.java",0,1,0,1,1
"hbase-server/src/test/java/org/apache/hadoop/hbase/replication/TestReplicationSmallTests.java",0,0.6875,3,2,5
"hbase-server/src/test/java/org/apache/hadoop/hbase/replication/TestReplicationSource.java",0,0.747826086956522,1,2,3
"hbase-server/src/test/java/org/apache/hadoop/hbase/replication/TestReplicationStateBasic.java",0,0.525179856115108,1,2,3
"hbase-server/src/test/java/org/apache/hadoop/hbase/replication/TestReplicationStateZKImpl.java",0,0.840909090909091,1,2,3
"hbase-server/src/test/java/org/apache/hadoop/hbase/replication/TestReplicationTrackerZKImpl.java",0,1,0,1,1
"hbase-server/src/test/java/org/apache/hadoop/hbase/replication/regionserver/TestReplicationHLogReaderManager.java",0,0.760956175298805,0,2,2
"hbase-server/src/test/java/org/apache/hadoop/hbase/replication/regionserver/TestReplicationSink.java",0,0.675373134328358,1,2,3
"hbase-server/src/test/java/org/apache/hadoop/hbase/replication/regionserver/TestReplicationSinkManager.java",0,1,0,1,1
"hbase-server/src/test/java/org/apache/hadoop/hbase/replication/regionserver/TestReplicationSourceManager.java",0,0.482269503546099,2,3,5
"hbase-server/src/test/java/org/apache/hadoop/hbase/rest/HBaseRESTTestingUtility.java",0,0.761363636363636,2,2,4
"hbase-server/src/test/java/org/apache/hadoop/hbase/rest/PerformanceEvaluation.java",0,0.995983935742972,1,1,2
"hbase-server/src/test/java/org/apache/hadoop/hbase/rest/TestGzipFilter.java",0,0.928571428571429,3,1,4
"hbase-server/src/test/java/org/apache/hadoop/hbase/rest/TestMultiRowResource.java",0,0.948275862068966,3,1,4
"hbase-server/src/test/java/org/apache/hadoop/hbase/rest/TestRowResource.java",0,0.701388888888889,2,2,4
"hbase-server/src/test/java/org/apache/hadoop/hbase/rest/TestScannerResource.java",0,0.790368271954674,2,2,4
"hbase-server/src/test/java/org/apache/hadoop/hbase/rest/TestScannersWithFilters.java",0,0.987987987987988,3,1,4
"hbase-server/src/test/java/org/apache/hadoop/hbase/rest/TestSchemaResource.java",0,0.835227272727273,1,2,3
"hbase-server/src/test/java/org/apache/hadoop/hbase/rest/TestStatusResource.java",0,0.931623931623932,2,1,3
"hbase-server/src/test/java/org/apache/hadoop/hbase/rest/TestTableResource.java",0,0.889312977099237,3,2,5
"hbase-server/src/test/java/org/apache/hadoop/hbase/rest/TestVersionResource.java",0,0.966480446927374,2,1,3
"hbase-server/src/test/java/org/apache/hadoop/hbase/rest/client/TestRemoteTable.java",0,0.929471032745592,3,1,4
"hbase-server/src/test/java/org/apache/hadoop/hbase/rest/model/TestCellModel.java",0,0.953703703703704,2,1,3
"hbase-server/src/test/java/org/apache/hadoop/hbase/rest/model/TestCellSetModel.java",0,0.968354430379747,2,1,3
"hbase-server/src/test/java/org/apache/hadoop/hbase/rest/model/TestColumnSchemaModel.java",0,0.952830188679245,2,1,3
"hbase-server/src/test/java/org/apache/hadoop/hbase/rest/model/TestRowModel.java",0,0.948453608247423,2,1,3
"hbase-server/src/test/java/org/apache/hadoop/hbase/rest/model/TestScannerModel.java",0,0.903703703703704,2,2,4
"hbase-server/src/test/java/org/apache/hadoop/hbase/rest/model/TestStorageClusterStatusModel.java",0,0.747191011235955,1,3,4
"hbase-server/src/test/java/org/apache/hadoop/hbase/rest/model/TestStorageClusterVersionModel.java",0,0.935064935064935,2,1,3
"hbase-server/src/test/java/org/apache/hadoop/hbase/rest/model/TestTableInfoModel.java",0,0.958333333333333,2,1,3
"hbase-server/src/test/java/org/apache/hadoop/hbase/rest/model/TestTableListModel.java",0,0.954954954954955,2,1,3
"hbase-server/src/test/java/org/apache/hadoop/hbase/rest/model/TestTableRegionModel.java",0,0.787037037037037,1,2,3
"hbase-server/src/test/java/org/apache/hadoop/hbase/rest/model/TestTableSchemaModel.java",0,0.962121212121212,2,1,3
"hbase-server/src/test/java/org/apache/hadoop/hbase/rest/model/TestVersionModel.java",0,0.956896551724138,2,1,3
"hbase-server/src/test/java/org/apache/hadoop/hbase/security/TestUser.java",0,0.690909090909091,1,2,3
"hbase-server/src/test/java/org/apache/hadoop/hbase/security/access/SecureTestUtil.java",0,0.741935483870968,1,2,3
"hbase-server/src/test/java/org/apache/hadoop/hbase/security/access/TestAccessControlFilter.java",0,0.833333333333333,2,3,5
"hbase-server/src/test/java/org/apache/hadoop/hbase/security/access/TestAccessController.java",0,0.432354357246028,8,4,12
"hbase-server/src/test/java/org/apache/hadoop/hbase/security/access/TestTablePermissions.java",0,0.604910714285714,3,3,6
"hbase-server/src/test/java/org/apache/hadoop/hbase/security/access/TestZKPermissionsWatcher.java",0,0.91025641025641,1,2,3
"hbase-server/src/test/java/org/apache/hadoop/hbase/security/token/TestTokenAuthentication.java",0,0.83,1,2,3
"hbase-server/src/test/java/org/apache/hadoop/hbase/security/token/TestZKSecretWatcher.java",0,0.968627450980392,1,1,2
"hbase-server/src/test/java/org/apache/hadoop/hbase/snapshot/SnapshotTestingUtils.java",0,0.728440366972477,2,3,5
"hbase-server/src/test/java/org/apache/hadoop/hbase/snapshot/TestCopyRecoveredEditsTask.java",0,1,0,1,1
"hbase-server/src/test/java/org/apache/hadoop/hbase/snapshot/TestExportSnapshot.java",0,0.683734939759036,1,3,4
"hbase-server/src/test/java/org/apache/hadoop/hbase/snapshot/TestFlushSnapshotFromClient.java",0,0.603290676416819,3,3,6
"hbase-server/src/test/java/org/apache/hadoop/hbase/snapshot/TestReferenceRegionHFilesTask.java",0,0.978494623655914,1,1,2
"hbase-server/src/test/java/org/apache/hadoop/hbase/snapshot/TestRestoreFlushSnapshotFromClient.java",0,0.787330316742081,3,2,5
"hbase-server/src/test/java/org/apache/hadoop/hbase/snapshot/TestRestoreSnapshotHelper.java",0,0.813725490196078,0,3,3
"hbase-server/src/test/java/org/apache/hadoop/hbase/snapshot/TestSnapshotDescriptionUtils.java",0,0.971428571428571,1,1,2
"hbase-server/src/test/java/org/apache/hadoop/hbase/snapshot/TestSnapshotLogSplitter.java",0,0.916201117318436,0,2,2
"hbase-server/src/test/java/org/apache/hadoop/hbase/snapshot/TestSnapshotTask.java",0,0.96551724137931,1,1,2
"hbase-server/src/test/java/org/apache/hadoop/hbase/snapshot/TestWALReferenceTask.java",0,0.990291262135922,1,1,2
"hbase-server/src/test/java/org/apache/hadoop/hbase/thrift/TestCallQueue.java",0,0.906976744186046,1,2,3
"hbase-server/src/test/java/org/apache/hadoop/hbase/thrift/TestThriftServer.java",0,0.525,4,4,8
"hbase-server/src/test/java/org/apache/hadoop/hbase/thrift/TestThriftServerCmdLine.java",0,0.897119341563786,2,2,4
"hbase-server/src/test/java/org/apache/hadoop/hbase/thrift2/TestThriftHBaseServiceHandler.java",0,0.515957446808511,2,2,4
"hbase-server/src/test/java/org/apache/hadoop/hbase/trace/TestHTraceHooks.java",0,0.917355371900826,0,2,2
"hbase-server/src/test/java/org/apache/hadoop/hbase/util/HBaseHomePath.java",0,0.970588235294118,1,1,2
"hbase-server/src/test/java/org/apache/hadoop/hbase/util/HFileArchiveTestingUtil.java",0,0.926229508196721,1,2,3
"hbase-server/src/test/java/org/apache/hadoop/hbase/util/LoadTestTool.java",0,0.368243243243243,5,6,11
"hbase-server/src/test/java/org/apache/hadoop/hbase/util/MockRegionServerServices.java",0,0.641509433962264,3,5,8
"hbase-server/src/test/java/org/apache/hadoop/hbase/util/MockServer.java",0,0.946428571428571,2,1,3
"hbase-server/src/test/java/org/apache/hadoop/hbase/util/MultiThreadedAction.java",0,0.397119341563786,2,3,5
"hbase-server/src/test/java/org/apache/hadoop/hbase/util/MultiThreadedReader.java",0,0.842271293375394,3,2,5
"hbase-server/src/test/java/org/apache/hadoop/hbase/util/MultiThreadedUpdater.java",0,1,0,1,1
"hbase-server/src/test/java/org/apache/hadoop/hbase/util/MultiThreadedWriter.java",0,0.676258992805755,2,3,5
"hbase-server/src/test/java/org/apache/hadoop/hbase/util/MultiThreadedWriterBase.java",0,1,0,1,1
"hbase-server/src/test/java/org/apache/hadoop/hbase/util/ProcessBasedLocalHBaseCluster.java",0,0.50179211469534,1,2,3
"hbase-server/src/test/java/org/apache/hadoop/hbase/util/RestartMetaTest.java",0,0.849673202614379,3,2,5
"hbase-server/src/test/java/org/apache/hadoop/hbase/util/StoppableImplementation.java",0,1,0,1,1
"hbase-server/src/test/java/org/apache/hadoop/hbase/util/TestByteBloomFilter.java",0,0.738095238095238,0,2,2
"hbase-server/src/test/java/org/apache/hadoop/hbase/util/TestByteBufferUtils.java",0,0.963076923076923,1,1,2
"hbase-server/src/test/java/org/apache/hadoop/hbase/util/TestCompressionTest.java",0,0.457746478873239,2,3,5
"hbase-server/src/test/java/org/apache/hadoop/hbase/util/TestCoprocessorScanPolicy.java",0,0.792517006802721,2,4,6
"hbase-server/src/test/java/org/apache/hadoop/hbase/util/TestDefaultEnvironmentEdge.java",0,0.907407407407407,1,2,3
"hbase-server/src/test/java/org/apache/hadoop/hbase/util/TestFSHDFSUtils.java",0,0.954128440366973,1,1,2
"hbase-server/src/test/java/org/apache/hadoop/hbase/util/TestFSTableDescriptors.java",0,0.882943143812709,4,2,6
"hbase-server/src/test/java/org/apache/hadoop/hbase/util/TestFSUtils.java",0,0.542944785276074,1,4,5
"hbase-server/src/test/java/org/apache/hadoop/hbase/util/TestFSVisitor.java",0,1,0,1,1
"hbase-server/src/test/java/org/apache/hadoop/hbase/util/TestHBaseFsck.java",0,0.4070042593469,6,4,10
"hbase-server/src/test/java/org/apache/hadoop/hbase/util/TestHBaseFsckComparator.java",0,0.970588235294118,1,1,2
"hbase-server/src/test/java/org/apache/hadoop/hbase/util/TestHFileArchiveUtil.java",0,0.794117647058823,0,2,2
"hbase-server/src/test/java/org/apache/hadoop/hbase/util/TestIdLock.java",0,0.93859649122807,2,1,3
"hbase-server/src/test/java/org/apache/hadoop/hbase/util/TestIncrementingEnvironmentEdge.java",0,0.844444444444444,2,2,4
"hbase-server/src/test/java/org/apache/hadoop/hbase/util/TestKeying.java",0,0.787878787878788,0,3,3
"hbase-server/src/test/java/org/apache/hadoop/hbase/util/TestMergeTable.java",0,0.810344827586207,3,2,5
"hbase-server/src/test/java/org/apache/hadoop/hbase/util/TestMergeTool.java",0,0.493333333333333,5,3,8
"hbase-server/src/test/java/org/apache/hadoop/hbase/util/TestMiniClusterLoadEncoded.java",0,1,0,1,1
"hbase-server/src/test/java/org/apache/hadoop/hbase/util/TestMiniClusterLoadParallel.java",0,0.866666666666667,0,2,2
"hbase-server/src/test/java/org/apache/hadoop/hbase/util/TestMiniClusterLoadSequential.java",0,0.566666666666667,5,4,9
"hbase-server/src/test/java/org/apache/hadoop/hbase/util/TestPoolMap.java",0,0.948497854077253,3,1,4
"hbase-server/src/test/java/org/apache/hadoop/hbase/util/TestProcessBasedCluster.java",0,0.946236559139785,0,2,2
"hbase-server/src/test/java/org/apache/hadoop/hbase/util/TestRegionSplitCalculator.java",0,0.81360201511335,2,3,5
"hbase-server/src/test/java/org/apache/hadoop/hbase/util/TestRegionSplitter.java",0,0.953079178885631,2,1,3
"hbase-server/src/test/java/org/apache/hadoop/hbase/util/TestRootPath.java",0,0.895522388059702,1,2,3
"hbase-server/src/test/java/org/apache/hadoop/hbase/util/TestSortedCopyOnWriteSet.java",0,0.953271028037383,2,1,3
"hbase-server/src/test/java/org/apache/hadoop/hbase/util/TestTableName.java",0,1,0,1,1
"hbase-server/src/test/java/org/apache/hadoop/hbase/util/hbck/HbckTestingUtil.java",0,0.428571428571429,2,4,6
"hbase-server/src/test/java/org/apache/hadoop/hbase/util/hbck/OfflineMetaRebuildTestCore.java",0,0.810344827586207,2,2,4
"hbase-server/src/test/java/org/apache/hadoop/hbase/util/hbck/TestOfflineMetaRebuildBase.java",0,0.901098901098901,2,2,4
"hbase-server/src/test/java/org/apache/hadoop/hbase/util/hbck/TestOfflineMetaRebuildHole.java",0,0.807692307692308,1,2,3
"hbase-server/src/test/java/org/apache/hadoop/hbase/util/hbck/TestOfflineMetaRebuildOverlap.java",0,0.833333333333333,1,2,3
"hbase-server/src/test/java/org/apache/hadoop/hbase/zookeeper/TestHQuorumPeer.java",0,0.818181818181818,2,3,5
"hbase-server/src/test/java/org/apache/hadoop/hbase/zookeeper/TestRecoverableZooKeeper.java",0,1,0,1,1
"hbase-server/src/test/java/org/apache/hadoop/hbase/zookeeper/TestZKConfig.java",0,1,0,1,1
"hbase-server/src/test/java/org/apache/hadoop/hbase/zookeeper/TestZKLeaderManager.java",0,0.961538461538462,1,1,2
"hbase-server/src/test/java/org/apache/hadoop/hbase/zookeeper/TestZKMulti.java",0,1,0,1,1
"hbase-server/src/test/java/org/apache/hadoop/hbase/zookeeper/TestZKTable.java",0,0.845454545454545,0,2,2
"hbase-server/src/test/java/org/apache/hadoop/hbase/zookeeper/TestZooKeeperACL.java",0,0.98134328358209,1,1,2
"hbase-server/src/test/java/org/apache/hadoop/hbase/zookeeper/TestZooKeeperMainServer.java",0,0.863636363636364,1,2,3
"hbase-server/src/test/java/org/apache/hadoop/hbase/zookeeper/TestZooKeeperNodeTracker.java",0,0.917613636363636,1,2,3
"hbase-server/src/test/java/org/apache/hadoop/hbase/zookeeper/lock/TestZKInterProcessReadWriteLock.java",0,1,0,1,1
"bin/get-active-master.rb",0,0.977272727272727,1,1,2
"bin/hirb.rb",0,0.851851851851852,3,2,5
"bin/region_mover.rb",0,0.910869565217391,1,2,3
"bin/region_status.rb",0,0.953333333333333,2,1,3
"bin/replication/copy_tables_desc.rb",0,1,0,1,1
"hbase-examples/src/main/cpp/DemoClient.cpp",0,0.840764331210191,0,2,2
"hbase-examples/src/main/cpp/gen-cpp/Hbase.cpp",0,1,0,1,1
"hbase-examples/src/main/cpp/gen-cpp/Hbase.h",0,1,0,1,1
"hbase-examples/src/main/cpp/gen-cpp/Hbase_constants.cpp",0,1,0,1,1
"hbase-examples/src/main/cpp/gen-cpp/Hbase_constants.h",0,1,0,1,1
"hbase-examples/src/main/cpp/gen-cpp/Hbase_server.skeleton.cpp",0,1,0,1,1
"hbase-examples/src/main/cpp/gen-cpp/Hbase_types.cpp",0,1,0,1,1
"hbase-examples/src/main/cpp/gen-cpp/Hbase_types.h",0,1,0,1,1
"hbase-examples/src/main/python/thrift1/DemoClient.py",0,1,0,1,1
"hbase-examples/src/main/python/thrift1/gen-py/hbase/Hbase.py",0,1,0,1,1
"hbase-examples/src/main/python/thrift1/gen-py/hbase/__init__.py",0,1,0,1,1
"hbase-examples/src/main/python/thrift1/gen-py/hbase/constants.py",0,1,0,1,1
"hbase-examples/src/main/python/thrift1/gen-py/hbase/ttypes.py",0,1,0,1,1
"hbase-examples/src/main/python/thrift2/DemoClient.py",0,1,0,1,1
"hbase-examples/src/main/python/thrift2/gen-py/hbase/THBaseService.py",0,1,0,1,1
"hbase-examples/src/main/python/thrift2/gen-py/hbase/__init__.py",0,1,0,1,1
"hbase-examples/src/main/python/thrift2/gen-py/hbase/constants.py",0,1,0,1,1
"hbase-examples/src/main/python/thrift2/gen-py/hbase/ttypes.py",0,1,0,1,1
"hbase-examples/src/main/ruby/DemoClient.rb",0,0.762845849802372,0,2,2
"hbase-examples/src/main/ruby/gen-rb/hbase.rb",0,1,0,1,1
"hbase-examples/src/main/ruby/gen-rb/hbase_constants.rb",0,1,0,1,1
"hbase-examples/src/main/ruby/gen-rb/hbase_types.rb",0,1,0,1,1
"hbase-examples/src/main/ruby/index-builder-setup.rb",0,0.516129032258065,0,2,2
"hbase-server/src/main/native/src/mlockall_agent/mlockall_agent.c",0,1,0,1,1
"hbase-server/src/main/python/hbase/merge_conf.py",0,0.901960784313726,0,2,2
"hbase-server/src/main/ruby/hbase.rb",0,0.6875,5,2,7
"hbase-server/src/main/ruby/hbase/admin.rb",0,0.770631067961165,14,1,15
"hbase-server/src/main/ruby/hbase/hbase.rb",0,0.525423728813559,0,4,4
"hbase-server/src/main/ruby/hbase/replication_admin.rb",0,0.842105263157895,1,3,4
"hbase-server/src/main/ruby/hbase/security.rb",0,0.505813953488372,0,3,3
"hbase-server/src/main/ruby/hbase/table.rb",0,0.922077922077922,6,1,7
"hbase-server/src/main/ruby/irb/hirb.rb",0,0.677966101694915,0,2,2
"hbase-server/src/main/ruby/shell.rb",0,0.792507204610951,6,2,8
"hbase-server/src/main/ruby/shell/commands.rb",0,0.734042553191489,2,2,4
"hbase-server/src/main/ruby/shell/commands/add_peer.rb",0,0.813953488372093,0,2,2
"hbase-server/src/main/ruby/shell/commands/alter.rb",0,0.571428571428571,1,2,3
"hbase-server/src/main/ruby/shell/commands/alter_async.rb",0,1,0,1,1
"hbase-server/src/main/ruby/shell/commands/alter_namespace.rb",0,1,0,1,1
"hbase-server/src/main/ruby/shell/commands/alter_status.rb",0,1,0,1,1
"hbase-server/src/main/ruby/shell/commands/assign.rb",0,0.513513513513513,0,4,4
"hbase-server/src/main/ruby/shell/commands/balance_switch.rb",0,0.547619047619048,0,2,2
"hbase-server/src/main/ruby/shell/commands/balancer.rb",0,0.475,0,3,3
"hbase-server/src/main/ruby/shell/commands/catalogjanitor_enabled.rb",0,1,0,1,1
"hbase-server/src/main/ruby/shell/commands/catalogjanitor_run.rb",0,1,0,1,1
"hbase-server/src/main/ruby/shell/commands/catalogjanitor_switch.rb",0,1,0,1,1
"hbase-server/src/main/ruby/shell/commands/clone_snapshot.rb",0,0.95,0,2,2
"hbase-server/src/main/ruby/shell/commands/close_region.rb",0,0.666666666666667,0,2,2
"hbase-server/src/main/ruby/shell/commands/compact.rb",0,0.404255319148936,0,3,3
"hbase-server/src/main/ruby/shell/commands/count.rb",0,0.671052631578947,0,3,3
"hbase-server/src/main/ruby/shell/commands/create.rb",0,0.676470588235294,1,2,3
"hbase-server/src/main/ruby/shell/commands/create_namespace.rb",0,1,0,1,1
"hbase-server/src/main/ruby/shell/commands/delete.rb",0,0.648148148148148,0,2,2
"hbase-server/src/main/ruby/shell/commands/delete_snapshot.rb",0,1,0,1,1
"hbase-server/src/main/ruby/shell/commands/deleteall.rb",0,0.614035087719298,0,3,3
"hbase-server/src/main/ruby/shell/commands/describe.rb",0,0.536585365853659,0,2,2
"hbase-server/src/main/ruby/shell/commands/describe_namespace.rb",0,1,0,1,1
"hbase-server/src/main/ruby/shell/commands/disable.rb",0,0.527777777777778,0,2,2
"hbase-server/src/main/ruby/shell/commands/disable_all.rb",0,0.979591836734694,1,1,2
"hbase-server/src/main/ruby/shell/commands/disable_peer.rb",0,0.878048780487805,0,2,2
"hbase-server/src/main/ruby/shell/commands/drop.rb",0,0.527777777777778,0,2,2
"hbase-server/src/main/ruby/shell/commands/drop_all.rb",0,0.979591836734694,1,1,2
"hbase-server/src/main/ruby/shell/commands/drop_namespace.rb",0,1,0,1,1
"hbase-server/src/main/ruby/shell/commands/enable.rb",0,0.527777777777778,0,2,2
"hbase-server/src/main/ruby/shell/commands/enable_all.rb",0,0.979591836734694,1,1,2
"hbase-server/src/main/ruby/shell/commands/enable_peer.rb",0,0.878048780487805,0,2,2
"hbase-server/src/main/ruby/shell/commands/exists.rb",0,0.5,0,2,2
"hbase-server/src/main/ruby/shell/commands/flush.rb",0,0.525,0,2,2
"hbase-server/src/main/ruby/shell/commands/get.rb",0,0.791208791208791,0,2,2
"hbase-server/src/main/ruby/shell/commands/get_counter.rb",0,0.641509433962264,0,2,2
"hbase-server/src/main/ruby/shell/commands/get_table.rb",0,1,0,1,1
"hbase-server/src/main/ruby/shell/commands/grant.rb",0,0.931818181818182,0,2,2
"hbase-server/src/main/ruby/shell/commands/hlog_roll.rb",0,1,0,1,1
"hbase-server/src/main/ruby/shell/commands/incr.rb",0,0.654545454545455,0,2,2
"hbase-server/src/main/ruby/shell/commands/is_disabled.rb",0,1,0,1,1
"hbase-server/src/main/ruby/shell/commands/is_enabled.rb",0,1,0,1,1
"hbase-server/src/main/ruby/shell/commands/list.rb",0,0.404255319148936,1,3,4
"hbase-server/src/main/ruby/shell/commands/list_namespace.rb",0,1,0,1,1
"hbase-server/src/main/ruby/shell/commands/list_namespace_tables.rb",0,1,0,1,1
"hbase-server/src/main/ruby/shell/commands/list_peers.rb",0,0.936170212765957,0,2,2
"hbase-server/src/main/ruby/shell/commands/list_replicated_tables.rb",0,1,0,1,1
"hbase-server/src/main/ruby/shell/commands/list_snapshots.rb",0,1,0,1,1
"hbase-server/src/main/ruby/shell/commands/major_compact.rb",0,0.395833333333333,0,3,3
"hbase-server/src/main/ruby/shell/commands/merge_region.rb",0,1,0,1,1
"hbase-server/src/main/ruby/shell/commands/move.rb",0,0.595744680851064,0,2,2
"hbase-server/src/main/ruby/shell/commands/put.rb",0,0.634615384615385,0,2,2
"hbase-server/src/main/ruby/shell/commands/remove_peer.rb",0,0.897435897435897,0,2,2
"hbase-server/src/main/ruby/shell/commands/rename_snapshot.rb",0,1,0,1,1
"hbase-server/src/main/ruby/shell/commands/restore_snapshot.rb",0,1,0,1,1
"hbase-server/src/main/ruby/shell/commands/revoke.rb",0,0.897435897435897,0,2,2
"hbase-server/src/main/ruby/shell/commands/scan.rb",0,0.754545454545455,1,3,4
"hbase-server/src/main/ruby/shell/commands/show_filters.rb",0,1,0,1,1
"hbase-server/src/main/ruby/shell/commands/snapshot.rb",0,1,0,1,1
"hbase-server/src/main/ruby/shell/commands/split.rb",0,0.452380952380952,0,3,3
"hbase-server/src/main/ruby/shell/commands/status.rb",0,0.525,0,2,2
"hbase-server/src/main/ruby/shell/commands/table_help.rb",0,1,0,1,1
"hbase-server/src/main/ruby/shell/commands/truncate.rb",0,0.5,0,2,2
"hbase-server/src/main/ruby/shell/commands/truncate_preserve.rb",0,1,0,1,1
"hbase-server/src/main/ruby/shell/commands/unassign.rb",0,0.488372093023256,0,3,3
"hbase-server/src/main/ruby/shell/commands/user_permission.rb",0,0.936170212765957,0,2,2
"hbase-server/src/main/ruby/shell/commands/version.rb",0,0.513513513513513,0,2,2
"hbase-server/src/main/ruby/shell/commands/whoami.rb",0,1,0,1,1
"hbase-server/src/main/ruby/shell/commands/zk_dump.rb",0,0.558823529411765,0,2,2
"hbase-server/src/main/ruby/shell/formatter.rb",0,0.858823529411765,1,2,3
"hbase-server/src/test/ruby/hbase/admin_test.rb",0,0.815561959654179,1,2,3
"hbase-server/src/test/ruby/hbase/hbase_test.rb",0,0.591836734693878,1,2,3
"hbase-server/src/test/ruby/hbase/table_test.rb",0,0.962745098039216,1,1,2
"hbase-server/src/test/ruby/shell/commands_test.rb",0,0.558823529411765,0,2,2
"hbase-server/src/test/ruby/shell/formatter_test.rb",0,0.720588235294118,0,2,2
"hbase-server/src/test/ruby/shell/shell_test.rb",0,0.710144927536232,1,2,3
"hbase-server/src/test/ruby/test_helper.rb",0,1,0,1,1
"hbase-server/src/test/ruby/tests_runner.rb",0,0.707692307692308,0,2,2
