"Filename","X","LineOWN","LineMinor","LineMajor","LineNumDev"
"maven/jruby-rake-plugin/src/main/java/org/jruby/maven/AbstractJRubyMojo.java",0,1,0,1,1
"maven/jruby-rake-plugin/src/main/java/org/jruby/maven/GemMojo.java",0,1,0,1,1
"maven/jruby-rake-plugin/src/main/java/org/jruby/maven/IRBMojo.java",0,1,0,1,1
"maven/jruby-rake-plugin/src/main/java/org/jruby/maven/InstallGemsMojo.java",0,1,0,1,1
"maven/jruby-rake-plugin/src/main/java/org/jruby/maven/JRubyMojo.java",0,1,0,1,1
"maven/jruby-rake-plugin/src/main/java/org/jruby/maven/RakeMojo.java",0,1,0,1,1
"src/org/jruby/CompatVersion.java",0,1,0,1,1
"src/org/jruby/Finalizable.java",0,1,0,1,1
"src/org/jruby/IErrno.java",0,0.677165354330709,0,3,3
"src/org/jruby/IncludedModuleWrapper.java",0,0.580858085808581,3,4,7
"src/org/jruby/JRubyApplet.java",0,1,0,1,1
"src/org/jruby/JRubyClient.java",0,1,0,1,1
"src/org/jruby/JRubyServer.java",0,0.980769230769231,1,1,2
"src/org/jruby/JRubyService.java",0,1,0,1,1
"src/org/jruby/Main.java",0,0.398936170212766,6,5,11
"src/org/jruby/MetaClass.java",0,0.354430379746835,1,4,5
"src/org/jruby/NativeException.java",0,0.722772277227723,0,3,3
"src/org/jruby/Profile.java",0,1,0,1,1
"src/org/jruby/Ruby.java",0,0.620588235294118,8,4,12
"src/org/jruby/RubyArgsFile.java",0,0.674364896073903,1,4,5
"src/org/jruby/RubyArray.java",0,0.55564681724846,8,4,12
"src/org/jruby/RubyBigDecimal.java",0,0.553398058252427,0,6,6
"src/org/jruby/RubyBignum.java",0,0.509433962264151,4,5,9
"src/org/jruby/RubyBinding.java",0,0.717241379310345,1,2,3
"src/org/jruby/RubyBoolean.java",0,0.327160493827161,2,5,7
"src/org/jruby/RubyClass.java",0,0.395196506550218,4,4,8
"src/org/jruby/RubyClassPathVariable.java",0,0.91578947368421,1,2,3
"src/org/jruby/RubyComparable.java",0,0.394088669950739,1,4,5
"src/org/jruby/RubyContinuation.java",0,0.88,0,2,2
"src/org/jruby/RubyDigest.java",0,0.454268292682927,2,4,6
"src/org/jruby/RubyDir.java",0,0.386481802426343,5,3,8
"src/org/jruby/RubyEnumerable.java",0,0.615094339622641,0,4,4
"src/org/jruby/RubyEnumerator.java",0,0.548022598870056,1,4,5
"src/org/jruby/RubyEtc.java",0,0.716814159292035,1,2,3
"src/org/jruby/RubyException.java",0,0.310756972111554,7,5,12
"src/org/jruby/RubyFile.java",0,0.489281210592686,8,4,12
"src/org/jruby/RubyFileStat.java",0,0.769633507853403,5,2,7
"src/org/jruby/RubyFileTest.java",0,0.702602230483271,3,4,7
"src/org/jruby/RubyFixnum.java",0,0.438280166435506,5,4,9
"src/org/jruby/RubyFloat.java",0,0.532203389830509,6,4,10
"src/org/jruby/RubyGC.java",0,0.461538461538462,1,5,6
"src/org/jruby/RubyGlobal.java",0,0.302047781569966,3,5,8
"src/org/jruby/RubyHash.java",0,0.415853658536585,8,3,11
"src/org/jruby/RubyIO.java",0,0.614537444933921,7,2,9
"src/org/jruby/RubyIconv.java",0,0.882530120481928,2,2,4
"src/org/jruby/RubyInstanceConfig.java",0,0.627180899908173,1,3,4
"src/org/jruby/RubyInteger.java",0,0.432314410480349,3,4,7
"src/org/jruby/RubyJRuby.java",0,0.397540983606557,2,4,6
"src/org/jruby/RubyKernel.java",0,0.369191049913941,7,4,11
"src/org/jruby/RubyLocalJumpError.java",0,0.942028985507246,0,2,2
"src/org/jruby/RubyMarshal.java",0,0.347826086956522,3,5,8
"src/org/jruby/RubyMatchData.java",0,0.363076923076923,4,5,9
"src/org/jruby/RubyMath.java",0,0.835073068893528,2,3,5
"src/org/jruby/RubyMethod.java",0,0.371308016877637,5,4,9
"src/org/jruby/RubyModule.java",0,0.472178560201195,7,6,13
"src/org/jruby/RubyNKF.java",0,0.980519480519481,1,1,2
"src/org/jruby/RubyNameError.java",0,0.571428571428571,0,4,4
"src/org/jruby/RubyNil.java",0,0.359550561797753,3,4,7
"src/org/jruby/RubyNoMethodError.java",0,0.814814814814815,0,3,3
"src/org/jruby/RubyNumeric.java",0,0.474358974358974,5,4,9
"src/org/jruby/RubyObject.java",0,0.332602739726027,5,7,12
"src/org/jruby/RubyObjectAdapter.java",0,1,0,1,1
"src/org/jruby/RubyObjectSpace.java",0,0.312925170068027,3,6,9
"src/org/jruby/RubyPrecision.java",0,0.457831325301205,3,3,6
"src/org/jruby/RubyProc.java",0,0.429787234042553,3,3,6
"src/org/jruby/RubyProcess.java",0,0.732436472346786,3,2,5
"src/org/jruby/RubyRange.java",0,0.367112810707457,7,6,13
"src/org/jruby/RubyRegexp.java",0,0.483870967741935,7,3,10
"src/org/jruby/RubyRuntimeAdapter.java",0,1,0,1,1
"src/org/jruby/RubySignal.java",0,0.644444444444444,1,3,4
"src/org/jruby/RubyString.java",0,0.340941924299335,5,5,10
"src/org/jruby/RubyStringIO.java",0,0.823446327683616,3,2,5
"src/org/jruby/RubyStringScanner.java",0,0.761410788381743,3,2,5
"src/org/jruby/RubyStruct.java",0,0.341137123745819,7,4,11
"src/org/jruby/RubySymbol.java",0,0.379699248120301,8,3,11
"src/org/jruby/RubySystemCallError.java",0,0.423580786026201,1,3,4
"src/org/jruby/RubySystemExit.java",0,0.822222222222222,1,2,3
"src/org/jruby/RubyThread.java",0,0.625149700598802,6,5,11
"src/org/jruby/RubyThreadGroup.java",0,0.663793103448276,3,2,5
"src/org/jruby/RubyTime.java",0,0.420074349442379,8,4,12
"src/org/jruby/RubyUnboundMethod.java",0,0.403361344537815,2,3,5
"src/org/jruby/RubyUndef.java",0,0.795454545454545,2,3,5
"src/org/jruby/RubyYAML.java",0,0.488294314381271,3,2,5
"src/org/jruby/RubyZlib.java",0,0.446828358208955,3,3,6
"src/org/jruby/TopSelfFactory.java",0,0.463414634146341,2,3,5
"src/org/jruby/anno/JRubyMethod.java",0,1,0,1,1
"src/org/jruby/anno/JavaMethodDescriptor.java",0,1,0,1,1
"src/org/jruby/anno/RDoc.java",0,1,0,1,1
"src/org/jruby/ast/AliasNode.java",0,0.481012658227848,1,4,5
"src/org/jruby/ast/AndNode.java",0,0.513157894736842,2,4,6
"src/org/jruby/ast/ArgsCatNode.java",0,0.646153846153846,3,4,7
"src/org/jruby/ast/ArgsNode.java",0,0.460526315789474,3,3,6
"src/org/jruby/ast/ArgsPushNode.java",0,1,0,1,1
"src/org/jruby/ast/ArgumentNode.java",0,0.96969696969697,1,1,2
"src/org/jruby/ast/ArrayNode.java",0,0.52112676056338,1,3,4
"src/org/jruby/ast/AssignableNode.java",0,0.797101449275362,0,3,3
"src/org/jruby/ast/AttrAssignNode.java",0,0.94392523364486,0,2,2
"src/org/jruby/ast/BackRefNode.java",0,0.5,2,4,6
"src/org/jruby/ast/BeginNode.java",0,0.542857142857143,2,3,5
"src/org/jruby/ast/BignumNode.java",0,0.567567567567568,3,4,7
"src/org/jruby/ast/BinaryOperatorNode.java",0,0.595744680851064,0,2,2
"src/org/jruby/ast/BlockAcceptingNode.java",0,0.8,0,2,2
"src/org/jruby/ast/BlockArgNode.java",0,0.616279069767442,3,2,5
"src/org/jruby/ast/BlockNode.java",0,0.642857142857143,1,3,4
"src/org/jruby/ast/BlockPassNode.java",0,0.467391304347826,4,2,6
"src/org/jruby/ast/BreakNode.java",0,0.693333333333333,3,3,6
"src/org/jruby/ast/CallNode.java",0,0.507692307692308,2,3,5
"src/org/jruby/ast/CaseNode.java",0,0.50561797752809,3,3,6
"src/org/jruby/ast/ClassNode.java",0,0.392523364485981,1,4,5
"src/org/jruby/ast/ClassVarAsgnNode.java",0,0.493506493506494,2,4,6
"src/org/jruby/ast/ClassVarDeclNode.java",0,0.513157894736842,1,4,5
"src/org/jruby/ast/ClassVarNode.java",0,0.546666666666667,2,4,6
"src/org/jruby/ast/Colon2Node.java",0,0.538461538461538,2,4,6
"src/org/jruby/ast/Colon3Node.java",0,0.580246913580247,2,4,6
"src/org/jruby/ast/CommentNode.java",0,1,0,1,1
"src/org/jruby/ast/ConstDeclNode.java",0,0.6,3,3,6
"src/org/jruby/ast/ConstNode.java",0,0.5,1,4,5
"src/org/jruby/ast/DAsgnNode.java",0,0.343137254901961,3,4,7
"src/org/jruby/ast/DRegexpNode.java",0,0.386792452830189,2,3,5
"src/org/jruby/ast/DStrNode.java",0,0.6,2,3,5
"src/org/jruby/ast/DSymbolNode.java",0,0.947368421052632,0,2,2
"src/org/jruby/ast/DVarNode.java",0,0.413461538461538,2,3,5
"src/org/jruby/ast/DXStrNode.java",0,0.666666666666667,0,4,4
"src/org/jruby/ast/DefinedNode.java",0,0.527777777777778,2,3,5
"src/org/jruby/ast/DefnNode.java",0,0.544303797468354,3,4,7
"src/org/jruby/ast/DefsNode.java",0,0.575,2,4,6
"src/org/jruby/ast/DotNode.java",0,0.542857142857143,4,2,6
"src/org/jruby/ast/EnsureNode.java",0,0.5125,2,3,5
"src/org/jruby/ast/EvStrNode.java",0,0.540540540540541,4,3,7
"src/org/jruby/ast/FCallNode.java",0,0.457627118644068,3,4,7
"src/org/jruby/ast/FalseNode.java",0,0.686567164179104,3,2,5
"src/org/jruby/ast/FixnumNode.java",0,0.558139534883721,2,4,6
"src/org/jruby/ast/FlipNode.java",0,0.367521367521368,3,3,6
"src/org/jruby/ast/FloatNode.java",0,0.613333333333333,2,4,6
"src/org/jruby/ast/ForNode.java",0,0.576923076923077,1,3,4
"src/org/jruby/ast/GlobalAsgnNode.java",0,0.52,2,4,6
"src/org/jruby/ast/GlobalVarNode.java",0,0.52112676056338,1,4,5
"src/org/jruby/ast/HashNode.java",0,0.535211267605634,2,3,5
"src/org/jruby/ast/IArgumentNode.java",0,1,0,1,1
"src/org/jruby/ast/IScopingNode.java",0,0.882352941176471,0,2,2
"src/org/jruby/ast/IfNode.java",0,0.483516483516484,2,3,5
"src/org/jruby/ast/InstAsgnNode.java",0,0.530864197530864,3,4,7
"src/org/jruby/ast/InstVarNode.java",0,0.623529411764706,3,3,6
"src/org/jruby/ast/IterNode.java",0,0.413461538461538,2,3,5
"src/org/jruby/ast/ListNode.java",0,0.568627450980392,2,3,5
"src/org/jruby/ast/LocalAsgnNode.java",0,0.490566037735849,2,4,6
"src/org/jruby/ast/LocalVarNode.java",0,0.452830188679245,3,3,6
"src/org/jruby/ast/Match2Node.java",0,0.512820512820513,3,3,6
"src/org/jruby/ast/Match3Node.java",0,0.48780487804878,1,4,5
"src/org/jruby/ast/MatchNode.java",0,0.537313432835821,3,3,6
"src/org/jruby/ast/MethodDefNode.java",0,0.898989898989899,0,2,2
"src/org/jruby/ast/ModuleNode.java",0,0.43010752688172,2,4,6
"src/org/jruby/ast/MultipleAsgnNode.java",0,0.48314606741573,2,4,6
"src/org/jruby/ast/NewlineNode.java",0,0.4875,2,4,6
"src/org/jruby/ast/NextNode.java",0,0.693333333333333,3,3,6
"src/org/jruby/ast/NilNode.java",0,0.656716417910448,3,3,6
"src/org/jruby/ast/Node.java",0,0.748299319727891,3,3,6
"src/org/jruby/ast/NodeType.java",0,0.978723404255319,1,1,2
"src/org/jruby/ast/NotNode.java",0,0.535211267605634,3,3,6
"src/org/jruby/ast/NthRefNode.java",0,0.542857142857143,3,3,6
"src/org/jruby/ast/OpAsgnAndNode.java",0,0.506493506493506,2,4,6
"src/org/jruby/ast/OpAsgnNode.java",0,0.407407407407407,3,3,6
"src/org/jruby/ast/OpAsgnOrNode.java",0,0.519480519480519,2,4,6
"src/org/jruby/ast/OpElementAsgnNode.java",0,0.417391304347826,3,3,6
"src/org/jruby/ast/OrNode.java",0,0.506172839506173,3,3,6
"src/org/jruby/ast/PostExeNode.java",0,0.622641509433962,2,3,5
"src/org/jruby/ast/PreExeNode.java",0,1,0,1,1
"src/org/jruby/ast/RedoNode.java",0,0.610169491525424,2,4,6
"src/org/jruby/ast/RegexpNode.java",0,0.483516483516484,4,3,7
"src/org/jruby/ast/RescueBodyNode.java",0,0.56043956043956,3,3,6
"src/org/jruby/ast/RescueNode.java",0,0.494505494505495,4,3,7
"src/org/jruby/ast/RetryNode.java",0,0.610169491525424,2,4,6
"src/org/jruby/ast/ReturnNode.java",0,0.533333333333333,2,3,5
"src/org/jruby/ast/RootNode.java",0,0.96,1,1,2
"src/org/jruby/ast/SClassNode.java",0,0.383838383838384,2,4,6
"src/org/jruby/ast/SValueNode.java",0,0.666666666666667,3,4,7
"src/org/jruby/ast/SelfNode.java",0,0.656716417910448,3,3,6
"src/org/jruby/ast/SplatNode.java",0,0.842105263157895,1,3,4
"src/org/jruby/ast/StarNode.java",0,0.6875,3,3,6
"src/org/jruby/ast/StrNode.java",0,0.592592592592593,2,3,5
"src/org/jruby/ast/SuperNode.java",0,0.619047619047619,3,3,6
"src/org/jruby/ast/SymbolNode.java",0,0.531645569620253,2,6,8
"src/org/jruby/ast/ToAryNode.java",0,0.655172413793103,3,4,7
"src/org/jruby/ast/TrueNode.java",0,0.656716417910448,3,3,6
"src/org/jruby/ast/UndefNode.java",0,0.542857142857143,2,4,6
"src/org/jruby/ast/UntilNode.java",0,0.585106382978723,2,4,6
"src/org/jruby/ast/VAliasNode.java",0,0.469135802469136,2,4,6
"src/org/jruby/ast/VCallNode.java",0,0.5,2,4,6
"src/org/jruby/ast/WhenNode.java",0,0.556818181818182,3,3,6
"src/org/jruby/ast/WhileNode.java",0,0.596153846153846,3,3,6
"src/org/jruby/ast/XStrNode.java",0,0.555555555555556,2,3,5
"src/org/jruby/ast/YieldNode.java",0,0.5625,2,4,6
"src/org/jruby/ast/ZArrayNode.java",0,0.555555555555556,2,3,5
"src/org/jruby/ast/ZSuperNode.java",0,0.692307692307692,3,3,6
"src/org/jruby/ast/ZeroArgNode.java",0,0.671232876712329,2,3,5
"src/org/jruby/ast/executable/AbstractScript.java",0,1,0,1,1
"src/org/jruby/ast/executable/ISeqPosition.java",0,0.818181818181818,0,2,2
"src/org/jruby/ast/executable/RubiniusCMethod.java",0,1,0,1,1
"src/org/jruby/ast/executable/RubiniusInstructions.java",0,1,0,1,1
"src/org/jruby/ast/executable/RubiniusMachine.java",0,0.927113702623907,2,2,4
"src/org/jruby/ast/executable/RubiniusRunner.java",0,0.720670391061452,1,2,3
"src/org/jruby/ast/executable/Script.java",0,1,0,1,1
"src/org/jruby/ast/executable/YARVCompiledRunner.java",0,0.944700460829493,1,2,3
"src/org/jruby/ast/executable/YARVInstructions.java",0,0.834123222748815,0,2,2
"src/org/jruby/ast/executable/YARVMachine.java",0,0.523743016759777,3,3,6
"src/org/jruby/ast/types/IArityNode.java",0,0.82051282051282,1,2,3
"src/org/jruby/ast/types/ILiteralNode.java",0,0.722222222222222,0,2,2
"src/org/jruby/ast/types/INameNode.java",0,0.875,0,2,2
"src/org/jruby/ast/util/ArgsUtil.java",0,0.528846153846154,3,3,6
"src/org/jruby/ast/util/SexpMaker.java",0,1,0,1,1
"src/org/jruby/ast/visitor/AbstractVisitor.java",0,0.363636363636364,0,4,4
"src/org/jruby/ast/visitor/DefaultIteratorVisitor.java",0,0.762688614540466,2,3,5
"src/org/jruby/ast/visitor/NodeVisitor.java",0,0.399141630901288,1,3,4
"src/org/jruby/ast/visitor/rewriter/ClassBodyWriter.java",0,1,0,1,1
"src/org/jruby/ast/visitor/rewriter/DefaultFormatHelper.java",0,0.954954954954955,1,1,2
"src/org/jruby/ast/visitor/rewriter/FormatHelper.java",0,0.904761904761905,0,2,2
"src/org/jruby/ast/visitor/rewriter/ReWriteVisitor.java",0,0.989752863170585,2,1,3
"src/org/jruby/ast/visitor/rewriter/ReWriterFactory.java",0,1,0,1,1
"src/org/jruby/ast/visitor/rewriter/utils/BooleanStateStack.java",0,1,0,1,1
"src/org/jruby/ast/visitor/rewriter/utils/CallDepth.java",0,1,0,1,1
"src/org/jruby/ast/visitor/rewriter/utils/DRegxReWriteVisitor.java",0,1,0,1,1
"src/org/jruby/ast/visitor/rewriter/utils/HereDocReWriteVisitor.java",0,1,0,1,1
"src/org/jruby/ast/visitor/rewriter/utils/HereDocument.java",0,1,0,1,1
"src/org/jruby/ast/visitor/rewriter/utils/IgnoreCommentsReWriteVisitor.java",0,1,0,1,1
"src/org/jruby/ast/visitor/rewriter/utils/Indentor.java",0,1,0,1,1
"src/org/jruby/ast/visitor/rewriter/utils/LocalVariables.java",0,1,0,1,1
"src/org/jruby/ast/visitor/rewriter/utils/MultipleAssignmentReWriteVisitor.java",0,1,0,1,1
"src/org/jruby/ast/visitor/rewriter/utils/Operators.java",0,1,0,1,1
"src/org/jruby/ast/visitor/rewriter/utils/ReWriterContext.java",0,1,0,1,1
"src/org/jruby/ast/visitor/rewriter/utils/ShortIfNodeReWriteVisitor.java",0,1,0,1,1
"src/org/jruby/common/IRubyWarnings.java",0,0.981308411214953,1,1,2
"src/org/jruby/common/NullWarnings.java",0,0.729166666666667,0,2,2
"src/org/jruby/common/RubyWarnings.java",0,0.650602409638554,2,2,4
"src/org/jruby/compiler/ASTCompiler.java",0,0.970006381620932,4,1,5
"src/org/jruby/compiler/ASTInspector.java",0,0.867289719626168,1,2,3
"src/org/jruby/compiler/ArgumentsCallback.java",0,1,0,1,1
"src/org/jruby/compiler/ArrayCallback.java",0,1,0,1,1
"src/org/jruby/compiler/BranchCallback.java",0,1,0,1,1
"src/org/jruby/compiler/CacheCompiler.java",0,1,0,1,1
"src/org/jruby/compiler/CompilerCallback.java",0,1,0,1,1
"src/org/jruby/compiler/InvocationCompiler.java",0,0.95,0,2,2
"src/org/jruby/compiler/JITCompiler.java",0,0.747787610619469,0,2,2
"src/org/jruby/compiler/MethodCompiler.java",0,0.794979079497908,2,2,4
"src/org/jruby/compiler/NotCompilableException.java",0,1,0,1,1
"src/org/jruby/compiler/ScriptCompiler.java",0,1,0,1,1
"src/org/jruby/compiler/VariableCompiler.java",0,0.927536231884058,1,2,3
"src/org/jruby/compiler/YARVNodesCompiler.java",0,0.925,1,2,3
"src/org/jruby/compiler/impl/AbstractVariableCompiler.java",0,0.919117647058823,0,2,2
"src/org/jruby/compiler/impl/BoxedVariableCompiler.java",0,1,0,1,1
"src/org/jruby/compiler/impl/FieldBasedCacheCompiler.java",0,1,0,1,1
"src/org/jruby/compiler/impl/HeapBasedVariableCompiler.java",0,0.991525423728814,1,1,2
"src/org/jruby/compiler/impl/InheritedCacheCompiler.java",0,1,0,1,1
"src/org/jruby/compiler/impl/SkinnyMethodAdapter.java",0,1,0,1,1
"src/org/jruby/compiler/impl/StackBasedVariableCompiler.java",0,0.986013986013986,1,1,2
"src/org/jruby/compiler/impl/StandardASMCompiler.java",0,0.819956616052061,4,2,6
"src/org/jruby/compiler/impl/StandardInvocationCompiler.java",0,0.980582524271845,2,1,3
"src/org/jruby/compiler/yarv/StandardYARVCompiler.java",0,0.678795483061481,1,2,3
"src/org/jruby/demo/IRBApplet.java",0,0.884210526315789,3,2,5
"src/org/jruby/demo/IRBConsole.java",0,0.783783783783784,2,2,4
"src/org/jruby/demo/TextAreaReadline.java",0,0.895348837209302,4,1,5
"src/org/jruby/environment/IOSEnvironmentReader.java",0,0.945454545454545,0,2,2
"src/org/jruby/environment/OSEnvironment.java",0,0.75,2,2,4
"src/org/jruby/environment/OSEnvironmentReaderExcepton.java",0,1,0,1,1
"src/org/jruby/environment/OSEnvironmentReaderFromApacheAnt.java",0,0.976744186046512,1,1,2
"src/org/jruby/environment/OSEnvironmentReaderFromFile.java",0,0.967032967032967,1,1,2
"src/org/jruby/environment/OSEnvironmentReaderFromJava5SystemGetenv.java",0,0.968085106382979,1,1,2
"src/org/jruby/environment/OSEnvironmentReaderFromRuntimeExec.java",0,0.794117647058823,0,3,3
"src/org/jruby/evaluator/ASTInterpreter.java",0,0.732723112128146,4,3,7
"src/org/jruby/evaluator/AssignmentVisitor.java",0,0.630252100840336,3,3,6
"src/org/jruby/evaluator/Instruction.java",0,1,0,1,1
"src/org/jruby/evaluator/ValueConverter.java",0,0.636363636363636,4,2,6
"src/org/jruby/evaluator/WantsRetry.java",0,1,0,1,1
"src/org/jruby/evaluator/WantsReturn.java",0,1,0,1,1
"src/org/jruby/exceptions/JumpException.java",0,0.514285714285714,3,3,6
"src/org/jruby/exceptions/MainExitException.java",0,0.786666666666667,0,2,2
"src/org/jruby/exceptions/RaiseException.java",0,0.261363636363636,1,7,8
"src/org/jruby/exceptions/ThreadKill.java",0,0.78125,0,2,2
"src/org/jruby/ext/Generator.java",0,0.928783382789317,3,1,4
"src/org/jruby/ext/JRubyPOSIXHandler.java",0,0.943181818181818,0,2,2
"src/org/jruby/ext/LateLoadingLibrary.java",0,0.983333333333333,1,1,2
"src/org/jruby/ext/Readline.java",0,0.604651162790698,3,3,6
"src/org/jruby/ext/WeakRef.java",0,0.978494623655914,1,1,2
"src/org/jruby/ext/posix/BaseNativeFileStat.java",0,1,0,1,1
"src/org/jruby/ext/posix/BaseNativePOSIX.java",0,0.591836734693878,0,3,3
"src/org/jruby/ext/posix/FileStat.java",0,1,0,1,1
"src/org/jruby/ext/posix/Group.java",0,1,0,1,1
"src/org/jruby/ext/posix/JavaFileStat.java",0,0.971061093247588,1,1,2
"src/org/jruby/ext/posix/JavaLibCHelper.java",0,0.928934010152284,3,1,4
"src/org/jruby/ext/posix/JavaPOSIX.java",0,0.813559322033898,1,2,3
"src/org/jruby/ext/posix/JavaPasswd.java",0,0.907692307692308,0,2,2
"src/org/jruby/ext/posix/LibC.java",0,0.609756097560976,0,3,3
"src/org/jruby/ext/posix/LinuxFileStat.java",0,1,0,1,1
"src/org/jruby/ext/posix/LinuxLibC.java",0,1,0,1,1
"src/org/jruby/ext/posix/LinuxPOSIX.java",0,1,0,1,1
"src/org/jruby/ext/posix/MacOSFileStat.java",0,1,0,1,1
"src/org/jruby/ext/posix/MacOSPOSIX.java",0,1,0,1,1
"src/org/jruby/ext/posix/NativeGroup.java",0,1,0,1,1
"src/org/jruby/ext/posix/NativePasswd.java",0,0.895833333333333,0,2,2
"src/org/jruby/ext/posix/POSIX.java",0,0.76271186440678,0,3,3
"src/org/jruby/ext/posix/POSIXFactory.java",0,0.768292682926829,0,2,2
"src/org/jruby/ext/posix/POSIXFunctionMapper.java",0,1,0,1,1
"src/org/jruby/ext/posix/POSIXHandler.java",0,1,0,1,1
"src/org/jruby/ext/posix/Passwd.java",0,0.928571428571429,0,2,2
"src/org/jruby/ext/posix/SolarisFileStat.java",0,1,0,1,1
"src/org/jruby/ext/posix/SolarisLibC.java",0,1,0,1,1
"src/org/jruby/ext/posix/SolarisPOSIX.java",0,1,0,1,1
"src/org/jruby/ext/posix/WindowsFileStat.java",0,1,0,1,1
"src/org/jruby/ext/posix/WindowsLibC.java",0,1,0,1,1
"src/org/jruby/ext/posix/WindowsLibCFunctionMapper.java",0,0.970588235294118,1,1,2
"src/org/jruby/ext/posix/WindowsPOSIX.java",0,0.939393939393939,2,1,3
"src/org/jruby/ext/posix/util/Chmod.java",0,0.95,0,2,2
"src/org/jruby/ext/posix/util/ExecIt.java",0,1,0,1,1
"src/org/jruby/ext/posix/util/FieldAccess.java",0,1,0,1,1
"src/org/jruby/ext/posix/util/Platform.java",0,0.956521739130435,2,1,3
"src/org/jruby/ext/socket/IANA.java",0,1,0,1,1
"src/org/jruby/ext/socket/RubyBasicSocket.java",0,0.902298850574713,2,2,4
"src/org/jruby/ext/socket/RubyIPSocket.java",0,0.909090909090909,1,2,3
"src/org/jruby/ext/socket/RubySocket.java",0,0.764485981308411,3,2,5
"src/org/jruby/ext/socket/RubyTCPServer.java",0,0.468181818181818,1,3,4
"src/org/jruby/ext/socket/RubyTCPSocket.java",0,0.6875,2,3,5
"src/org/jruby/ext/socket/RubyUDPSocket.java",0,0.538461538461538,1,2,3
"src/org/jruby/ext/socket/RubyUNIXServer.java",0,1,0,1,1
"src/org/jruby/ext/socket/RubyUNIXSocket.java",0,0.898,2,2,4
"src/org/jruby/internal/runtime/FutureThread.java",0,0.979020979020979,1,1,2
"src/org/jruby/internal/runtime/GlobalVariable.java",0,0.396396396396396,1,3,4
"src/org/jruby/internal/runtime/GlobalVariables.java",0,0.524590163934426,2,4,6
"src/org/jruby/internal/runtime/JumpTarget.java",0,1,0,1,1
"src/org/jruby/internal/runtime/NativeThread.java",0,0.701149425287356,1,2,3
"src/org/jruby/internal/runtime/ReadonlyAccessor.java",0,0.542372881355932,2,2,4
"src/org/jruby/internal/runtime/RubyNativeThread.java",0,0.651685393258427,1,2,3
"src/org/jruby/internal/runtime/RubyRunnable.java",0,0.968421052631579,2,1,3
"src/org/jruby/internal/runtime/ThreadLike.java",0,0.980392156862745,1,1,2
"src/org/jruby/internal/runtime/ThreadService.java",0,0.609302325581395,2,4,6
"src/org/jruby/internal/runtime/UndefinedAccessor.java",0,0.540540540540541,1,2,3
"src/org/jruby/internal/runtime/ValueAccessor.java",0,0.545454545454545,0,2,2
"src/org/jruby/internal/runtime/methods/AliasMethod.java",0,0.512820512820513,2,4,6
"src/org/jruby/internal/runtime/methods/CallConfiguration.java",0,1,0,1,1
"src/org/jruby/internal/runtime/methods/CompiledMethod.java",0,0.848484848484849,0,3,3
"src/org/jruby/internal/runtime/methods/DefaultMethod.java",0,0.683098591549296,3,3,6
"src/org/jruby/internal/runtime/methods/DumpingInvocationMethodFactory.java",0,0.848484848484849,0,2,2
"src/org/jruby/internal/runtime/methods/DynamicMethod.java",0,0.585798816568047,0,2,2
"src/org/jruby/internal/runtime/methods/FullFunctionCallbackMethod.java",0,0.378947368421053,0,4,4
"src/org/jruby/internal/runtime/methods/InvocationMethodFactory.java",0,0.92992992992993,1,2,3
"src/org/jruby/internal/runtime/methods/JavaMethod.java",0,1,0,1,1
"src/org/jruby/internal/runtime/methods/MethodMethod.java",0,0.558823529411765,0,3,3
"src/org/jruby/internal/runtime/methods/ProcMethod.java",0,0.527027027027027,0,3,3
"src/org/jruby/internal/runtime/methods/ReflectedCompiledMethod.java",0,0.982142857142857,1,1,2
"src/org/jruby/internal/runtime/methods/ReflectedJavaMethod.java",0,0.823232323232323,0,3,3
"src/org/jruby/internal/runtime/methods/ReflectionMethodFactory.java",0,0.435643564356436,0,3,3
"src/org/jruby/internal/runtime/methods/RubiniusMethod.java",0,0.868421052631579,1,2,3
"src/org/jruby/internal/runtime/methods/SimpleCallbackMethod.java",0,0.481481481481481,1,4,5
"src/org/jruby/internal/runtime/methods/UndefinedMethod.java",0,0.397727272727273,0,4,4
"src/org/jruby/internal/runtime/methods/WrapperMethod.java",0,0.516666666666667,1,3,4
"src/org/jruby/internal/runtime/methods/YARVMethod.java",0,0.756756756756757,0,3,3
"src/org/jruby/javasupport/Java.java",0,0.36468330134357,7,4,11
"src/org/jruby/javasupport/JavaAccessibleObject.java",0,0.53416149068323,2,4,6
"src/org/jruby/javasupport/JavaArray.java",0,0.398550724637681,4,4,8
"src/org/jruby/javasupport/JavaArrayUtilities.java",0,0.986301369863014,1,1,2
"src/org/jruby/javasupport/JavaCallable.java",0,0.471428571428571,2,4,6
"src/org/jruby/javasupport/JavaClass.java",0,0.405286343612335,5,5,10
"src/org/jruby/javasupport/JavaConstructor.java",0,0.545023696682464,4,3,7
"src/org/jruby/javasupport/JavaEmbedUtils.java",0,0.516,1,3,4
"src/org/jruby/javasupport/JavaField.java",0,0.382075471698113,4,4,8
"src/org/jruby/javasupport/JavaMethod.java",0,0.267647058823529,3,6,9
"src/org/jruby/javasupport/JavaObject.java",0,0.330188679245283,3,5,8
"src/org/jruby/javasupport/JavaSupport.java",0,0.325,4,6,10
"src/org/jruby/javasupport/JavaUtil.java",0,0.47117296222664,6,5,11
"src/org/jruby/javasupport/ParameterTypes.java",0,1,0,1,1
"src/org/jruby/javasupport/bsf/BSFExample.java",0,0.721854304635762,1,3,4
"src/org/jruby/javasupport/bsf/JRubyEngine.java",0,0.446808510638298,1,4,5
"src/org/jruby/javasupport/proxy/InternalJavaProxy.java",0,1,0,1,1
"src/org/jruby/javasupport/proxy/InternalJavaProxyHelper.java",0,1,0,1,1
"src/org/jruby/javasupport/proxy/JavaProxyClass.java",0,0.558299039780521,1,3,4
"src/org/jruby/javasupport/proxy/JavaProxyClassFactory.java",0,0.900744416873449,1,2,3
"src/org/jruby/javasupport/proxy/JavaProxyConstructor.java",0,0.647272727272727,1,3,4
"src/org/jruby/javasupport/proxy/JavaProxyInvocationHandler.java",0,1,0,1,1
"src/org/jruby/javasupport/proxy/JavaProxyMethod.java",0,0.959459459459459,1,1,2
"src/org/jruby/javasupport/proxy/JavaProxyReflectionObject.java",0,0.951219512195122,2,1,3
"src/org/jruby/javasupport/util/ConversionIterator.java",0,1,0,1,1
"src/org/jruby/javasupport/util/ObjectProxyCache.java",0,1,0,1,1
"src/org/jruby/javasupport/util/RuntimeHelpers.java",0,0.748066298342541,4,2,6
"src/org/jruby/lexer/yacc/ByteListLexerSource.java",0,0.94300518134715,0,2,2
"src/org/jruby/lexer/yacc/CapturingByteListLexerSource.java",0,0.9,0,2,2
"src/org/jruby/lexer/yacc/HeredocTerm.java",0,0.644444444444444,1,3,4
"src/org/jruby/lexer/yacc/IDESourcePosition.java",0,0.823275862068966,1,3,4
"src/org/jruby/lexer/yacc/IDESourcePositionFactory.java",0,1,0,1,1
"src/org/jruby/lexer/yacc/ISourcePosition.java",0,1,0,1,1
"src/org/jruby/lexer/yacc/ISourcePositionFactory.java",0,1,0,1,1
"src/org/jruby/lexer/yacc/ISourcePositionHolder.java",0,1,0,1,1
"src/org/jruby/lexer/yacc/InputStreamLexerSource.java",0,0.936329588014981,0,2,2
"src/org/jruby/lexer/yacc/LexerSource.java",0,0.924324324324324,3,1,4
"src/org/jruby/lexer/yacc/RubyYaccLexer.java",0,0.850844277673546,6,2,8
"src/org/jruby/lexer/yacc/SimplePositionFactory.java",0,0.839285714285714,0,2,2
"src/org/jruby/lexer/yacc/SimpleSourcePosition.java",0,0.853658536585366,1,3,4
"src/org/jruby/lexer/yacc/StackState.java",0,0.608695652173913,1,2,3
"src/org/jruby/lexer/yacc/StrTerm.java",0,0.78125,1,2,3
"src/org/jruby/lexer/yacc/StringTerm.java",0,0.545961002785515,1,3,4
"src/org/jruby/lexer/yacc/SyntaxException.java",0,0.752941176470588,0,3,3
"src/org/jruby/lexer/yacc/Token.java",0,1,0,1,1
"src/org/jruby/libraries/BigDecimalLibrary.java",0,0.978723404255319,1,1,2
"src/org/jruby/libraries/DigestLibrary.java",0,0.909090909090909,1,2,3
"src/org/jruby/libraries/EnumeratorLibrary.java",0,0.975609756097561,1,1,2
"src/org/jruby/libraries/EtcLibrary.java",0,1,0,1,1
"src/org/jruby/libraries/FiberLibrary.java",0,0.986013986013986,1,1,2
"src/org/jruby/libraries/IConvLibrary.java",0,0.976190476190476,1,1,2
"src/org/jruby/libraries/IOWaitLibrary.java",0,0.533333333333333,1,2,3
"src/org/jruby/libraries/JRubyLibrary.java",0,0.975609756097561,1,1,2
"src/org/jruby/libraries/NKFLibrary.java",0,0.928571428571429,0,2,2
"src/org/jruby/libraries/RbConfigLibrary.java",0,0.478494623655914,2,5,7
"src/org/jruby/libraries/StringIOLibrary.java",0,0.975,1,1,2
"src/org/jruby/libraries/StringScannerLibrary.java",0,0.909090909090909,0,2,2
"src/org/jruby/libraries/ThreadLibrary.java",0,0.62807881773399,4,3,7
"src/org/jruby/libraries/YamlLibrary.java",0,0.957446808510638,2,1,3
"src/org/jruby/libraries/ZlibLibrary.java",0,0.975,1,1,2
"src/org/jruby/parser/BlockStaticScope.java",0,0.936363636363636,0,2,2
"src/org/jruby/parser/DefaultRubyParser.java",0,0.756602641056423,4,2,6
"src/org/jruby/parser/LocalStaticScope.java",0,0.981132075471698,1,1,2
"src/org/jruby/parser/Parser.java",0,0.702970297029703,3,4,7
"src/org/jruby/parser/ParserConfiguration.java",0,0.971223021582734,1,1,2
"src/org/jruby/parser/ParserSupport.java",0,0.680628272251309,4,3,7
"src/org/jruby/parser/ReOptions.java",0,0.697674418604651,0,4,4
"src/org/jruby/parser/RubyParserPool.java",0,0.641509433962264,0,2,2
"src/org/jruby/parser/RubyParserResult.java",0,0.616161616161616,1,4,5
"src/org/jruby/parser/StaticScope.java",0,0.968652037617555,1,1,2
"src/org/jruby/parser/Tokens.java",0,1,0,1,1
"src/org/jruby/parser/YyTables.java",0,0.99195494770716,2,1,3
"src/org/jruby/runtime/Arity.java",0,0.49402390438247,3,3,6
"src/org/jruby/runtime/Binding.java",0,1,0,1,1
"src/org/jruby/runtime/Block.java",0,0.427027027027027,2,3,5
"src/org/jruby/runtime/BlockBody.java",0,0.989637305699482,1,1,2
"src/org/jruby/runtime/BlockCallback.java",0,1,0,1,1
"src/org/jruby/runtime/CacheMap.java",0,0.504273504273504,2,2,4
"src/org/jruby/runtime/CallBlock.java",0,0.981481481481482,2,1,3
"src/org/jruby/runtime/CallSite.java",0,0.855491329479769,1,2,3
"src/org/jruby/runtime/CallType.java",0,0.557692307692308,1,4,5
"src/org/jruby/runtime/CallbackFactory.java",0,0.298850574712644,1,6,7
"src/org/jruby/runtime/ClassIndex.java",0,1,0,1,1
"src/org/jruby/runtime/CompiledBlock.java",0,0.882978723404255,0,2,2
"src/org/jruby/runtime/CompiledBlockCallback.java",0,1,0,1,1
"src/org/jruby/runtime/CompiledBlockLight.java",0,0.978723404255319,1,1,2
"src/org/jruby/runtime/CompiledSharedScopeBlock.java",0,0.873239436619718,0,2,2
"src/org/jruby/runtime/Constants.java",0,0.373493975903614,0,4,4
"src/org/jruby/runtime/Dispatcher.java",0,1,0,1,1
"src/org/jruby/runtime/DynamicScope.java",0,0.860869565217391,1,2,3
"src/org/jruby/runtime/ErrorLogger.java",0,0.658536585365854,0,2,2
"src/org/jruby/runtime/EventHook.java",0,1,0,1,1
"src/org/jruby/runtime/Frame.java",0,0.617161716171617,2,3,5
"src/org/jruby/runtime/GlobalVariable.java",0,0.404761904761905,1,4,5
"src/org/jruby/runtime/IAccessor.java",0,0.692307692307692,0,2,2
"src/org/jruby/runtime/IRaiseListener.java",0,0.692307692307692,0,2,2
"src/org/jruby/runtime/InterpretedBlock.java",0,0.98015873015873,1,1,2
"src/org/jruby/runtime/Iter.java",0,0.478260869565217,1,3,4
"src/org/jruby/runtime/MethodBlock.java",0,1,0,1,1
"src/org/jruby/runtime/MethodCacheSite.java",0,1,0,1,1
"src/org/jruby/runtime/MethodFactory.java",0,0.734177215189873,1,2,3
"src/org/jruby/runtime/MethodIndex.java",0,0.768,1,2,3
"src/org/jruby/runtime/ObjectAllocator.java",0,0.857142857142857,1,2,3
"src/org/jruby/runtime/ObjectMarshal.java",0,0.943396226415094,0,2,2
"src/org/jruby/runtime/ObjectSpace.java",0,0.378787878787879,3,5,8
"src/org/jruby/runtime/ReadonlyGlobalVariable.java",0,0.659090909090909,2,3,5
"src/org/jruby/runtime/RubyOptions.java",0,0.552238805970149,1,2,3
"src/org/jruby/runtime/SharedScopeBlock.java",0,0.764705882352941,0,2,2
"src/org/jruby/runtime/ThreadContext.java",0,0.677667766776678,5,2,7
"src/org/jruby/runtime/Visibility.java",0,0.736842105263158,1,3,4
"src/org/jruby/runtime/builtin/IRubyObject.java",0,0.401215805471125,3,6,9
"src/org/jruby/runtime/builtin/InstanceVariables.java",0,1,0,1,1
"src/org/jruby/runtime/builtin/InternalVariables.java",0,1,0,1,1
"src/org/jruby/runtime/builtin/Variable.java",0,1,0,1,1
"src/org/jruby/runtime/callback/Callback.java",0,0.711111111111111,0,3,3
"src/org/jruby/runtime/callback/DumpingInvocationCallbackFactory.java",0,0.847826086956522,1,2,3
"src/org/jruby/runtime/callback/FastInvocationCallback.java",0,0.835616438356164,0,2,2
"src/org/jruby/runtime/callback/InvocationCallback.java",0,0.555555555555556,1,2,3
"src/org/jruby/runtime/callback/InvocationCallbackFactory.java",0,0.814339622641509,1,3,4
"src/org/jruby/runtime/callback/ReflectionCallback.java",0,0.80184331797235,5,2,7
"src/org/jruby/runtime/callback/ReflectionCallbackFactory.java",0,0.478947368421053,0,4,4
"src/org/jruby/runtime/component/VariableEntry.java",0,0.975,1,1,2
"src/org/jruby/runtime/load/BasicLibraryService.java",0,0.957446808510638,1,1,2
"src/org/jruby/runtime/load/ClassExtensionLibrary.java",0,0.964285714285714,2,1,3
"src/org/jruby/runtime/load/ExternalScript.java",0,0.606060606060606,1,4,5
"src/org/jruby/runtime/load/IAutoloadMethod.java",0,0.725,1,2,3
"src/org/jruby/runtime/load/JarredScript.java",0,0.375,1,3,4
"src/org/jruby/runtime/load/JavaCompiledScript.java",0,1,0,1,1
"src/org/jruby/runtime/load/Library.java",0,0.763157894736842,1,3,4
"src/org/jruby/runtime/load/LoadService.java",0,0.554119547657512,4,4,8
"src/org/jruby/runtime/load/LoadServiceResource.java",0,1,0,1,1
"src/org/jruby/runtime/marshal/CoreObjectType.java",0,1,0,1,1
"src/org/jruby/runtime/marshal/MarshalCache.java",0,0.507246376811594,2,3,5
"src/org/jruby/runtime/marshal/MarshalStream.java",0,0.404395604395604,4,6,10
"src/org/jruby/runtime/marshal/UnmarshalCache.java",0,0.511627906976744,3,3,6
"src/org/jruby/runtime/marshal/UnmarshalStream.java",0,0.295454545454545,4,5,9
"src/org/jruby/runtime/scope/ManyVarsDynamicScope.java",0,0.996415770609319,1,1,2
"src/org/jruby/runtime/scope/NoVarsDynamicScope.java",0,0.992805755395683,1,1,2
"src/org/jruby/runtime/scope/OneVarDynamicScope.java",0,0.994764397905759,1,1,2
"src/org/jruby/runtime/scope/TwoVarDynamicScope.java",0,0.995652173913044,1,1,2
"src/org/jruby/util/Adler32Ext.java",0,0.99236641221374,1,1,2
"src/org/jruby/util/BuiltinScript.java",0,0.583333333333333,0,4,4
"src/org/jruby/util/ByteList.java",0,0.333780160857909,0,5,5
"src/org/jruby/util/CRC32Ext.java",0,1,0,1,1
"src/org/jruby/util/ClassCache.java",0,0.684210526315789,1,2,3
"src/org/jruby/util/ClassProvider.java",0,0.976744186046512,1,1,2
"src/org/jruby/util/CodegenUtils.java",0,1,0,1,1
"src/org/jruby/util/Convert.java",0,0.517461669505963,2,2,4
"src/org/jruby/util/DataInputBridgeStream.java",0,0.981818181818182,1,1,2
"src/org/jruby/util/DataOutputBridgeStream.java",0,1,0,1,1
"src/org/jruby/util/Dir.java",0,0.565432098765432,1,3,4
"src/org/jruby/util/GenericMap.java",0,1,0,1,1
"src/org/jruby/util/IOInputStream.java",0,0.683333333333333,1,3,4
"src/org/jruby/util/IOOutputStream.java",0,0.797619047619048,0,2,2
"src/org/jruby/util/IOReader.java",0,0.943661971830986,0,2,2
"src/org/jruby/util/IOWriter.java",0,0.953125,1,1,2
"src/org/jruby/util/IdUtil.java",0,0.473684210526316,0,4,4
"src/org/jruby/util/JRubyClassLoader.java",0,0.37037037037037,0,4,4
"src/org/jruby/util/JRubyFile.java",0,0.90547263681592,1,2,3
"src/org/jruby/util/JRubyNonExistentFile.java",0,0.929203539823009,0,2,2
"src/org/jruby/util/JavaNameMangler.java",0,0.955974842767296,1,1,2
"src/org/jruby/util/KCode.java",0,0.450980392156863,1,3,4
"src/org/jruby/util/NoFunctionalitySignalFacade.java",0,1,0,1,1
"src/org/jruby/util/NormalizedFile.java",0,1,0,1,1
"src/org/jruby/util/Pack.java",0,0.356035697510568,4,5,9
"src/org/jruby/util/RubyDateFormat.java",0,0.664383561643836,4,3,7
"src/org/jruby/util/RubyInputStream.java",0,0.359550561797753,1,3,4
"src/org/jruby/util/SafePropertyAccessor.java",0,1,0,1,1
"src/org/jruby/util/ShellLauncher.java",0,0.493624772313297,3,3,6
"src/org/jruby/util/SignalFacade.java",0,1,0,1,1
"src/org/jruby/util/SimpleSampler.java",0,1,0,1,1
"src/org/jruby/util/Sprintf.java",0,0.885161290322581,1,2,3
"src/org/jruby/util/SunSignalFacade.java",0,1,0,1,1
"src/org/jruby/util/SwallowingOutputStream.java",0,1,0,1,1
"src/org/jruby/util/TypeCoercer.java",0,1,0,1,1
"src/org/jruby/util/TypeConverter.java",0,0.956521739130435,2,1,3
"src/org/jruby/util/WeakIdentityHashMap.java",0,1,0,1,1
"src/org/jruby/util/ZlibDeflate.java",0,0.715384615384615,2,2,4
"src/org/jruby/util/ZlibInflate.java",0,0.702479338842975,0,3,3
"src/org/jruby/util/collections/IdentitySet.java",0,0.603174603174603,0,2,2
"src/org/jruby/util/collections/IntHashMap.java",0,1,0,1,1
"src/org/jruby/util/collections/SlottedHashMap.java",0,1,0,1,1
"src/org/jruby/util/collections/WeakHashSet.java",0,0.70873786407767,0,2,2
"src/org/jruby/util/io/BadDescriptorException.java",0,1,0,1,1
"src/org/jruby/util/io/ChannelDescriptor.java",0,0.900689655172414,1,2,3
"src/org/jruby/util/io/ChannelStream.java",0,0.959910913140312,2,1,3
"src/org/jruby/util/io/DirectoryAsFileException.java",0,1,0,1,1
"src/org/jruby/util/io/FileExistsException.java",0,1,0,1,1
"src/org/jruby/util/io/InvalidValueException.java",0,1,0,1,1
"src/org/jruby/util/io/ModeFlags.java",0,1,0,1,1
"src/org/jruby/util/io/NullChannel.java",0,0.955223880597015,1,1,2
"src/org/jruby/util/io/OpenFile.java",0,0.971223021582734,1,1,2
"src/org/jruby/util/io/PipeException.java",0,1,0,1,1
"src/org/jruby/util/io/STDIO.java",0,1,0,1,1
"src/org/jruby/util/io/SplitChannel.java",0,1,0,1,1
"src/org/jruby/util/io/Stream.java",0,1,0,1,1
"src/org/jruby/util/string/UcharIterator.java",0,0.987179487179487,1,1,2
"src/org/jruby/util/string/Ustr.java",0,0.992532247114732,1,1,2
"src/org/jruby/util/string/UstrException.java",0,0.777777777777778,0,2,2
"src/org/jruby/yaml/JRubyConstructor.java",0,0.498275862068966,2,2,4
"src/org/jruby/yaml/JRubyRepresenter.java",0,0.987179487179487,1,1,2
"src/org/jruby/yaml/JRubySerializer.java",0,1,0,1,1
"src/org/jvyamlb/BaseConstructorImpl.java",0,1,0,1,1
"src/org/jvyamlb/Composer.java",0,1,0,1,1
"src/org/jvyamlb/ComposerException.java",0,1,0,1,1
"src/org/jvyamlb/ComposerImpl.java",0,1,0,1,1
"src/org/jvyamlb/Constructor.java",0,1,0,1,1
"src/org/jvyamlb/ConstructorException.java",0,1,0,1,1
"src/org/jvyamlb/ConstructorImpl.java",0,1,0,1,1
"src/org/jvyamlb/DefaultYAMLConfig.java",0,1,0,1,1
"src/org/jvyamlb/DefaultYAMLFactory.java",0,1,0,1,1
"src/org/jvyamlb/Emitter.java",0,1,0,1,1
"src/org/jvyamlb/EmitterException.java",0,1,0,1,1
"src/org/jvyamlb/EmitterImpl.java",0,0.989704873026767,1,1,2
"src/org/jvyamlb/IntStack.java",0,1,0,1,1
"src/org/jvyamlb/Parser.java",0,1,0,1,1
"src/org/jvyamlb/ParserException.java",0,1,0,1,1
"src/org/jvyamlb/ParserImpl.java",0,1,0,1,1
"src/org/jvyamlb/PrivateType.java",0,1,0,1,1
"src/org/jvyamlb/Representer.java",0,1,0,1,1
"src/org/jvyamlb/RepresenterException.java",0,1,0,1,1
"src/org/jvyamlb/RepresenterImpl.java",0,0.989059080962801,1,1,2
"src/org/jvyamlb/Resolver.java",0,1,0,1,1
"src/org/jvyamlb/ResolverException.java",0,1,0,1,1
"src/org/jvyamlb/ResolverImpl.java",0,1,0,1,1
"src/org/jvyamlb/ResolverScanner.java",0,1,0,1,1
"src/org/jvyamlb/SafeConstructorImpl.java",0,0.998154981549816,1,1,2
"src/org/jvyamlb/SafeRepresenterImpl.java",0,1,0,1,1
"src/org/jvyamlb/Scanner.java",0,1,0,1,1
"src/org/jvyamlb/ScannerException.java",0,1,0,1,1
"src/org/jvyamlb/ScannerImpl.java",0,0.994402985074627,2,1,3
"src/org/jvyamlb/Serializer.java",0,1,0,1,1
"src/org/jvyamlb/SerializerException.java",0,1,0,1,1
"src/org/jvyamlb/SerializerImpl.java",0,1,0,1,1
"src/org/jvyamlb/SimpleKey.java",0,1,0,1,1
"src/org/jvyamlb/YAML.java",0,1,0,1,1
"src/org/jvyamlb/YAMLConfig.java",0,1,0,1,1
"src/org/jvyamlb/YAMLException.java",0,1,0,1,1
"src/org/jvyamlb/YAMLFactory.java",0,1,0,1,1
"src/org/jvyamlb/YAMLNodeCreator.java",0,1,0,1,1
"src/org/jvyamlb/events/AliasEvent.java",0,1,0,1,1
"src/org/jvyamlb/events/CollectionEndEvent.java",0,1,0,1,1
"src/org/jvyamlb/events/CollectionStartEvent.java",0,1,0,1,1
"src/org/jvyamlb/events/DocumentEndEvent.java",0,1,0,1,1
"src/org/jvyamlb/events/DocumentStartEvent.java",0,1,0,1,1
"src/org/jvyamlb/events/Event.java",0,1,0,1,1
"src/org/jvyamlb/events/MappingEndEvent.java",0,1,0,1,1
"src/org/jvyamlb/events/MappingStartEvent.java",0,1,0,1,1
"src/org/jvyamlb/events/NodeEvent.java",0,1,0,1,1
"src/org/jvyamlb/events/ScalarEvent.java",0,1,0,1,1
"src/org/jvyamlb/events/SequenceEndEvent.java",0,1,0,1,1
"src/org/jvyamlb/events/SequenceStartEvent.java",0,1,0,1,1
"src/org/jvyamlb/events/StreamEndEvent.java",0,1,0,1,1
"src/org/jvyamlb/events/StreamStartEvent.java",0,1,0,1,1
"src/org/jvyamlb/nodes/CollectionNode.java",0,1,0,1,1
"src/org/jvyamlb/nodes/LinkNode.java",0,1,0,1,1
"src/org/jvyamlb/nodes/MappingNode.java",0,1,0,1,1
"src/org/jvyamlb/nodes/Node.java",0,1,0,1,1
"src/org/jvyamlb/nodes/ScalarNode.java",0,1,0,1,1
"src/org/jvyamlb/nodes/SequenceNode.java",0,1,0,1,1
"src/org/jvyamlb/tokens/AliasToken.java",0,1,0,1,1
"src/org/jvyamlb/tokens/AnchorToken.java",0,1,0,1,1
"src/org/jvyamlb/tokens/BlockEndToken.java",0,1,0,1,1
"src/org/jvyamlb/tokens/BlockEntryToken.java",0,1,0,1,1
"src/org/jvyamlb/tokens/BlockMappingStartToken.java",0,1,0,1,1
"src/org/jvyamlb/tokens/BlockSequenceStartToken.java",0,1,0,1,1
"src/org/jvyamlb/tokens/DirectiveToken.java",0,1,0,1,1
"src/org/jvyamlb/tokens/DocumentEndToken.java",0,1,0,1,1
"src/org/jvyamlb/tokens/DocumentStartToken.java",0,1,0,1,1
"src/org/jvyamlb/tokens/FlowEntryToken.java",0,1,0,1,1
"src/org/jvyamlb/tokens/FlowMappingEndToken.java",0,1,0,1,1
"src/org/jvyamlb/tokens/FlowMappingStartToken.java",0,1,0,1,1
"src/org/jvyamlb/tokens/FlowSequenceEndToken.java",0,1,0,1,1
"src/org/jvyamlb/tokens/FlowSequenceStartToken.java",0,1,0,1,1
"src/org/jvyamlb/tokens/KeyToken.java",0,1,0,1,1
"src/org/jvyamlb/tokens/ScalarToken.java",0,1,0,1,1
"src/org/jvyamlb/tokens/StreamEndToken.java",0,1,0,1,1
"src/org/jvyamlb/tokens/StreamStartToken.java",0,1,0,1,1
"src/org/jvyamlb/tokens/TagToken.java",0,1,0,1,1
"src/org/jvyamlb/tokens/Token.java",0,1,0,1,1
"src/org/jvyamlb/tokens/ValueToken.java",0,1,0,1,1
"src/org/jvyamlb/util/Base64Coder.java",0,0.984615384615385,1,1,2
"test/org/jruby/ast/executable/YARVMachineTest.java",0,0.547008547008547,0,3,3
"test/org/jruby/ast/visitor/rewriter/SourceRewriteTester.java",0,1,0,1,1
"test/org/jruby/ast/visitor/rewriter/SourceTestCase.java",0,1,0,1,1
"test/org/jruby/ast/visitor/rewriter/TestReWriteVisitor.java",0,0.552845528455285,1,2,3
"test/org/jruby/ast/visitor/rewriter/VisitorTestSuite.java",0,1,0,1,1
"test/org/jruby/ast/visitor/rewriter/utils/TestBooleanStateStack.java",0,1,0,1,1
"test/org/jruby/ast/visitor/rewriter/utils/TestOperators.java",0,1,0,1,1
"test/org/jruby/ext/posix/JavaFileStatTest.java",0,0.884615384615385,0,2,2
"test/org/jruby/javasupport/TestJavaClass.java",0,0.777777777777778,0,4,4
"test/org/jruby/javasupport/TypeMatcher.java",0,1,0,1,1
"test/org/jruby/javasupport/test/Color.java",0,0.814814814814815,0,2,2
"test/org/jruby/javasupport/test/ConstantHolder.java",0,1,0,1,1
"test/org/jruby/javasupport/test/ConsumeInterfaces.java",0,1,0,1,1
"test/org/jruby/javasupport/test/DateHolder.java",0,1,0,1,1
"test/org/jruby/javasupport/test/Interface1.java",0,1,0,1,1
"test/org/jruby/javasupport/test/Interface2.java",0,1,0,1,1
"test/org/jruby/javasupport/test/JavaSupportTestSuite.java",0,0.642857142857143,1,2,3
"test/org/jruby/javasupport/test/NullToString.java",0,1,0,1,1
"test/org/jruby/javasupport/test/OuterClass.java",0,1,0,1,1
"test/org/jruby/javasupport/test/Room.java",0,1,0,1,1
"test/org/jruby/javasupport/test/RubyTestCase.java",0,0.354166666666667,2,5,7
"test/org/jruby/javasupport/test/RubyTestObject.java",0,0.630952380952381,1,2,3
"test/org/jruby/javasupport/test/SimpleExecutor.java",0,1,0,1,1
"test/org/jruby/javasupport/test/SimpleInterface.java",0,1,0,1,1
"test/org/jruby/javasupport/test/TestBSF.java",0,0.665768194070081,0,2,2
"test/org/jruby/javasupport/test/TestIntWrapper.java",0,0.848484848484849,0,2,2
"test/org/jruby/javasupport/test/TestIntWrapperImpl.java",0,0.518518518518518,0,2,2
"test/org/jruby/javasupport/test/TestNativeException.java",0,0.614035087719298,0,2,2
"test/org/jruby/runtime/callback/TestReflectionCallback.java",0,0.91304347826087,2,1,3
"test/org/jruby/test/Abstract.java",0,1,0,1,1
"test/org/jruby/test/AlphaSingleton.java",0,1,0,1,1
"test/org/jruby/test/BFTSTestSuite.java",0,1,0,1,1
"test/org/jruby/test/BasicLibraryTestService.java",0,0.951219512195122,1,1,2
"test/org/jruby/test/BetaSingleton.java",0,1,0,1,1
"test/org/jruby/test/ClassWithPrimitive.java",0,1,0,1,1
"test/org/jruby/test/DubyTestSuite.java",0,1,0,1,1
"test/org/jruby/test/FailingTest.java",0,1,0,1,1
"test/org/jruby/test/FinalMethodBaseTest.java",0,1,0,1,1
"test/org/jruby/test/ITest.java",0,1,0,1,1
"test/org/jruby/test/JRubyTestSuite.java",0,1,0,1,1
"test/org/jruby/test/MRITestSuite.java",0,1,0,1,1
"test/org/jruby/test/MainTestSuite.java",0,0.397849462365591,3,5,8
"test/org/jruby/test/MockException.java",0,0.8,0,2,2
"test/org/jruby/test/MockJavaSupport.java",0,0.833333333333333,0,2,2
"test/org/jruby/test/MockObjectSpace.java",0,1,0,1,1
"test/org/jruby/test/MockRubyObject.java",0,0.76,1,2,3
"test/org/jruby/test/ObjectPersistenceTestSuite.java",0,1,0,1,1
"test/org/jruby/test/Parent.java",0,1,0,1,1
"test/org/jruby/test/ReturnsNull.java",0,1,0,1,1
"test/org/jruby/test/RubiconTestSuite.java",0,1,0,1,1
"test/org/jruby/test/Ruby1_9TestSuite.java",0,1,0,1,1
"test/org/jruby/test/RubyTestTestSuite.java",0,1,0,1,1
"test/org/jruby/test/ScriptTestSuite.java",0,0.309859154929577,3,4,7
"test/org/jruby/test/TestAdoptedThreading.java",0,0.934156378600823,0,2,2
"test/org/jruby/test/TestCodeCache.java",0,0.984848484848485,1,1,2
"test/org/jruby/test/TestCommandlineParser.java",0,0.38655462184874,0,6,6
"test/org/jruby/test/TestHelper.java",0,0.302904564315353,4,4,8
"test/org/jruby/test/TestIdentitySet.java",0,0.580645161290323,1,2,3
"test/org/jruby/test/TestJavaUtil.java",0,0.491525423728814,2,3,5
"test/org/jruby/test/TestKernel.java",0,0.47,6,4,10
"test/org/jruby/test/TestLoadService.java",0,0.528735632183908,2,3,5
"test/org/jruby/test/TestObjectSpace.java",0,0.323809523809524,5,3,8
"test/org/jruby/test/TestParser.java",0,0.967741935483871,1,1,2
"test/org/jruby/test/TestRaiseException.java",0,0.989010989010989,1,1,2
"test/org/jruby/test/TestRbConfigLibrary.java",0,0.826086956521739,0,3,3
"test/org/jruby/test/TestRequire.java",0,0.582417582417582,0,2,2
"test/org/jruby/test/TestRuby.java",0,0.647058823529412,5,4,9
"test/org/jruby/test/TestRubyArray.java",0,0.971014492753623,1,1,2
"test/org/jruby/test/TestRubyBase.java",0,0.390804597701149,3,4,7
"test/org/jruby/test/TestRubyBigDecimal.java",0,0.71875,0,2,2
"test/org/jruby/test/TestRubyCollect.java",0,0.58,1,3,4
"test/org/jruby/test/TestRubyException.java",0,0.80952380952381,1,2,3
"test/org/jruby/test/TestRubyHash.java",0,0.550802139037433,3,4,7
"test/org/jruby/test/TestRubyInstanceConfig.java",0,1,0,1,1
"test/org/jruby/test/TestRubyNil.java",0,0.445544554455446,4,3,7
"test/org/jruby/test/TestRubyObject.java",0,0.6,5,2,7
"test/org/jruby/test/TestRubySymbol.java",0,0.439393939393939,4,3,7
"test/org/jruby/test/TestUnitTestSuite.java",0,0.587962962962963,0,3,3
"test/org/jruby/test/TestVariableCreation.java",0,0.883720930232558,1,2,3
"test/org/jruby/test/Worker.java",0,1,0,1,1
"test/org/jruby/test/bench/BenchIntFibRecursive.java",0,1,0,1,1
"test/org/jruby/test/bench/BenchLongFibRecursive.java",0,1,0,1,1
"test/org/jruby/test/smallLetterClass.java",0,1,0,1,1
"test/org/jruby/util/ByteListTest.java",0,0.895833333333333,0,2,2
"test/org/jruby/util/JRubyThreadContextTest.java",0,1,0,1,1
"test/org/jruby/util/PlatformTest.java",0,1,0,1,1
"test/org/jruby/util/Pwd.java",0,1,0,1,1
"test/org/jruby/util/ShellLauncherTest.java",0,0.769230769230769,0,2,2
"test/org/jruby/util/collections/test/SlottedHashMapTest.java",0,1,0,1,1
"test/org/jvyamlb/TestBean.java",0,1,0,1,1
"test/org/jvyamlb/TestBean2.java",0,1,0,1,1
"test/org/jvyamlb/YAMLDumpTest.java",0,1,0,1,1
"test/org/jvyamlb/YAMLLoadTest.java",0,0.888888888888889,0,2,2
"tool/nailgun/src/java/org/jruby/util/NailMain.java",0,1,0,1,1
"bin/generate_yaml_index.rb",0,1,0,1,1
"bin/index_gem_repository.rb",0,0.333333333333333,0,3,3
"bin/jruby.rb",0,0.958762886597938,2,1,3
"bin/patch_parser.rb",0,1,0,1,1
"lib/ruby/1.8/English.rb",0,1,0,1,1
"lib/ruby/1.8/Env.rb",0,1,0,1,1
"lib/ruby/1.8/abbrev.rb",0,1,0,1,1
"lib/ruby/1.8/base64.rb",0,1,0,1,1
"lib/ruby/1.8/benchmark.rb",0,1,0,1,1
"lib/ruby/1.8/bigdecimal/jacobian.rb",0,1,0,1,1
"lib/ruby/1.8/bigdecimal/ludcmp.rb",0,1,0,1,1
"lib/ruby/1.8/bigdecimal/math.rb",0,1,0,1,1
"lib/ruby/1.8/bigdecimal/newton.rb",0,1,0,1,1
"lib/ruby/1.8/bigdecimal/util.rb",0,1,0,1,1
"lib/ruby/1.8/cgi-lib.rb",0,1,0,1,1
"lib/ruby/1.8/cgi.rb",0,1,0,1,1
"lib/ruby/1.8/cgi/session.rb",0,1,0,1,1
"lib/ruby/1.8/cgi/session/pstore.rb",0,1,0,1,1
"lib/ruby/1.8/complex.rb",0,1,0,1,1
"lib/ruby/1.8/csv.rb",0,1,0,1,1
"lib/ruby/1.8/date.rb",0,0.998829039812646,1,1,2
"lib/ruby/1.8/date/format.rb",0,0.746323529411765,0,2,2
"lib/ruby/1.8/date2.rb",0,1,0,1,1
"lib/ruby/1.8/debug.rb",0,0.993677555321391,1,1,2
"lib/ruby/1.8/delegate.rb",0,1,0,1,1
"lib/ruby/1.8/dl.rb",0,1,0,1,1
"lib/ruby/1.8/drb.rb",0,1,0,1,1
"lib/ruby/1.8/drb/acl.rb",0,1,0,1,1
"lib/ruby/1.8/drb/drb.rb",0,1,0,1,1
"lib/ruby/1.8/drb/eq.rb",0,1,0,1,1
"lib/ruby/1.8/drb/extserv.rb",0,1,0,1,1
"lib/ruby/1.8/drb/extservm.rb",0,1,0,1,1
"lib/ruby/1.8/drb/gw.rb",0,1,0,1,1
"lib/ruby/1.8/drb/invokemethod.rb",0,1,0,1,1
"lib/ruby/1.8/drb/observer.rb",0,1,0,1,1
"lib/ruby/1.8/drb/ssl.rb",0,1,0,1,1
"lib/ruby/1.8/drb/timeridconv.rb",0,1,0,1,1
"lib/ruby/1.8/drb/unix.rb",0,1,0,1,1
"lib/ruby/1.8/e2mmap.rb",0,1,0,1,1
"lib/ruby/1.8/erb.rb",0,1,0,1,1
"lib/ruby/1.8/eregex.rb",0,1,0,1,1
"lib/ruby/1.8/fileutils.rb",0,1,0,1,1
"lib/ruby/1.8/finalize.rb",0,0.943877551020408,0,2,2
"lib/ruby/1.8/find.rb",0,1,0,1,1
"lib/ruby/1.8/forwardable.rb",0,1,0,1,1
"lib/ruby/1.8/ftools.rb",0,1,0,1,1
"lib/ruby/1.8/generator.rb",0,0.996350364963504,1,1,2
"lib/ruby/1.8/getoptlong.rb",0,1,0,1,1
"lib/ruby/1.8/getopts.rb",0,1,0,1,1
"lib/ruby/1.8/gserver.rb",0,1,0,1,1
"lib/ruby/1.8/importenv.rb",0,1,0,1,1
"lib/ruby/1.8/io/nonblock.rb",0,1,0,1,1
"lib/ruby/1.8/ipaddr.rb",0,1,0,1,1
"lib/ruby/1.8/irb.rb",0,1,0,1,1
"lib/ruby/1.8/irb/cmd/chws.rb",0,1,0,1,1
"lib/ruby/1.8/irb/cmd/fork.rb",0,1,0,1,1
"lib/ruby/1.8/irb/cmd/help.rb",0,1,0,1,1
"lib/ruby/1.8/irb/cmd/load.rb",0,1,0,1,1
"lib/ruby/1.8/irb/cmd/nop.rb",0,1,0,1,1
"lib/ruby/1.8/irb/cmd/pushws.rb",0,1,0,1,1
"lib/ruby/1.8/irb/cmd/subirb.rb",0,1,0,1,1
"lib/ruby/1.8/irb/completion.rb",0,0.966981132075472,1,1,2
"lib/ruby/1.8/irb/context.rb",0,1,0,1,1
"lib/ruby/1.8/irb/ext/change-ws.rb",0,1,0,1,1
"lib/ruby/1.8/irb/ext/history.rb",0,1,0,1,1
"lib/ruby/1.8/irb/ext/loader.rb",0,1,0,1,1
"lib/ruby/1.8/irb/ext/math-mode.rb",0,1,0,1,1
"lib/ruby/1.8/irb/ext/multi-irb.rb",0,1,0,1,1
"lib/ruby/1.8/irb/ext/save-history.rb",0,1,0,1,1
"lib/ruby/1.8/irb/ext/tracer.rb",0,1,0,1,1
"lib/ruby/1.8/irb/ext/use-loader.rb",0,1,0,1,1
"lib/ruby/1.8/irb/ext/workspaces.rb",0,1,0,1,1
"lib/ruby/1.8/irb/extend-command.rb",0,1,0,1,1
"lib/ruby/1.8/irb/frame.rb",0,1,0,1,1
"lib/ruby/1.8/irb/help.rb",0,1,0,1,1
"lib/ruby/1.8/irb/init.rb",0,1,0,1,1
"lib/ruby/1.8/irb/input-method.rb",0,1,0,1,1
"lib/ruby/1.8/irb/lc/error.rb",0,1,0,1,1
"lib/ruby/1.8/irb/lc/ja/error.rb",0,1,0,1,1
"lib/ruby/1.8/irb/locale.rb",0,1,0,1,1
"lib/ruby/1.8/irb/notifier.rb",0,1,0,1,1
"lib/ruby/1.8/irb/output-method.rb",0,1,0,1,1
"lib/ruby/1.8/irb/ruby-lex.rb",0,1,0,1,1
"lib/ruby/1.8/irb/ruby-token.rb",0,1,0,1,1
"lib/ruby/1.8/irb/slex.rb",0,1,0,1,1
"lib/ruby/1.8/irb/version.rb",0,1,0,1,1
"lib/ruby/1.8/irb/workspace.rb",0,1,0,1,1
"lib/ruby/1.8/irb/ws-for-case-2.rb",0,1,0,1,1
"lib/ruby/1.8/irb/xmp.rb",0,1,0,1,1
"lib/ruby/1.8/jcode.rb",0,1,0,1,1
"lib/ruby/1.8/kconv.rb",0,1,0,1,1
"lib/ruby/1.8/logger.rb",0,1,0,1,1
"lib/ruby/1.8/mailread.rb",0,1,0,1,1
"lib/ruby/1.8/mathn.rb",0,1,0,1,1
"lib/ruby/1.8/matrix.rb",0,1,0,1,1
"lib/ruby/1.8/md5.rb",0,1,0,1,1
"lib/ruby/1.8/monitor.rb",0,0.736070381231672,0,2,2
"lib/ruby/1.8/mutex_m.rb",0,0.909090909090909,0,2,2
"lib/ruby/1.8/net/ftp.rb",0,1,0,1,1
"lib/ruby/1.8/net/http.rb",0,0.977272727272727,1,1,2
"lib/ruby/1.8/net/https.rb",0,0.988439306358382,1,1,2
"lib/ruby/1.8/net/imap.rb",0,1,0,1,1
"lib/ruby/1.8/net/pop.rb",0,1,0,1,1
"lib/ruby/1.8/net/protocol.rb",0,1,0,1,1
"lib/ruby/1.8/net/smtp.rb",0,1,0,1,1
"lib/ruby/1.8/net/telnet.rb",0,1,0,1,1
"lib/ruby/1.8/observer.rb",0,1,0,1,1
"lib/ruby/1.8/open-uri.rb",0,1,0,1,1
"lib/ruby/1.8/open3.rb",0,1,0,1,1
"lib/ruby/1.8/optparse.rb",0,1,0,1,1
"lib/ruby/1.8/optparse/date.rb",0,1,0,1,1
"lib/ruby/1.8/optparse/shellwords.rb",0,1,0,1,1
"lib/ruby/1.8/optparse/time.rb",0,1,0,1,1
"lib/ruby/1.8/optparse/uri.rb",0,1,0,1,1
"lib/ruby/1.8/optparse/version.rb",0,1,0,1,1
"lib/ruby/1.8/ostruct.rb",0,1,0,1,1
"lib/ruby/1.8/parsearg.rb",0,1,0,1,1
"lib/ruby/1.8/parsedate.rb",0,1,0,1,1
"lib/ruby/1.8/pathname.rb",0,0.996244131455399,1,1,2
"lib/ruby/1.8/ping.rb",0,1,0,1,1
"lib/ruby/1.8/pp.rb",0,1,0,1,1
"lib/ruby/1.8/prettyprint.rb",0,1,0,1,1
"lib/ruby/1.8/profile.rb",0,1,0,1,1
"lib/ruby/1.8/profiler.rb",0,1,0,1,1
"lib/ruby/1.8/pstore.rb",0,1,0,1,1
"lib/ruby/1.8/racc/parser.rb",0,1,0,1,1
"lib/ruby/1.8/rational.rb",0,1,0,1,1
"lib/ruby/1.8/rdoc/code_objects.rb",0,1,0,1,1
"lib/ruby/1.8/rdoc/diagram.rb",0,1,0,1,1
"lib/ruby/1.8/rdoc/dot/dot.rb",0,1,0,1,1
"lib/ruby/1.8/rdoc/generators/chm_generator.rb",0,1,0,1,1
"lib/ruby/1.8/rdoc/generators/html_generator.rb",0,1,0,1,1
"lib/ruby/1.8/rdoc/generators/ri_generator.rb",0,1,0,1,1
"lib/ruby/1.8/rdoc/generators/template/chm/chm.rb",0,1,0,1,1
"lib/ruby/1.8/rdoc/generators/template/html/hefss.rb",0,1,0,1,1
"lib/ruby/1.8/rdoc/generators/template/html/html.rb",0,1,0,1,1
"lib/ruby/1.8/rdoc/generators/template/html/kilmer.rb",0,1,0,1,1
"lib/ruby/1.8/rdoc/generators/template/html/old_html.rb",0,1,0,1,1
"lib/ruby/1.8/rdoc/generators/template/html/one_page_html.rb",0,1,0,1,1
"lib/ruby/1.8/rdoc/generators/template/xml/rdf.rb",0,1,0,1,1
"lib/ruby/1.8/rdoc/generators/template/xml/xml.rb",0,1,0,1,1
"lib/ruby/1.8/rdoc/generators/xml_generator.rb",0,1,0,1,1
"lib/ruby/1.8/rdoc/markup/sample/rdoc2latex.rb",0,1,0,1,1
"lib/ruby/1.8/rdoc/markup/sample/sample.rb",0,1,0,1,1
"lib/ruby/1.8/rdoc/markup/simple_markup.rb",0,1,0,1,1
"lib/ruby/1.8/rdoc/markup/simple_markup/fragments.rb",0,1,0,1,1
"lib/ruby/1.8/rdoc/markup/simple_markup/inline.rb",0,1,0,1,1
"lib/ruby/1.8/rdoc/markup/simple_markup/lines.rb",0,1,0,1,1
"lib/ruby/1.8/rdoc/markup/simple_markup/preprocess.rb",0,1,0,1,1
"lib/ruby/1.8/rdoc/markup/simple_markup/to_flow.rb",0,1,0,1,1
"lib/ruby/1.8/rdoc/markup/simple_markup/to_html.rb",0,1,0,1,1
"lib/ruby/1.8/rdoc/markup/simple_markup/to_latex.rb",0,1,0,1,1
"lib/ruby/1.8/rdoc/markup/test/AllTests.rb",0,1,0,1,1
"lib/ruby/1.8/rdoc/markup/test/TestInline.rb",0,1,0,1,1
"lib/ruby/1.8/rdoc/markup/test/TestParse.rb",0,1,0,1,1
"lib/ruby/1.8/rdoc/options.rb",0,1,0,1,1
"lib/ruby/1.8/rdoc/parsers/parse_c.rb",0,1,0,1,1
"lib/ruby/1.8/rdoc/parsers/parse_f95.rb",0,1,0,1,1
"lib/ruby/1.8/rdoc/parsers/parse_rb.rb",0,1,0,1,1
"lib/ruby/1.8/rdoc/parsers/parse_simple.rb",0,1,0,1,1
"lib/ruby/1.8/rdoc/parsers/parserfactory.rb",0,1,0,1,1
"lib/ruby/1.8/rdoc/rdoc.rb",0,1,0,1,1
"lib/ruby/1.8/rdoc/ri/ri_cache.rb",0,1,0,1,1
"lib/ruby/1.8/rdoc/ri/ri_descriptions.rb",0,1,0,1,1
"lib/ruby/1.8/rdoc/ri/ri_display.rb",0,1,0,1,1
"lib/ruby/1.8/rdoc/ri/ri_driver.rb",0,1,0,1,1
"lib/ruby/1.8/rdoc/ri/ri_formatter.rb",0,1,0,1,1
"lib/ruby/1.8/rdoc/ri/ri_options.rb",0,1,0,1,1
"lib/ruby/1.8/rdoc/ri/ri_paths.rb",0,1,0,1,1
"lib/ruby/1.8/rdoc/ri/ri_reader.rb",0,1,0,1,1
"lib/ruby/1.8/rdoc/ri/ri_util.rb",0,1,0,1,1
"lib/ruby/1.8/rdoc/ri/ri_writer.rb",0,1,0,1,1
"lib/ruby/1.8/rdoc/template.rb",0,1,0,1,1
"lib/ruby/1.8/rdoc/tokenstream.rb",0,1,0,1,1
"lib/ruby/1.8/rdoc/usage.rb",0,1,0,1,1
"lib/ruby/1.8/readbytes.rb",0,1,0,1,1
"lib/ruby/1.8/resolv-replace.rb",0,1,0,1,1
"lib/ruby/1.8/resolv.rb",0,0.996820349761526,1,1,2
"lib/ruby/1.8/rexml/attlistdecl.rb",0,1,0,1,1
"lib/ruby/1.8/rexml/attribute.rb",0,1,0,1,1
"lib/ruby/1.8/rexml/cdata.rb",0,1,0,1,1
"lib/ruby/1.8/rexml/child.rb",0,1,0,1,1
"lib/ruby/1.8/rexml/comment.rb",0,1,0,1,1
"lib/ruby/1.8/rexml/doctype.rb",0,1,0,1,1
"lib/ruby/1.8/rexml/document.rb",0,1,0,1,1
"lib/ruby/1.8/rexml/dtd/attlistdecl.rb",0,1,0,1,1
"lib/ruby/1.8/rexml/dtd/dtd.rb",0,1,0,1,1
"lib/ruby/1.8/rexml/dtd/elementdecl.rb",0,1,0,1,1
"lib/ruby/1.8/rexml/dtd/entitydecl.rb",0,1,0,1,1
"lib/ruby/1.8/rexml/dtd/notationdecl.rb",0,1,0,1,1
"lib/ruby/1.8/rexml/element.rb",0,1,0,1,1
"lib/ruby/1.8/rexml/encoding.rb",0,1,0,1,1
"lib/ruby/1.8/rexml/encodings/CP-1252.rb",0,1,0,1,1
"lib/ruby/1.8/rexml/encodings/EUC-JP.rb",0,1,0,1,1
"lib/ruby/1.8/rexml/encodings/ICONV.rb",0,1,0,1,1
"lib/ruby/1.8/rexml/encodings/ISO-8859-1.rb",0,1,0,1,1
"lib/ruby/1.8/rexml/encodings/ISO-8859-15.rb",0,1,0,1,1
"lib/ruby/1.8/rexml/encodings/SHIFT-JIS.rb",0,1,0,1,1
"lib/ruby/1.8/rexml/encodings/SHIFT_JIS.rb",0,1,0,1,1
"lib/ruby/1.8/rexml/encodings/UNILE.rb",0,1,0,1,1
"lib/ruby/1.8/rexml/encodings/US-ASCII.rb",0,1,0,1,1
"lib/ruby/1.8/rexml/encodings/UTF-16.rb",0,1,0,1,1
"lib/ruby/1.8/rexml/encodings/UTF-8.rb",0,1,0,1,1
"lib/ruby/1.8/rexml/entity.rb",0,1,0,1,1
"lib/ruby/1.8/rexml/formatters/default.rb",0,1,0,1,1
"lib/ruby/1.8/rexml/formatters/pretty.rb",0,1,0,1,1
"lib/ruby/1.8/rexml/formatters/transitive.rb",0,1,0,1,1
"lib/ruby/1.8/rexml/functions.rb",0,1,0,1,1
"lib/ruby/1.8/rexml/instruction.rb",0,1,0,1,1
"lib/ruby/1.8/rexml/light/node.rb",0,1,0,1,1
"lib/ruby/1.8/rexml/namespace.rb",0,1,0,1,1
"lib/ruby/1.8/rexml/node.rb",0,1,0,1,1
"lib/ruby/1.8/rexml/output.rb",0,1,0,1,1
"lib/ruby/1.8/rexml/parent.rb",0,1,0,1,1
"lib/ruby/1.8/rexml/parseexception.rb",0,1,0,1,1
"lib/ruby/1.8/rexml/parsers/baseparser.rb",0,1,0,1,1
"lib/ruby/1.8/rexml/parsers/lightparser.rb",0,1,0,1,1
"lib/ruby/1.8/rexml/parsers/pullparser.rb",0,1,0,1,1
"lib/ruby/1.8/rexml/parsers/sax2parser.rb",0,1,0,1,1
"lib/ruby/1.8/rexml/parsers/streamparser.rb",0,1,0,1,1
"lib/ruby/1.8/rexml/parsers/treeparser.rb",0,1,0,1,1
"lib/ruby/1.8/rexml/parsers/ultralightparser.rb",0,1,0,1,1
"lib/ruby/1.8/rexml/parsers/xpathparser.rb",0,1,0,1,1
"lib/ruby/1.8/rexml/quickpath.rb",0,1,0,1,1
"lib/ruby/1.8/rexml/rexml.rb",0,1,0,1,1
"lib/ruby/1.8/rexml/sax2listener.rb",0,1,0,1,1
"lib/ruby/1.8/rexml/source.rb",0,1,0,1,1
"lib/ruby/1.8/rexml/streamlistener.rb",0,1,0,1,1
"lib/ruby/1.8/rexml/syncenumerator.rb",0,1,0,1,1
"lib/ruby/1.8/rexml/text.rb",0,1,0,1,1
"lib/ruby/1.8/rexml/validation/relaxng.rb",0,1,0,1,1
"lib/ruby/1.8/rexml/validation/validation.rb",0,1,0,1,1
"lib/ruby/1.8/rexml/validation/validationexception.rb",0,1,0,1,1
"lib/ruby/1.8/rexml/xmldecl.rb",0,1,0,1,1
"lib/ruby/1.8/rexml/xmltokens.rb",0,1,0,1,1
"lib/ruby/1.8/rexml/xpath.rb",0,1,0,1,1
"lib/ruby/1.8/rexml/xpath_parser.rb",0,1,0,1,1
"lib/ruby/1.8/rinda/rinda.rb",0,1,0,1,1
"lib/ruby/1.8/rinda/ring.rb",0,1,0,1,1
"lib/ruby/1.8/rinda/tuplespace.rb",0,1,0,1,1
"lib/ruby/1.8/rss.rb",0,1,0,1,1
"lib/ruby/1.8/rss/0.9.rb",0,1,0,1,1
"lib/ruby/1.8/rss/1.0.rb",0,1,0,1,1
"lib/ruby/1.8/rss/2.0.rb",0,1,0,1,1
"lib/ruby/1.8/rss/content.rb",0,1,0,1,1
"lib/ruby/1.8/rss/converter.rb",0,1,0,1,1
"lib/ruby/1.8/rss/dublincore.rb",0,1,0,1,1
"lib/ruby/1.8/rss/image.rb",0,1,0,1,1
"lib/ruby/1.8/rss/maker.rb",0,1,0,1,1
"lib/ruby/1.8/rss/maker/0.9.rb",0,1,0,1,1
"lib/ruby/1.8/rss/maker/1.0.rb",0,1,0,1,1
"lib/ruby/1.8/rss/maker/2.0.rb",0,1,0,1,1
"lib/ruby/1.8/rss/maker/base.rb",0,1,0,1,1
"lib/ruby/1.8/rss/maker/content.rb",0,1,0,1,1
"lib/ruby/1.8/rss/maker/dublincore.rb",0,1,0,1,1
"lib/ruby/1.8/rss/maker/image.rb",0,1,0,1,1
"lib/ruby/1.8/rss/maker/syndication.rb",0,1,0,1,1
"lib/ruby/1.8/rss/maker/taxonomy.rb",0,1,0,1,1
"lib/ruby/1.8/rss/maker/trackback.rb",0,1,0,1,1
"lib/ruby/1.8/rss/parser.rb",0,1,0,1,1
"lib/ruby/1.8/rss/rexmlparser.rb",0,1,0,1,1
"lib/ruby/1.8/rss/rss.rb",0,1,0,1,1
"lib/ruby/1.8/rss/syndication.rb",0,1,0,1,1
"lib/ruby/1.8/rss/taxonomy.rb",0,1,0,1,1
"lib/ruby/1.8/rss/trackback.rb",0,1,0,1,1
"lib/ruby/1.8/rss/utils.rb",0,1,0,1,1
"lib/ruby/1.8/rss/xml-stylesheet.rb",0,1,0,1,1
"lib/ruby/1.8/rss/xmlparser.rb",0,1,0,1,1
"lib/ruby/1.8/rss/xmlscanner.rb",0,1,0,1,1
"lib/ruby/1.8/rubyunit.rb",0,1,0,1,1
"lib/ruby/1.8/runit/assert.rb",0,1,0,1,1
"lib/ruby/1.8/runit/cui/testrunner.rb",0,1,0,1,1
"lib/ruby/1.8/runit/error.rb",0,1,0,1,1
"lib/ruby/1.8/runit/testcase.rb",0,1,0,1,1
"lib/ruby/1.8/runit/testresult.rb",0,1,0,1,1
"lib/ruby/1.8/runit/testsuite.rb",0,1,0,1,1
"lib/ruby/1.8/runit/topublic.rb",0,1,0,1,1
"lib/ruby/1.8/scanf.rb",0,1,0,1,1
"lib/ruby/1.8/set.rb",0,1,0,1,1
"lib/ruby/1.8/sha1.rb",0,1,0,1,1
"lib/ruby/1.8/shell.rb",0,1,0,1,1
"lib/ruby/1.8/shell/builtin-command.rb",0,1,0,1,1
"lib/ruby/1.8/shell/command-processor.rb",0,1,0,1,1
"lib/ruby/1.8/shell/error.rb",0,1,0,1,1
"lib/ruby/1.8/shell/filter.rb",0,1,0,1,1
"lib/ruby/1.8/shell/process-controller.rb",0,1,0,1,1
"lib/ruby/1.8/shell/system-command.rb",0,1,0,1,1
"lib/ruby/1.8/shell/version.rb",0,1,0,1,1
"lib/ruby/1.8/shellwords.rb",0,1,0,1,1
"lib/ruby/1.8/singleton.rb",0,0.903225806451613,0,2,2
"lib/ruby/1.8/soap/attachment.rb",0,1,0,1,1
"lib/ruby/1.8/soap/baseData.rb",0,1,0,1,1
"lib/ruby/1.8/soap/element.rb",0,1,0,1,1
"lib/ruby/1.8/soap/encodingstyle/aspDotNetHandler.rb",0,1,0,1,1
"lib/ruby/1.8/soap/encodingstyle/handler.rb",0,1,0,1,1
"lib/ruby/1.8/soap/encodingstyle/literalHandler.rb",0,1,0,1,1
"lib/ruby/1.8/soap/encodingstyle/soapHandler.rb",0,1,0,1,1
"lib/ruby/1.8/soap/generator.rb",0,1,0,1,1
"lib/ruby/1.8/soap/header/handler.rb",0,1,0,1,1
"lib/ruby/1.8/soap/header/handlerset.rb",0,1,0,1,1
"lib/ruby/1.8/soap/header/simplehandler.rb",0,1,0,1,1
"lib/ruby/1.8/soap/httpconfigloader.rb",0,1,0,1,1
"lib/ruby/1.8/soap/mapping.rb",0,1,0,1,1
"lib/ruby/1.8/soap/mapping/factory.rb",0,1,0,1,1
"lib/ruby/1.8/soap/mapping/mapping.rb",0,1,0,1,1
"lib/ruby/1.8/soap/mapping/registry.rb",0,1,0,1,1
"lib/ruby/1.8/soap/mapping/rubytypeFactory.rb",0,1,0,1,1
"lib/ruby/1.8/soap/mapping/typeMap.rb",0,1,0,1,1
"lib/ruby/1.8/soap/mapping/wsdlencodedregistry.rb",0,1,0,1,1
"lib/ruby/1.8/soap/mapping/wsdlliteralregistry.rb",0,1,0,1,1
"lib/ruby/1.8/soap/marshal.rb",0,1,0,1,1
"lib/ruby/1.8/soap/mimemessage.rb",0,1,0,1,1
"lib/ruby/1.8/soap/netHttpClient.rb",0,1,0,1,1
"lib/ruby/1.8/soap/parser.rb",0,1,0,1,1
"lib/ruby/1.8/soap/processor.rb",0,1,0,1,1
"lib/ruby/1.8/soap/property.rb",0,1,0,1,1
"lib/ruby/1.8/soap/rpc/cgistub.rb",0,1,0,1,1
"lib/ruby/1.8/soap/rpc/driver.rb",0,1,0,1,1
"lib/ruby/1.8/soap/rpc/element.rb",0,1,0,1,1
"lib/ruby/1.8/soap/rpc/httpserver.rb",0,1,0,1,1
"lib/ruby/1.8/soap/rpc/proxy.rb",0,1,0,1,1
"lib/ruby/1.8/soap/rpc/router.rb",0,1,0,1,1
"lib/ruby/1.8/soap/rpc/rpc.rb",0,1,0,1,1
"lib/ruby/1.8/soap/rpc/soaplet.rb",0,1,0,1,1
"lib/ruby/1.8/soap/rpc/standaloneServer.rb",0,1,0,1,1
"lib/ruby/1.8/soap/soap.rb",0,1,0,1,1
"lib/ruby/1.8/soap/streamHandler.rb",0,1,0,1,1
"lib/ruby/1.8/soap/wsdlDriver.rb",0,1,0,1,1
"lib/ruby/1.8/sync.rb",0,0.587837837837838,0,2,2
"lib/ruby/1.8/tempfile.rb",0,0.628019323671498,0,2,2
"lib/ruby/1.8/test/unit.rb",0,1,0,1,1
"lib/ruby/1.8/test/unit/assertionfailederror.rb",0,1,0,1,1
"lib/ruby/1.8/test/unit/assertions.rb",0,1,0,1,1
"lib/ruby/1.8/test/unit/autorunner.rb",0,1,0,1,1
"lib/ruby/1.8/test/unit/collector.rb",0,1,0,1,1
"lib/ruby/1.8/test/unit/collector/dir.rb",0,1,0,1,1
"lib/ruby/1.8/test/unit/collector/objectspace.rb",0,1,0,1,1
"lib/ruby/1.8/test/unit/error.rb",0,1,0,1,1
"lib/ruby/1.8/test/unit/failure.rb",0,1,0,1,1
"lib/ruby/1.8/test/unit/testcase.rb",0,1,0,1,1
"lib/ruby/1.8/test/unit/testresult.rb",0,1,0,1,1
"lib/ruby/1.8/test/unit/testsuite.rb",0,1,0,1,1
"lib/ruby/1.8/test/unit/ui/console/testrunner.rb",0,1,0,1,1
"lib/ruby/1.8/test/unit/ui/fox/testrunner.rb",0,1,0,1,1
"lib/ruby/1.8/test/unit/ui/gtk/testrunner.rb",0,1,0,1,1
"lib/ruby/1.8/test/unit/ui/gtk2/testrunner.rb",0,1,0,1,1
"lib/ruby/1.8/test/unit/ui/testrunnermediator.rb",0,1,0,1,1
"lib/ruby/1.8/test/unit/ui/testrunnerutilities.rb",0,1,0,1,1
"lib/ruby/1.8/test/unit/ui/tk/testrunner.rb",0,1,0,1,1
"lib/ruby/1.8/test/unit/util/backtracefilter.rb",0,1,0,1,1
"lib/ruby/1.8/test/unit/util/observable.rb",0,1,0,1,1
"lib/ruby/1.8/test/unit/util/procwrapper.rb",0,1,0,1,1
"lib/ruby/1.8/thread.rb",0,0.971428571428571,1,1,2
"lib/ruby/1.8/thwait.rb",0,1,0,1,1
"lib/ruby/1.8/time.rb",0,0.993726474278545,1,1,2
"lib/ruby/1.8/timeout.rb",0,0.923809523809524,0,2,2
"lib/ruby/1.8/tmpdir.rb",0,1,0,1,1
"lib/ruby/1.8/tracer.rb",0,1,0,1,1
"lib/ruby/1.8/tsort.rb",0,1,0,1,1
"lib/ruby/1.8/un.rb",0,1,0,1,1
"lib/ruby/1.8/uri.rb",0,1,0,1,1
"lib/ruby/1.8/uri/common.rb",0,1,0,1,1
"lib/ruby/1.8/uri/ftp.rb",0,1,0,1,1
"lib/ruby/1.8/uri/generic.rb",0,1,0,1,1
"lib/ruby/1.8/uri/http.rb",0,1,0,1,1
"lib/ruby/1.8/uri/https.rb",0,1,0,1,1
"lib/ruby/1.8/uri/ldap.rb",0,1,0,1,1
"lib/ruby/1.8/uri/mailto.rb",0,1,0,1,1
"lib/ruby/1.8/webrick.rb",0,1,0,1,1
"lib/ruby/1.8/webrick/accesslog.rb",0,1,0,1,1
"lib/ruby/1.8/webrick/cgi.rb",0,1,0,1,1
"lib/ruby/1.8/webrick/compat.rb",0,1,0,1,1
"lib/ruby/1.8/webrick/config.rb",0,1,0,1,1
"lib/ruby/1.8/webrick/cookie.rb",0,1,0,1,1
"lib/ruby/1.8/webrick/htmlutils.rb",0,1,0,1,1
"lib/ruby/1.8/webrick/httpauth.rb",0,1,0,1,1
"lib/ruby/1.8/webrick/httpauth/authenticator.rb",0,1,0,1,1
"lib/ruby/1.8/webrick/httpauth/basicauth.rb",0,1,0,1,1
"lib/ruby/1.8/webrick/httpauth/digestauth.rb",0,1,0,1,1
"lib/ruby/1.8/webrick/httpauth/htdigest.rb",0,1,0,1,1
"lib/ruby/1.8/webrick/httpauth/htgroup.rb",0,1,0,1,1
"lib/ruby/1.8/webrick/httpauth/htpasswd.rb",0,1,0,1,1
"lib/ruby/1.8/webrick/httpauth/userdb.rb",0,1,0,1,1
"lib/ruby/1.8/webrick/httpproxy.rb",0,1,0,1,1
"lib/ruby/1.8/webrick/httprequest.rb",0,1,0,1,1
"lib/ruby/1.8/webrick/httpresponse.rb",0,1,0,1,1
"lib/ruby/1.8/webrick/https.rb",0,1,0,1,1
"lib/ruby/1.8/webrick/httpserver.rb",0,1,0,1,1
"lib/ruby/1.8/webrick/httpservlet.rb",0,1,0,1,1
"lib/ruby/1.8/webrick/httpservlet/abstract.rb",0,1,0,1,1
"lib/ruby/1.8/webrick/httpservlet/cgi_runner.rb",0,1,0,1,1
"lib/ruby/1.8/webrick/httpservlet/cgihandler.rb",0,1,0,1,1
"lib/ruby/1.8/webrick/httpservlet/erbhandler.rb",0,1,0,1,1
"lib/ruby/1.8/webrick/httpservlet/filehandler.rb",0,1,0,1,1
"lib/ruby/1.8/webrick/httpservlet/prochandler.rb",0,1,0,1,1
"lib/ruby/1.8/webrick/httpstatus.rb",0,1,0,1,1
"lib/ruby/1.8/webrick/httputils.rb",0,1,0,1,1
"lib/ruby/1.8/webrick/httpversion.rb",0,1,0,1,1
"lib/ruby/1.8/webrick/log.rb",0,1,0,1,1
"lib/ruby/1.8/webrick/server.rb",0,1,0,1,1
"lib/ruby/1.8/webrick/ssl.rb",0,1,0,1,1
"lib/ruby/1.8/webrick/utils.rb",0,1,0,1,1
"lib/ruby/1.8/webrick/version.rb",0,1,0,1,1
"lib/ruby/1.8/wsdl/binding.rb",0,1,0,1,1
"lib/ruby/1.8/wsdl/data.rb",0,1,0,1,1
"lib/ruby/1.8/wsdl/definitions.rb",0,1,0,1,1
"lib/ruby/1.8/wsdl/documentation.rb",0,1,0,1,1
"lib/ruby/1.8/wsdl/import.rb",0,1,0,1,1
"lib/ruby/1.8/wsdl/importer.rb",0,1,0,1,1
"lib/ruby/1.8/wsdl/info.rb",0,1,0,1,1
"lib/ruby/1.8/wsdl/message.rb",0,1,0,1,1
"lib/ruby/1.8/wsdl/operation.rb",0,1,0,1,1
"lib/ruby/1.8/wsdl/operationBinding.rb",0,1,0,1,1
"lib/ruby/1.8/wsdl/param.rb",0,1,0,1,1
"lib/ruby/1.8/wsdl/parser.rb",0,1,0,1,1
"lib/ruby/1.8/wsdl/part.rb",0,1,0,1,1
"lib/ruby/1.8/wsdl/port.rb",0,1,0,1,1
"lib/ruby/1.8/wsdl/portType.rb",0,1,0,1,1
"lib/ruby/1.8/wsdl/service.rb",0,1,0,1,1
"lib/ruby/1.8/wsdl/soap/address.rb",0,1,0,1,1
"lib/ruby/1.8/wsdl/soap/binding.rb",0,1,0,1,1
"lib/ruby/1.8/wsdl/soap/body.rb",0,1,0,1,1
"lib/ruby/1.8/wsdl/soap/cgiStubCreator.rb",0,1,0,1,1
"lib/ruby/1.8/wsdl/soap/classDefCreator.rb",0,1,0,1,1
"lib/ruby/1.8/wsdl/soap/classDefCreatorSupport.rb",0,1,0,1,1
"lib/ruby/1.8/wsdl/soap/clientSkeltonCreator.rb",0,1,0,1,1
"lib/ruby/1.8/wsdl/soap/complexType.rb",0,1,0,1,1
"lib/ruby/1.8/wsdl/soap/data.rb",0,1,0,1,1
"lib/ruby/1.8/wsdl/soap/definitions.rb",0,1,0,1,1
"lib/ruby/1.8/wsdl/soap/driverCreator.rb",0,1,0,1,1
"lib/ruby/1.8/wsdl/soap/element.rb",0,1,0,1,1
"lib/ruby/1.8/wsdl/soap/fault.rb",0,1,0,1,1
"lib/ruby/1.8/wsdl/soap/header.rb",0,1,0,1,1
"lib/ruby/1.8/wsdl/soap/headerfault.rb",0,1,0,1,1
"lib/ruby/1.8/wsdl/soap/mappingRegistryCreator.rb",0,1,0,1,1
"lib/ruby/1.8/wsdl/soap/methodDefCreator.rb",0,1,0,1,1
"lib/ruby/1.8/wsdl/soap/operation.rb",0,1,0,1,1
"lib/ruby/1.8/wsdl/soap/servantSkeltonCreator.rb",0,1,0,1,1
"lib/ruby/1.8/wsdl/soap/standaloneServerStubCreator.rb",0,1,0,1,1
"lib/ruby/1.8/wsdl/soap/wsdl2ruby.rb",0,1,0,1,1
"lib/ruby/1.8/wsdl/types.rb",0,1,0,1,1
"lib/ruby/1.8/wsdl/wsdl.rb",0,1,0,1,1
"lib/ruby/1.8/wsdl/xmlSchema/all.rb",0,1,0,1,1
"lib/ruby/1.8/wsdl/xmlSchema/annotation.rb",0,1,0,1,1
"lib/ruby/1.8/wsdl/xmlSchema/any.rb",0,1,0,1,1
"lib/ruby/1.8/wsdl/xmlSchema/attribute.rb",0,1,0,1,1
"lib/ruby/1.8/wsdl/xmlSchema/choice.rb",0,1,0,1,1
"lib/ruby/1.8/wsdl/xmlSchema/complexContent.rb",0,1,0,1,1
"lib/ruby/1.8/wsdl/xmlSchema/complexType.rb",0,1,0,1,1
"lib/ruby/1.8/wsdl/xmlSchema/content.rb",0,1,0,1,1
"lib/ruby/1.8/wsdl/xmlSchema/data.rb",0,1,0,1,1
"lib/ruby/1.8/wsdl/xmlSchema/element.rb",0,1,0,1,1
"lib/ruby/1.8/wsdl/xmlSchema/enumeration.rb",0,1,0,1,1
"lib/ruby/1.8/wsdl/xmlSchema/import.rb",0,1,0,1,1
"lib/ruby/1.8/wsdl/xmlSchema/importer.rb",0,1,0,1,1
"lib/ruby/1.8/wsdl/xmlSchema/include.rb",0,1,0,1,1
"lib/ruby/1.8/wsdl/xmlSchema/length.rb",0,1,0,1,1
"lib/ruby/1.8/wsdl/xmlSchema/parser.rb",0,1,0,1,1
"lib/ruby/1.8/wsdl/xmlSchema/pattern.rb",0,1,0,1,1
"lib/ruby/1.8/wsdl/xmlSchema/schema.rb",0,1,0,1,1
"lib/ruby/1.8/wsdl/xmlSchema/sequence.rb",0,1,0,1,1
"lib/ruby/1.8/wsdl/xmlSchema/simpleContent.rb",0,1,0,1,1
"lib/ruby/1.8/wsdl/xmlSchema/simpleExtension.rb",0,1,0,1,1
"lib/ruby/1.8/wsdl/xmlSchema/simpleRestriction.rb",0,1,0,1,1
"lib/ruby/1.8/wsdl/xmlSchema/simpleType.rb",0,1,0,1,1
"lib/ruby/1.8/wsdl/xmlSchema/unique.rb",0,1,0,1,1
"lib/ruby/1.8/wsdl/xmlSchema/xsd2ruby.rb",0,1,0,1,1
"lib/ruby/1.8/xmlrpc/base64.rb",0,1,0,1,1
"lib/ruby/1.8/xmlrpc/client.rb",0,1,0,1,1
"lib/ruby/1.8/xmlrpc/config.rb",0,1,0,1,1
"lib/ruby/1.8/xmlrpc/create.rb",0,1,0,1,1
"lib/ruby/1.8/xmlrpc/datetime.rb",0,1,0,1,1
"lib/ruby/1.8/xmlrpc/httpserver.rb",0,1,0,1,1
"lib/ruby/1.8/xmlrpc/marshal.rb",0,1,0,1,1
"lib/ruby/1.8/xmlrpc/parser.rb",0,1,0,1,1
"lib/ruby/1.8/xmlrpc/server.rb",0,1,0,1,1
"lib/ruby/1.8/xmlrpc/utils.rb",0,1,0,1,1
"lib/ruby/1.8/xsd/charset.rb",0,1,0,1,1
"lib/ruby/1.8/xsd/codegen.rb",0,1,0,1,1
"lib/ruby/1.8/xsd/codegen/classdef.rb",0,1,0,1,1
"lib/ruby/1.8/xsd/codegen/commentdef.rb",0,1,0,1,1
"lib/ruby/1.8/xsd/codegen/gensupport.rb",0,1,0,1,1
"lib/ruby/1.8/xsd/codegen/methoddef.rb",0,1,0,1,1
"lib/ruby/1.8/xsd/codegen/moduledef.rb",0,1,0,1,1
"lib/ruby/1.8/xsd/datatypes.rb",0,1,0,1,1
"lib/ruby/1.8/xsd/datatypes1999.rb",0,1,0,1,1
"lib/ruby/1.8/xsd/iconvcharset.rb",0,1,0,1,1
"lib/ruby/1.8/xsd/mapping.rb",0,1,0,1,1
"lib/ruby/1.8/xsd/namedelements.rb",0,1,0,1,1
"lib/ruby/1.8/xsd/ns.rb",0,1,0,1,1
"lib/ruby/1.8/xsd/qname.rb",0,1,0,1,1
"lib/ruby/1.8/xsd/xmlparser.rb",0,1,0,1,1
"lib/ruby/1.8/xsd/xmlparser/parser.rb",0,1,0,1,1
"lib/ruby/1.8/xsd/xmlparser/rexmlparser.rb",0,1,0,1,1
"lib/ruby/1.8/xsd/xmlparser/xmlparser.rb",0,1,0,1,1
"lib/ruby/1.8/xsd/xmlparser/xmlscanner.rb",0,1,0,1,1
"lib/ruby/gems/1.8/gems/sources-0.0.1/lib/sources.rb",0,1,0,1,1
"lib/ruby/site_ruby/1.8/builtin/java/ast.rb",0,1,0,1,1
"lib/ruby/site_ruby/1.8/builtin/java/collections.rb",0,0.639097744360902,0,4,4
"lib/ruby/site_ruby/1.8/builtin/java/exceptions.rb",0,0.6,0,2,2
"lib/ruby/site_ruby/1.8/builtin/java/interfaces.rb",0,0.666666666666667,0,2,2
"lib/ruby/site_ruby/1.8/builtin/java/regex.rb",0,1,0,1,1
"lib/ruby/site_ruby/1.8/builtin/javasupport.rb",0,0.58,1,5,6
"lib/ruby/site_ruby/1.8/builtin/javasupport/core_ext.rb",0,0.5,0,3,3
"lib/ruby/site_ruby/1.8/builtin/javasupport/core_ext/array.rb",0,1,0,1,1
"lib/ruby/site_ruby/1.8/builtin/javasupport/core_ext/kernel.rb",0,0.625,0,2,2
"lib/ruby/site_ruby/1.8/builtin/javasupport/core_ext/module.rb",0,0.946428571428571,0,2,2
"lib/ruby/site_ruby/1.8/builtin/javasupport/core_ext/object.rb",0,0.47008547008547,1,3,4
"lib/ruby/site_ruby/1.8/builtin/javasupport/core_ext/proc.rb",0,1,0,1,1
"lib/ruby/site_ruby/1.8/builtin/javasupport/core_ext/string.rb",0,1,0,1,1
"lib/ruby/site_ruby/1.8/builtin/javasupport/java.rb",0,0.46,0,3,3
"lib/ruby/site_ruby/1.8/builtin/javasupport/proxy/array.rb",0,1,0,1,1
"lib/ruby/site_ruby/1.8/builtin/javasupport/proxy/base.rb",0,0.507462686567164,0,2,2
"lib/ruby/site_ruby/1.8/builtin/javasupport/proxy/concrete.rb",0,0.88,1,2,3
"lib/ruby/site_ruby/1.8/builtin/javasupport/proxy/interface.rb",0,0.581749049429658,2,3,5
"lib/ruby/site_ruby/1.8/builtin/javasupport/utilities/array.rb",0,1,0,1,1
"lib/ruby/site_ruby/1.8/builtin/javasupport/utilities/base.rb",0,0.58974358974359,0,3,3
"lib/ruby/site_ruby/1.8/builtin/rdoc_jruby.rb",0,1,0,1,1
"lib/ruby/site_ruby/1.8/compiler/builder.rb",0,1,0,1,1
"lib/ruby/site_ruby/1.8/compiler/bytecode.rb",0,1,0,1,1
"lib/ruby/site_ruby/1.8/compiler/duby.rb",0,1,0,1,1
"lib/ruby/site_ruby/1.8/compiler/duby/ast.rb",0,1,0,1,1
"lib/ruby/site_ruby/1.8/compiler/duby/compiler.rb",0,1,0,1,1
"lib/ruby/site_ruby/1.8/compiler/duby/declaration.rb",0,1,0,1,1
"lib/ruby/site_ruby/1.8/compiler/duby/mapper.rb",0,1,0,1,1
"lib/ruby/site_ruby/1.8/compiler/duby/signature.rb",0,1,0,1,1
"lib/ruby/site_ruby/1.8/compiler/duby/transform.rb",0,1,0,1,1
"lib/ruby/site_ruby/1.8/compiler/duby/typer.rb",0,1,0,1,1
"lib/ruby/site_ruby/1.8/compiler/signature.rb",0,1,0,1,1
"lib/ruby/site_ruby/1.8/gemconfigure.rb",0,0.916666666666667,0,2,2
"lib/ruby/site_ruby/1.8/jruby/jrubyc.rb",0,1,0,1,1
"lib/ruby/site_ruby/1.8/jruby/openssl/builtin.rb",0,1,0,1,1
"lib/ruby/site_ruby/1.8/jruby/openssl/gem.rb",0,1,0,1,1
"lib/ruby/site_ruby/1.8/jruby/openssl/gem_only.rb",0,1,0,1,1
"lib/ruby/site_ruby/1.8/jruby/openssl/stub.rb",0,1,0,1,1
"lib/ruby/site_ruby/1.8/rbconfig/datadir.rb",0,1,0,1,1
"lib/ruby/site_ruby/1.8/rubygems.rb",0,0.549019607843137,1,2,3
"lib/ruby/site_ruby/1.8/rubygems/builder.rb",0,0.506172839506173,0,3,3
"lib/ruby/site_ruby/1.8/rubygems/command.rb",0,0.529556650246305,0,2,2
"lib/ruby/site_ruby/1.8/rubygems/command_manager.rb",0,0.597222222222222,0,3,3
"lib/ruby/site_ruby/1.8/rubygems/commands/build_command.rb",0,0.773584905660377,0,2,2
"lib/ruby/site_ruby/1.8/rubygems/commands/cert_command.rb",0,0.837209302325581,0,2,2
"lib/ruby/site_ruby/1.8/rubygems/commands/check_command.rb",0,0.851351351351351,0,2,2
"lib/ruby/site_ruby/1.8/rubygems/commands/cleanup_command.rb",0,0.731182795698925,0,2,2
"lib/ruby/site_ruby/1.8/rubygems/commands/contents_command.rb",0,0.945945945945946,0,2,2
"lib/ruby/site_ruby/1.8/rubygems/commands/dependency_command.rb",0,0.873333333333333,0,2,2
"lib/ruby/site_ruby/1.8/rubygems/commands/environment_command.rb",0,0.8375,0,2,2
"lib/ruby/site_ruby/1.8/rubygems/commands/fetch_command.rb",0,1,0,1,1
"lib/ruby/site_ruby/1.8/rubygems/commands/generate_index_command.rb",0,1,0,1,1
"lib/ruby/site_ruby/1.8/rubygems/commands/help_command.rb",0,0.947674418604651,0,2,2
"lib/ruby/site_ruby/1.8/rubygems/commands/install_command.rb",0,0.913385826771654,0,2,2
"lib/ruby/site_ruby/1.8/rubygems/commands/list_command.rb",0,0.714285714285714,0,2,2
"lib/ruby/site_ruby/1.8/rubygems/commands/lock_command.rb",0,1,0,1,1
"lib/ruby/site_ruby/1.8/rubygems/commands/mirror_command.rb",0,1,0,1,1
"lib/ruby/site_ruby/1.8/rubygems/commands/outdated_command.rb",0,0.8,0,2,2
"lib/ruby/site_ruby/1.8/rubygems/commands/pristine_command.rb",0,0.887218045112782,0,2,2
"lib/ruby/site_ruby/1.8/rubygems/commands/query_command.rb",0,0.925,0,2,2
"lib/ruby/site_ruby/1.8/rubygems/commands/rdoc_command.rb",0,0.833333333333333,0,2,2
"lib/ruby/site_ruby/1.8/rubygems/commands/search_command.rb",0,0.72972972972973,0,2,2
"lib/ruby/site_ruby/1.8/rubygems/commands/server_command.rb",0,1,0,1,1
"lib/ruby/site_ruby/1.8/rubygems/commands/sources_command.rb",0,0.904347826086957,0,2,2
"lib/ruby/site_ruby/1.8/rubygems/commands/specification_command.rb",0,0.902777777777778,0,2,2
"lib/ruby/site_ruby/1.8/rubygems/commands/uninstall_command.rb",0,0.696428571428571,0,2,2
"lib/ruby/site_ruby/1.8/rubygems/commands/unpack_command.rb",0,0.903614457831325,0,2,2
"lib/ruby/site_ruby/1.8/rubygems/commands/update_command.rb",0,0.916129032258065,0,2,2
"lib/ruby/site_ruby/1.8/rubygems/commands/which_command.rb",0,1,0,1,1
"lib/ruby/site_ruby/1.8/rubygems/config_file.rb",0,0.90625,0,2,2
"lib/ruby/site_ruby/1.8/rubygems/custom_require.rb",0,0.763157894736842,0,2,2
"lib/ruby/site_ruby/1.8/rubygems/defaults.rb",0,1,0,1,1
"lib/ruby/site_ruby/1.8/rubygems/dependency.rb",0,1,0,1,1
"lib/ruby/site_ruby/1.8/rubygems/dependency_installer.rb",0,1,0,1,1
"lib/ruby/site_ruby/1.8/rubygems/dependency_list.rb",0,0.824242424242424,0,2,2
"lib/ruby/site_ruby/1.8/rubygems/digest/digest_adapter.rb",0,1,0,1,1
"lib/ruby/site_ruby/1.8/rubygems/digest/md5.rb",0,0.826086956521739,0,2,2
"lib/ruby/site_ruby/1.8/rubygems/digest/sha1.rb",0,1,0,1,1
"lib/ruby/site_ruby/1.8/rubygems/digest/sha2.rb",0,0.941176470588235,0,2,2
"lib/ruby/site_ruby/1.8/rubygems/doc_manager.rb",0,0.745341614906832,0,2,2
"lib/ruby/site_ruby/1.8/rubygems/exceptions.rb",0,1,0,1,1
"lib/ruby/site_ruby/1.8/rubygems/ext.rb",0,1,0,1,1
"lib/ruby/site_ruby/1.8/rubygems/ext/builder.rb",0,1,0,1,1
"lib/ruby/site_ruby/1.8/rubygems/ext/configure_builder.rb",0,1,0,1,1
"lib/ruby/site_ruby/1.8/rubygems/ext/ext_conf_builder.rb",0,1,0,1,1
"lib/ruby/site_ruby/1.8/rubygems/ext/rake_builder.rb",0,1,0,1,1
"lib/ruby/site_ruby/1.8/rubygems/format.rb",0,0.790123456790123,1,2,3
"lib/ruby/site_ruby/1.8/rubygems/gem_open_uri.rb",0,1,0,1,1
"lib/ruby/site_ruby/1.8/rubygems/gem_openssl.rb",0,0.530120481927711,0,2,2
"lib/ruby/site_ruby/1.8/rubygems/gem_path_searcher.rb",0,1,0,1,1
"lib/ruby/site_ruby/1.8/rubygems/gem_runner.rb",0,0.620689655172414,1,2,3
"lib/ruby/site_ruby/1.8/rubygems/indexer.rb",0,1,0,1,1
"lib/ruby/site_ruby/1.8/rubygems/indexer/abstract_index_builder.rb",0,1,0,1,1
"lib/ruby/site_ruby/1.8/rubygems/indexer/marshal_index_builder.rb",0,1,0,1,1
"lib/ruby/site_ruby/1.8/rubygems/indexer/master_index_builder.rb",0,1,0,1,1
"lib/ruby/site_ruby/1.8/rubygems/indexer/quick_index_builder.rb",0,1,0,1,1
"lib/ruby/site_ruby/1.8/rubygems/install_update_options.rb",0,1,0,1,1
"lib/ruby/site_ruby/1.8/rubygems/installer.rb",0,0.842436974789916,1,2,3
"lib/ruby/site_ruby/1.8/rubygems/local_remote_options.rb",0,1,0,1,1
"lib/ruby/site_ruby/1.8/rubygems/old_format.rb",0,0.966216216216216,1,1,2
"lib/ruby/site_ruby/1.8/rubygems/open-uri.rb",0,0.827943078913325,1,2,3
"lib/ruby/site_ruby/1.8/rubygems/package.rb",0,0.740305522914219,1,2,3
"lib/ruby/site_ruby/1.8/rubygems/platform.rb",0,1,0,1,1
"lib/ruby/site_ruby/1.8/rubygems/remote_fetcher.rb",0,0.964285714285714,1,1,2
"lib/ruby/site_ruby/1.8/rubygems/require_paths_builder.rb",0,1,0,1,1
"lib/ruby/site_ruby/1.8/rubygems/requirement.rb",0,1,0,1,1
"lib/ruby/site_ruby/1.8/rubygems/rubygems_version.rb",0,0.833333333333333,0,2,2
"lib/ruby/site_ruby/1.8/rubygems/security.rb",0,0.915923566878981,0,2,2
"lib/ruby/site_ruby/1.8/rubygems/server.rb",0,1,0,1,1
"lib/ruby/site_ruby/1.8/rubygems/source_index.rb",0,0.641083521444695,1,2,3
"lib/ruby/site_ruby/1.8/rubygems/source_info_cache.rb",0,0.862068965517241,0,2,2
"lib/ruby/site_ruby/1.8/rubygems/source_info_cache_entry.rb",0,0.869565217391304,0,2,2
"lib/ruby/site_ruby/1.8/rubygems/specification.rb",0,0.506172839506173,1,2,3
"lib/ruby/site_ruby/1.8/rubygems/timer.rb",0,1,0,1,1
"lib/ruby/site_ruby/1.8/rubygems/uninstaller.rb",0,1,0,1,1
"lib/ruby/site_ruby/1.8/rubygems/user_interaction.rb",0,0.800687285223368,0,2,2
"lib/ruby/site_ruby/1.8/rubygems/validator.rb",0,0.650537634408602,1,2,3
"lib/ruby/site_ruby/1.8/rubygems/version.rb",0,0.842424242424242,0,2,2
"lib/ruby/site_ruby/1.8/rubygems/version_option.rb",0,1,0,1,1
"lib/ruby/site_ruby/1.8/securerandom.rb",0,1,0,1,1
"lib/ruby/site_ruby/1.8/ubygems.rb",0,1,0,1,1
"samples/duby/arraylist.rb",0,1,0,1,1
"samples/duby/constructors.rb",0,1,0,1,1
"samples/duby/operators.rb",0,1,0,1,1
"samples/duby/statics.rb",0,1,0,1,1
"samples/duby/stringthing.rb",0,1,0,1,1
"samples/duby/superfib.rb",0,1,0,1,1
"samples/error.rb",0,0.6,0,4,4
"samples/java2.rb",0,0.888888888888889,0,2,2
"samples/javascript.rb",0,1,0,1,1
"samples/scripting.rb",0,1,0,1,1
"samples/swing2.rb",0,0.576923076923077,0,2,2
"samples/thread.rb",0,0.5,0,2,2
"samples/xslt.rb",0,1,0,1,1
"src/builtin/fcntl.rb",0,1,0,1,1
"src/builtin/jsignal.rb",0,0.483870967741935,1,2,3
"src/builtin/yaml.rb",0,0.702764976958525,1,2,3
"src/builtin/yaml/store.rb",0,1,0,1,1
"src/builtin/yaml/syck.rb",0,1,0,1,1
"src/jruby/commands.rb",0,1,0,1,1
"src/jruby/extract.rb",0,1,0,1,1
"src/jruby/path_helper.rb",0,1,0,1,1
"test/autoloaded.rb",0,1,0,1,1
"test/autoloaded2.rb",0,1,0,1,1
"test/autoloaded3.rb",0,1,0,1,1
"test/autoloaded4.rb",0,1,0,1,1
"test/autoloaded5.rb",0,1,0,1,1
"test/autoloaded6.rb",0,1,0,1,1
"test/bench/bench_assert.rb",0,1,0,1,1
"test/bench/bench_chmod.rb",0,1,0,1,1
"test/bench/bench_define_method_methods.rb",0,1,0,1,1
"test/bench/bench_each_line.rb",0,1,0,1,1
"test/bench/bench_each_line_from_file.rb",0,1,0,1,1
"test/bench/bench_enumerable.rb",0,1,0,1,1
"test/bench/bench_eval.rb",0,0.5,0,2,2
"test/bench/bench_exceptions_stack_depth.rb",0,1,0,1,1
"test/bench/bench_fib_iterative.rb",0,1,0,1,1
"test/bench/bench_fib_recursive.rb",0,1,0,1,1
"test/bench/bench_fib_stack_depth.rb",0,1,0,1,1
"test/bench/bench_float_math.rb",0,1,0,1,1
"test/bench/bench_fractal.rb",0,1,0,1,1
"test/bench/bench_full_startup.rb",0,1,0,1,1
"test/bench/bench_java_invocation.rb",0,1,0,1,1
"test/bench/bench_java_invocation_single.rb",0,1,0,1,1
"test/bench/bench_java_subclass_invocation.rb",0,1,0,1,1
"test/bench/bench_jruby_init.rb",0,1,0,1,1
"test/bench/bench_kind_of.rb",0,1,0,1,1
"test/bench/bench_method_missing.rb",0,1,0,1,1
"test/bench/bench_method_to_proc.rb",0,1,0,1,1
"test/bench/bench_nsieve.rb",0,1,0,1,1
"test/bench/bench_parser.rb",0,0.52,1,2,3
"test/bench/bench_proc_invocation.rb",0,1,0,1,1
"test/bench/bench_pythag.rb",0,1,0,1,1
"test/bench/bench_quicksort.rb",0,1,0,1,1
"test/bench/bench_rails_regexen.rb",0,1,0,1,1
"test/bench/bench_rake_install.rb",0,1,0,1,1
"test/bench/bench_regex.rb",0,1,0,1,1
"test/bench/bench_regex_caching.rb",0,1,0,1,1
"test/bench/bench_rescue.rb",0,1,0,1,1
"test/bench/bench_respond_to.rb",0,1,0,1,1
"test/bench/bench_rexml.rb",0,1,0,1,1
"test/bench/bench_send.rb",0,1,0,1,1
"test/bench/bench_stack_depth.rb",0,1,0,1,1
"test/bench/bench_stat.rb",0,1,0,1,1
"test/bench/bench_string_ops.rb",0,1,0,1,1
"test/bench/bench_string_pack.rb",0,1,0,1,1
"test/bench/bench_stringio_puts.rb",0,1,0,1,1
"test/bench/bench_stringio_write.rb",0,1,0,1,1
"test/bench/bench_strptime.rb",0,0.7,0,2,2
"test/bench/bench_struct.rb",0,1,0,1,1
"test/bench/bench_symbol_to_proc.rb",0,1,0,1,1
"test/bench/bench_wide_finder.rb",0,1,0,1,1
"test/bench/compiler/bench_fib_iterative.rb",0,1,0,1,1
"test/bench/compiler/bench_fib_recursive.rb",0,1,0,1,1
"test/bench/compiler/bench_method_dispatch.rb",0,1,0,1,1
"test/bench/language/bench_alias.rb",0,1,0,1,1
"test/bench/language/bench_all.rb",0,1,0,1,1
"test/bench/language/bench_and.rb",0,1,0,1,1
"test/bench/language/bench_args_cat.rb",0,1,0,1,1
"test/bench/language/bench_args_push.rb",0,1,0,1,1
"test/bench/language/bench_array.rb",0,1,0,1,1
"test/bench/language/bench_attr_assign.rb",0,1,0,1,1
"test/bench/language/bench_backref.rb",0,1,0,1,1
"test/bench/language/bench_begin.rb",0,1,0,1,1
"test/bench/language/bench_bignum.rb",0,1,0,1,1
"test/bench/language/bench_break.rb",0,1,0,1,1
"test/bench/language/bench_case.rb",0,1,0,1,1
"test/bench/language/bench_class_definition.rb",0,1,0,1,1
"test/bench/language/bench_classvars.rb",0,1,0,1,1
"test/bench/language/bench_colon.rb",0,1,0,1,1
"test/bench/language/bench_const_lookup.rb",0,1,0,1,1
"test/bench/language/bench_def_method.rb",0,1,0,1,1
"test/bench/language/bench_defined.rb",0,0.989296636085627,1,1,2
"test/bench/language/bench_dregexp.rb",0,1,0,1,1
"test/bench/language/bench_dstr.rb",0,1,0,1,1
"test/bench/language/bench_dsymbol.rb",0,1,0,1,1
"test/bench/language/bench_false.rb",0,1,0,1,1
"test/bench/language/bench_fixnum.rb",0,1,0,1,1
"test/bench/language/bench_flip.rb",0,1,0,1,1
"test/bench/language/bench_float.rb",0,1,0,1,1
"test/bench/language/bench_for_loop.rb",0,1,0,1,1
"test/bench/language/bench_globals.rb",0,1,0,1,1
"test/bench/language/bench_ivar_access.rb",0,1,0,1,1
"test/bench/language/bench_literal_hash.rb",0,1,0,1,1
"test/bench/language/bench_local_vars.rb",0,1,0,1,1
"test/bench/language/bench_method_dispatch.rb",0,1,0,1,1
"test/bench/language/bench_method_dispatch_only.rb",0,0.966666666666667,1,1,2
"test/bench/language/bench_method_return.rb",0,1,0,1,1
"test/bench/language/bench_op_asgn_or.rb",0,0.707317073170732,0,2,2
"test/bench/language/bench_op_assign.rb",0,1,0,1,1
"test/bench/language/bench_op_element_asgn.rb",0,1,0,1,1
"test/bench/language/bench_range_literal.rb",0,1,0,1,1
"test/bench/language/bench_symbol.rb",0,0.875,0,2,2
"test/bench/language/bench_true.rb",0,1,0,1,1
"test/bench/language/bench_yield.rb",0,1,0,1,1
"test/bench/yarv/bm_app_answer.rb",0,1,0,1,1
"test/bench/yarv/bm_app_erb.rb",0,1,0,1,1
"test/bench/yarv/bm_app_factorial.rb",0,1,0,1,1
"test/bench/yarv/bm_app_fib.rb",0,1,0,1,1
"test/bench/yarv/bm_app_mandelbrot.rb",0,1,0,1,1
"test/bench/yarv/bm_app_pentomino.rb",0,1,0,1,1
"test/bench/yarv/bm_app_raise.rb",0,1,0,1,1
"test/bench/yarv/bm_app_strconcat.rb",0,1,0,1,1
"test/bench/yarv/bm_app_tak.rb",0,1,0,1,1
"test/bench/yarv/bm_app_tarai.rb",0,1,0,1,1
"test/bench/yarv/bm_app_uri.rb",0,1,0,1,1
"test/bench/yarv/bm_io_file_create.rb",0,1,0,1,1
"test/bench/yarv/bm_io_file_read.rb",0,1,0,1,1
"test/bench/yarv/bm_io_file_write.rb",0,1,0,1,1
"test/bench/yarv/bm_loop_generator.rb",0,1,0,1,1
"test/bench/yarv/bm_loop_times.rb",0,1,0,1,1
"test/bench/yarv/bm_loop_whileloop.rb",0,1,0,1,1
"test/bench/yarv/bm_loop_whileloop2.rb",0,1,0,1,1
"test/bench/yarv/bm_so_ackermann.rb",0,1,0,1,1
"test/bench/yarv/bm_so_array.rb",0,1,0,1,1
"test/bench/yarv/bm_so_binary_trees.rb",0,1,0,1,1
"test/bench/yarv/bm_so_concatenate.rb",0,1,0,1,1
"test/bench/yarv/bm_so_count_words.rb",0,1,0,1,1
"test/bench/yarv/bm_so_exception.rb",0,1,0,1,1
"test/bench/yarv/bm_so_fannkuch.rb",0,1,0,1,1
"test/bench/yarv/bm_so_fasta.rb",0,1,0,1,1
"test/bench/yarv/bm_so_k_nucleotide.rb",0,1,0,1,1
"test/bench/yarv/bm_so_lists.rb",0,1,0,1,1
"test/bench/yarv/bm_so_mandelbrot.rb",0,1,0,1,1
"test/bench/yarv/bm_so_matrix.rb",0,1,0,1,1
"test/bench/yarv/bm_so_meteor_contest.rb",0,1,0,1,1
"test/bench/yarv/bm_so_nbody.rb",0,1,0,1,1
"test/bench/yarv/bm_so_nested_loop.rb",0,1,0,1,1
"test/bench/yarv/bm_so_nsieve.rb",0,1,0,1,1
"test/bench/yarv/bm_so_nsieve_bits.rb",0,1,0,1,1
"test/bench/yarv/bm_so_object.rb",0,1,0,1,1
"test/bench/yarv/bm_so_partial_sums.rb",0,1,0,1,1
"test/bench/yarv/bm_so_pidigits.rb",0,1,0,1,1
"test/bench/yarv/bm_so_random.rb",0,1,0,1,1
"test/bench/yarv/bm_so_reverse_complement.rb",0,1,0,1,1
"test/bench/yarv/bm_so_sieve.rb",0,1,0,1,1
"test/bench/yarv/bm_so_spectralnorm.rb",0,1,0,1,1
"test/bench/yarv/bm_vm1_block.rb",0,1,0,1,1
"test/bench/yarv/bm_vm1_const.rb",0,1,0,1,1
"test/bench/yarv/bm_vm1_ensure.rb",0,1,0,1,1
"test/bench/yarv/bm_vm1_ivar.rb",0,1,0,1,1
"test/bench/yarv/bm_vm1_ivar_set.rb",0,1,0,1,1
"test/bench/yarv/bm_vm1_length.rb",0,1,0,1,1
"test/bench/yarv/bm_vm1_rescue.rb",0,1,0,1,1
"test/bench/yarv/bm_vm1_simplereturn.rb",0,1,0,1,1
"test/bench/yarv/bm_vm1_swap.rb",0,1,0,1,1
"test/bench/yarv/bm_vm2_array.rb",0,1,0,1,1
"test/bench/yarv/bm_vm2_case.rb",0,1,0,1,1
"test/bench/yarv/bm_vm2_eval.rb",0,1,0,1,1
"test/bench/yarv/bm_vm2_method.rb",0,1,0,1,1
"test/bench/yarv/bm_vm2_mutex.rb",0,1,0,1,1
"test/bench/yarv/bm_vm2_poly_method.rb",0,1,0,1,1
"test/bench/yarv/bm_vm2_poly_method_ov.rb",0,1,0,1,1
"test/bench/yarv/bm_vm2_proc.rb",0,1,0,1,1
"test/bench/yarv/bm_vm2_regexp.rb",0,1,0,1,1
"test/bench/yarv/bm_vm2_send.rb",0,1,0,1,1
"test/bench/yarv/bm_vm2_super.rb",0,1,0,1,1
"test/bench/yarv/bm_vm2_unif1.rb",0,1,0,1,1
"test/bench/yarv/bm_vm2_zsuper.rb",0,1,0,1,1
"test/bench/yarv/bm_vm3_thread_create_join.rb",0,1,0,1,1
"test/bench/yarv/bm_vm3_thread_mutex.rb",0,1,0,1,1
"test/bench/yarv/driver.rb",0,1,0,1,1
"test/bench/yarv/make_fasta_output.rb",0,1,0,1,1
"test/bench/yarv/prepare_so_count_words.rb",0,1,0,1,1
"test/bench/yarv/prepare_so_k_nucleotide.rb",0,1,0,1,1
"test/bench/yarv/prepare_so_reverse_complement.rb",0,1,0,1,1
"test/bench/yarv/report.rb",0,1,0,1,1
"test/bench/yarv/run.rb",0,1,0,1,1
"test/bench/yarv/runc.rb",0,1,0,1,1
"test/compiler/duby/test_ast.rb",0,1,0,1,1
"test/compiler/duby/test_call_node.rb",0,1,0,1,1
"test/compiler/duby/test_compiler.rb",0,1,0,1,1
"test/compiler/duby/test_hash_node.rb",0,1,0,1,1
"test/compiler/test_builder.rb",0,1,0,1,1
"test/compiler/test_bytecode.rb",0,1,0,1,1
"test/compiler/test_jrubyc.rb",0,1,0,1,1
"test/compiler/test_signature.rb",0,1,0,1,1
"test/externals/bfts/rubicon_testcase.rb",0,1,0,1,1
"test/externals/bfts/test_array.rb",0,0.996830427892235,1,1,2
"test/externals/bfts/test_comparable.rb",0,1,0,1,1
"test/externals/bfts/test_exception.rb",0,1,0,1,1
"test/externals/bfts/test_false_class.rb",0,1,0,1,1
"test/externals/bfts/test_file_test.rb",0,1,0,1,1
"test/externals/bfts/test_hash.rb",0,1,0,1,1
"test/externals/bfts/test_nil_class.rb",0,1,0,1,1
"test/externals/bfts/test_range.rb",0,1,0,1,1
"test/externals/bfts/test_string.rb",0,0.999442275515895,1,1,2
"test/externals/bfts/test_struct.rb",0,1,0,1,1
"test/externals/bfts/test_time.rb",0,0.994293865905849,2,1,3
"test/externals/bfts/test_true_class.rb",0,1,0,1,1
"test/externals/miniunit/test/unit.rb",0,1,0,1,1
"test/externals/miniunit/test/unit/testcase.rb",0,1,0,1,1
"test/externals/mri/csv/test_csv.rb",0,1,0,1,1
"test/externals/mri/dbm/test_dbm.rb",0,1,0,1,1
"test/externals/mri/digest/test_digest.rb",0,1,0,1,1
"test/externals/mri/drb/drbtest.rb",0,1,0,1,1
"test/externals/mri/drb/ignore_test_drb.rb",0,1,0,1,1
"test/externals/mri/drb/test_acl.rb",0,1,0,1,1
"test/externals/mri/drb/test_drb.rb",0,1,0,1,1
"test/externals/mri/drb/test_drbssl.rb",0,1,0,1,1
"test/externals/mri/drb/test_drbunix.rb",0,1,0,1,1
"test/externals/mri/drb/ut_array.rb",0,1,0,1,1
"test/externals/mri/drb/ut_array_drbssl.rb",0,1,0,1,1
"test/externals/mri/drb/ut_array_drbunix.rb",0,1,0,1,1
"test/externals/mri/drb/ut_drb.rb",0,1,0,1,1
"test/externals/mri/drb/ut_drb_drbssl.rb",0,1,0,1,1
"test/externals/mri/drb/ut_drb_drbunix.rb",0,1,0,1,1
"test/externals/mri/drb/ut_eval.rb",0,1,0,1,1
"test/externals/mri/drb/ut_large.rb",0,1,0,1,1
"test/externals/mri/drb/ut_port.rb",0,1,0,1,1
"test/externals/mri/drb/ut_safe1.rb",0,1,0,1,1
"test/externals/mri/drb/ut_timerholder.rb",0,1,0,1,1
"test/externals/mri/erb/test_erb.rb",0,1,0,1,1
"test/externals/mri/fileutils/fileasserts.rb",0,1,0,1,1
"test/externals/mri/fileutils/test_dryrun.rb",0,1,0,1,1
"test/externals/mri/fileutils/test_fileutils.rb",0,1,0,1,1
"test/externals/mri/fileutils/test_nowrite.rb",0,1,0,1,1
"test/externals/mri/fileutils/test_verbose.rb",0,1,0,1,1
"test/externals/mri/gdbm/test_gdbm.rb",0,1,0,1,1
"test/externals/mri/io/nonblock/test_flush.rb",0,1,0,1,1
"test/externals/mri/logger/test_logger.rb",0,1,0,1,1
"test/externals/mri/monitor/test_monitor.rb",0,1,0,1,1
"test/externals/mri/net/http/test_httpheader.rb",0,1,0,1,1
"test/externals/mri/net/http/test_https_proxy.rb",0,1,0,1,1
"test/externals/mri/nkf/test_kconv.rb",0,1,0,1,1
"test/externals/mri/nkf/test_nkf.rb",0,1,0,1,1
"test/externals/mri/openssl/ssl_server.rb",0,1,0,1,1
"test/externals/mri/openssl/test_asn1.rb",0,1,0,1,1
"test/externals/mri/openssl/test_cipher.rb",0,1,0,1,1
"test/externals/mri/openssl/test_digest.rb",0,1,0,1,1
"test/externals/mri/openssl/test_hmac.rb",0,1,0,1,1
"test/externals/mri/openssl/test_ns_spki.rb",0,1,0,1,1
"test/externals/mri/openssl/test_pair.rb",0,1,0,1,1
"test/externals/mri/openssl/test_pkcs7.rb",0,1,0,1,1
"test/externals/mri/openssl/test_pkey_rsa.rb",0,1,0,1,1
"test/externals/mri/openssl/test_ssl.rb",0,1,0,1,1
"test/externals/mri/openssl/test_x509cert.rb",0,1,0,1,1
"test/externals/mri/openssl/test_x509crl.rb",0,1,0,1,1
"test/externals/mri/openssl/test_x509ext.rb",0,1,0,1,1
"test/externals/mri/openssl/test_x509name.rb",0,1,0,1,1
"test/externals/mri/openssl/test_x509req.rb",0,1,0,1,1
"test/externals/mri/openssl/test_x509store.rb",0,1,0,1,1
"test/externals/mri/openssl/utils.rb",0,1,0,1,1
"test/externals/mri/optparse/test_noarg.rb",0,1,0,1,1
"test/externals/mri/optparse/test_optarg.rb",0,1,0,1,1
"test/externals/mri/optparse/test_optparse.rb",0,1,0,1,1
"test/externals/mri/optparse/test_placearg.rb",0,1,0,1,1
"test/externals/mri/optparse/test_reqarg.rb",0,1,0,1,1
"test/externals/mri/ostruct/test_ostruct.rb",0,1,0,1,1
"test/externals/mri/pathname/test_pathname.rb",0,1,0,1,1
"test/externals/mri/readline/test_readline.rb",0,1,0,1,1
"test/externals/mri/rinda/test_rinda.rb",0,1,0,1,1
"test/externals/mri/rss/rss-assertions.rb",0,1,0,1,1
"test/externals/mri/rss/rss-testcase.rb",0,1,0,1,1
"test/externals/mri/rss/test_1.0.rb",0,1,0,1,1
"test/externals/mri/rss/test_2.0.rb",0,1,0,1,1
"test/externals/mri/rss/test_accessor.rb",0,1,0,1,1
"test/externals/mri/rss/test_content.rb",0,1,0,1,1
"test/externals/mri/rss/test_dublincore.rb",0,1,0,1,1
"test/externals/mri/rss/test_image.rb",0,1,0,1,1
"test/externals/mri/rss/test_inherit.rb",0,1,0,1,1
"test/externals/mri/rss/test_maker_0.9.rb",0,1,0,1,1
"test/externals/mri/rss/test_maker_1.0.rb",0,1,0,1,1
"test/externals/mri/rss/test_maker_2.0.rb",0,1,0,1,1
"test/externals/mri/rss/test_maker_content.rb",0,1,0,1,1
"test/externals/mri/rss/test_maker_dc.rb",0,1,0,1,1
"test/externals/mri/rss/test_maker_image.rb",0,1,0,1,1
"test/externals/mri/rss/test_maker_sy.rb",0,1,0,1,1
"test/externals/mri/rss/test_maker_taxo.rb",0,1,0,1,1
"test/externals/mri/rss/test_maker_trackback.rb",0,1,0,1,1
"test/externals/mri/rss/test_maker_xml-stylesheet.rb",0,1,0,1,1
"test/externals/mri/rss/test_parser.rb",0,1,0,1,1
"test/externals/mri/rss/test_parser_1.0.rb",0,1,0,1,1
"test/externals/mri/rss/test_parser_2.0.rb",0,1,0,1,1
"test/externals/mri/rss/test_setup_maker_0.9.rb",0,1,0,1,1
"test/externals/mri/rss/test_setup_maker_1.0.rb",0,1,0,1,1
"test/externals/mri/rss/test_setup_maker_2.0.rb",0,1,0,1,1
"test/externals/mri/rss/test_syndication.rb",0,1,0,1,1
"test/externals/mri/rss/test_taxonomy.rb",0,1,0,1,1
"test/externals/mri/rss/test_to_s.rb",0,1,0,1,1
"test/externals/mri/rss/test_trackback.rb",0,1,0,1,1
"test/externals/mri/rss/test_version.rb",0,1,0,1,1
"test/externals/mri/rss/test_xml-stylesheet.rb",0,1,0,1,1
"test/externals/mri/ruby/beginmainend.rb",0,1,0,1,1
"test/externals/mri/ruby/endblockwarn.rb",0,1,0,1,1
"test/externals/mri/ruby/envutil.rb",0,0.928571428571429,0,2,2
"test/externals/mri/ruby/marshaltestlib.rb",0,1,0,1,1
"test/externals/mri/ruby/test_alias.rb",0,1,0,1,1
"test/externals/mri/ruby/test_array.rb",0,1,0,1,1
"test/externals/mri/ruby/test_assignment.rb",0,1,0,1,1
"test/externals/mri/ruby/test_beginendblock.rb",0,1,0,1,1
"test/externals/mri/ruby/test_bignum.rb",0,1,0,1,1
"test/externals/mri/ruby/test_call.rb",0,1,0,1,1
"test/externals/mri/ruby/test_case.rb",0,1,0,1,1
"test/externals/mri/ruby/test_clone.rb",0,1,0,1,1
"test/externals/mri/ruby/test_condition.rb",0,1,0,1,1
"test/externals/mri/ruby/test_const.rb",0,1,0,1,1
"test/externals/mri/ruby/test_defined.rb",0,1,0,1,1
"test/externals/mri/ruby/test_dir.rb",0,1,0,1,1
"test/externals/mri/ruby/test_env.rb",0,1,0,1,1
"test/externals/mri/ruby/test_eval.rb",0,1,0,1,1
"test/externals/mri/ruby/test_exception.rb",0,1,0,1,1
"test/externals/mri/ruby/test_fiber.rb",0,1,0,1,1
"test/externals/mri/ruby/test_file.rb",0,1,0,1,1
"test/externals/mri/ruby/test_float.rb",0,1,0,1,1
"test/externals/mri/ruby/test_gc.rb",0,1,0,1,1
"test/externals/mri/ruby/test_hash.rb",0,1,0,1,1
"test/externals/mri/ruby/test_ifunless.rb",0,1,0,1,1
"test/externals/mri/ruby/test_io.rb",0,1,0,1,1
"test/externals/mri/ruby/test_iterator.rb",0,0.968017057569296,1,1,2
"test/externals/mri/ruby/test_marshal.rb",0,1,0,1,1
"test/externals/mri/ruby/test_math.rb",0,1,0,1,1
"test/externals/mri/ruby/test_method.rb",0,1,0,1,1
"test/externals/mri/ruby/test_objectspace.rb",0,1,0,1,1
"test/externals/mri/ruby/test_pack.rb",0,1,0,1,1
"test/externals/mri/ruby/test_path.rb",0,1,0,1,1
"test/externals/mri/ruby/test_pipe.rb",0,1,0,1,1
"test/externals/mri/ruby/test_proc.rb",0,1,0,1,1
"test/externals/mri/ruby/test_process.rb",0,1,0,1,1
"test/externals/mri/ruby/test_rand.rb",0,1,0,1,1
"test/externals/mri/ruby/test_range.rb",0,1,0,1,1
"test/externals/mri/ruby/test_readpartial.rb",0,1,0,1,1
"test/externals/mri/ruby/test_settracefunc.rb",0,1,0,1,1
"test/externals/mri/ruby/test_signal.rb",0,1,0,1,1
"test/externals/mri/ruby/test_string.rb",0,1,0,1,1
"test/externals/mri/ruby/test_stringchar.rb",0,1,0,1,1
"test/externals/mri/ruby/test_struct.rb",0,1,0,1,1
"test/externals/mri/ruby/test_super.rb",0,1,0,1,1
"test/externals/mri/ruby/test_symbol.rb",0,1,0,1,1
"test/externals/mri/ruby/test_system.rb",0,1,0,1,1
"test/externals/mri/ruby/test_time.rb",0,1,0,1,1
"test/externals/mri/ruby/test_trace.rb",0,1,0,1,1
"test/externals/mri/ruby/test_variable.rb",0,1,0,1,1
"test/externals/mri/ruby/test_whileuntil.rb",0,1,0,1,1
"test/externals/mri/ruby/ut_eof.rb",0,1,0,1,1
"test/externals/mri/runner.rb",0,1,0,1,1
"test/externals/mri/sdbm/test_sdbm.rb",0,1,0,1,1
"test/externals/mri/soap/asp.net/test_aspdotnet.rb",0,1,0,1,1
"test/externals/mri/soap/calc/calc.rb",0,1,0,1,1
"test/externals/mri/soap/calc/calc2.rb",0,1,0,1,1
"test/externals/mri/soap/calc/server.rb",0,1,0,1,1
"test/externals/mri/soap/calc/server2.rb",0,1,0,1,1
"test/externals/mri/soap/calc/test_calc.rb",0,1,0,1,1
"test/externals/mri/soap/calc/test_calc2.rb",0,1,0,1,1
"test/externals/mri/soap/calc/test_calc_cgi.rb",0,1,0,1,1
"test/externals/mri/soap/fault/test_customfault.rb",0,1,0,1,1
"test/externals/mri/soap/header/test_authheader.rb",0,1,0,1,1
"test/externals/mri/soap/header/test_authheader_cgi.rb",0,1,0,1,1
"test/externals/mri/soap/header/test_simplehandler.rb",0,1,0,1,1
"test/externals/mri/soap/helloworld/hw_s.rb",0,1,0,1,1
"test/externals/mri/soap/helloworld/test_helloworld.rb",0,1,0,1,1
"test/externals/mri/soap/marshal/test_digraph.rb",0,1,0,1,1
"test/externals/mri/soap/marshal/test_marshal.rb",0,1,0,1,1
"test/externals/mri/soap/marshal/test_struct.rb",0,1,0,1,1
"test/externals/mri/soap/ssl/sslsvr.rb",0,1,0,1,1
"test/externals/mri/soap/ssl/test_ssl.rb",0,1,0,1,1
"test/externals/mri/soap/struct/test_struct.rb",0,1,0,1,1
"test/externals/mri/soap/swa/test_file.rb",0,1,0,1,1
"test/externals/mri/soap/test_basetype.rb",0,1,0,1,1
"test/externals/mri/soap/test_envelopenamespace.rb",0,1,0,1,1
"test/externals/mri/soap/test_httpconfigloader.rb",0,1,0,1,1
"test/externals/mri/soap/test_mapping.rb",0,1,0,1,1
"test/externals/mri/soap/test_no_indent.rb",0,1,0,1,1
"test/externals/mri/soap/test_property.rb",0,1,0,1,1
"test/externals/mri/soap/test_soapelement.rb",0,1,0,1,1
"test/externals/mri/soap/test_streamhandler.rb",0,1,0,1,1
"test/externals/mri/soap/test_styleuse.rb",0,1,0,1,1
"test/externals/mri/soap/wsdlDriver/echo_version.rb",0,1,0,1,1
"test/externals/mri/soap/wsdlDriver/test_calc.rb",0,1,0,1,1
"test/externals/mri/soap/wsdlDriver/test_document.rb",0,1,0,1,1
"test/externals/mri/soap/wsdlDriver/test_simpletype.rb",0,1,0,1,1
"test/externals/mri/socket/test_nonblock.rb",0,1,0,1,1
"test/externals/mri/socket/test_socket.rb",0,1,0,1,1
"test/externals/mri/socket/test_unix.rb",0,1,0,1,1
"test/externals/mri/stringio/test_stringio.rb",0,1,0,1,1
"test/externals/mri/strscan/test_stringscanner.rb",0,1,0,1,1
"test/externals/mri/testunit/collector/test_dir.rb",0,1,0,1,1
"test/externals/mri/testunit/collector/test_objectspace.rb",0,1,0,1,1
"test/externals/mri/testunit/runit/test_assert.rb",0,1,0,1,1
"test/externals/mri/testunit/runit/test_testcase.rb",0,1,0,1,1
"test/externals/mri/testunit/runit/test_testresult.rb",0,1,0,1,1
"test/externals/mri/testunit/runit/test_testsuite.rb",0,1,0,1,1
"test/externals/mri/testunit/test_assertions.rb",0,1,0,1,1
"test/externals/mri/testunit/test_error.rb",0,1,0,1,1
"test/externals/mri/testunit/test_failure.rb",0,1,0,1,1
"test/externals/mri/testunit/test_testcase.rb",0,1,0,1,1
"test/externals/mri/testunit/test_testresult.rb",0,1,0,1,1
"test/externals/mri/testunit/test_testsuite.rb",0,1,0,1,1
"test/externals/mri/testunit/util/collector/test_dir.rb",0,1,0,1,1
"test/externals/mri/testunit/util/collector/test_objectspace.rb",0,1,0,1,1
"test/externals/mri/testunit/util/runit/test_assert.rb",0,1,0,1,1
"test/externals/mri/testunit/util/runit/test_testcase.rb",0,1,0,1,1
"test/externals/mri/testunit/util/runit/test_testresult.rb",0,1,0,1,1
"test/externals/mri/testunit/util/runit/test_testsuite.rb",0,1,0,1,1
"test/externals/mri/testunit/util/test_assertions.rb",0,1,0,1,1
"test/externals/mri/testunit/util/test_backtracefilter.rb",0,1,0,1,1
"test/externals/mri/testunit/util/test_error.rb",0,1,0,1,1
"test/externals/mri/testunit/util/test_failure.rb",0,1,0,1,1
"test/externals/mri/testunit/util/test_observable.rb",0,1,0,1,1
"test/externals/mri/testunit/util/test_procwrapper.rb",0,1,0,1,1
"test/externals/mri/testunit/util/test_testcase.rb",0,1,0,1,1
"test/externals/mri/testunit/util/test_testresult.rb",0,1,0,1,1
"test/externals/mri/testunit/util/test_testsuite.rb",0,1,0,1,1
"test/externals/mri/uri/test_common.rb",0,1,0,1,1
"test/externals/mri/uri/test_ftp.rb",0,1,0,1,1
"test/externals/mri/uri/test_generic.rb",0,1,0,1,1
"test/externals/mri/uri/test_http.rb",0,1,0,1,1
"test/externals/mri/uri/test_ldap.rb",0,1,0,1,1
"test/externals/mri/uri/test_mailto.rb",0,1,0,1,1
"test/externals/mri/webrick/test_cgi.rb",0,1,0,1,1
"test/externals/mri/webrick/test_cookie.rb",0,1,0,1,1
"test/externals/mri/webrick/test_filehandler.rb",0,1,0,1,1
"test/externals/mri/webrick/test_httpauth.rb",0,1,0,1,1
"test/externals/mri/webrick/test_httprequest.rb",0,1,0,1,1
"test/externals/mri/webrick/test_httpserver.rb",0,1,0,1,1
"test/externals/mri/webrick/test_httputils.rb",0,1,0,1,1
"test/externals/mri/webrick/test_httpversion.rb",0,1,0,1,1
"test/externals/mri/webrick/test_server.rb",0,1,0,1,1
"test/externals/mri/webrick/utils.rb",0,1,0,1,1
"test/externals/mri/wsdl/any/expectedDriver.rb",0,1,0,1,1
"test/externals/mri/wsdl/any/expectedEcho.rb",0,1,0,1,1
"test/externals/mri/wsdl/any/expectedService.rb",0,1,0,1,1
"test/externals/mri/wsdl/any/test_any.rb",0,1,0,1,1
"test/externals/mri/wsdl/axisArray/itemList.rb",0,1,0,1,1
"test/externals/mri/wsdl/axisArray/test_axisarray.rb",0,1,0,1,1
"test/externals/mri/wsdl/datetime/DatetimeService.rb",0,1,0,1,1
"test/externals/mri/wsdl/datetime/datetimeServant.rb",0,1,0,1,1
"test/externals/mri/wsdl/datetime/test_datetime.rb",0,1,0,1,1
"test/externals/mri/wsdl/document/echo.rb",0,1,0,1,1
"test/externals/mri/wsdl/document/test_nosoapaction.rb",0,1,0,1,1
"test/externals/mri/wsdl/document/test_number.rb",0,1,0,1,1
"test/externals/mri/wsdl/document/test_rpc.rb",0,1,0,1,1
"test/externals/mri/wsdl/map/test_map.rb",0,1,0,1,1
"test/externals/mri/wsdl/marshal/person_org.rb",0,1,0,1,1
"test/externals/mri/wsdl/marshal/test_wsdlmarshal.rb",0,1,0,1,1
"test/externals/mri/wsdl/qualified/test_qualified.rb",0,1,0,1,1
"test/externals/mri/wsdl/qualified/test_unqualified.rb",0,1,0,1,1
"test/externals/mri/wsdl/raa/RAA.rb",0,1,0,1,1
"test/externals/mri/wsdl/raa/RAAServant.rb",0,1,0,1,1
"test/externals/mri/wsdl/raa/RAAService.rb",0,1,0,1,1
"test/externals/mri/wsdl/raa/server.rb",0,1,0,1,1
"test/externals/mri/wsdl/raa/test_raa.rb",0,1,0,1,1
"test/externals/mri/wsdl/ref/expectedProduct.rb",0,1,0,1,1
"test/externals/mri/wsdl/ref/test_ref.rb",0,1,0,1,1
"test/externals/mri/wsdl/rpc/echoDriver.rb",0,1,0,1,1
"test/externals/mri/wsdl/rpc/echo_serviceClient.rb",0,1,0,1,1
"test/externals/mri/wsdl/rpc/test_rpc.rb",0,1,0,1,1
"test/externals/mri/wsdl/rpc/test_rpc_lit.rb",0,1,0,1,1
"test/externals/mri/wsdl/simpletype/rpc/expectedClient.rb",0,1,0,1,1
"test/externals/mri/wsdl/simpletype/rpc/expectedDriver.rb",0,1,0,1,1
"test/externals/mri/wsdl/simpletype/rpc/expectedEchoVersion.rb",0,1,0,1,1
"test/externals/mri/wsdl/simpletype/rpc/expectedServant.rb",0,1,0,1,1
"test/externals/mri/wsdl/simpletype/rpc/expectedService.rb",0,1,0,1,1
"test/externals/mri/wsdl/simpletype/rpc/test_rpc.rb",0,1,0,1,1
"test/externals/mri/wsdl/simpletype/test_simpletype.rb",0,1,0,1,1
"test/externals/mri/wsdl/soap/test_soapbodyparts.rb",0,1,0,1,1
"test/externals/mri/wsdl/test_emptycomplextype.rb",0,1,0,1,1
"test/externals/mri/wsdl/test_fault.rb",0,1,0,1,1
"test/externals/mri/wsdl/test_multiplefault.rb",0,1,0,1,1
"test/externals/mri/xmlrpc/test_datetime.rb",0,1,0,1,1
"test/externals/mri/xmlrpc/test_features.rb",0,1,0,1,1
"test/externals/mri/xmlrpc/test_marshal.rb",0,1,0,1,1
"test/externals/mri/xmlrpc/test_parser.rb",0,1,0,1,1
"test/externals/mri/xmlrpc/test_webrick_server.rb",0,1,0,1,1
"test/externals/mri/xmlrpc/webrick_testing.rb",0,1,0,1,1
"test/externals/mri/xsd/codegen/test_classdef.rb",0,1,0,1,1
"test/externals/mri/xsd/test_noencoding.rb",0,1,0,1,1
"test/externals/mri/xsd/test_xmlschemaparser.rb",0,1,0,1,1
"test/externals/mri/xsd/test_xsd.rb",0,1,0,1,1
"test/externals/mri/yaml/test_yaml.rb",0,1,0,1,1
"test/externals/mri/zlib/test_zlib.rb",0,1,0,1,1
"test/externals/ruby_test/bench/core/Array/bench_aref.rb",0,1,0,1,1
"test/externals/ruby_test/bench/core/Array/bench_insert.rb",0,1,0,1,1
"test/externals/ruby_test/bench/core/bench_array.rb",0,0.995359628770302,1,1,2
"test/externals/ruby_test/bench/core/bench_hash.rb",0,0.995495495495496,1,1,2
"test/externals/ruby_test/bench/core/bench_integer.rb",0,0.983333333333333,1,1,2
"test/externals/ruby_test/bench/core/bench_math.rb",0,1,0,1,1
"test/externals/ruby_test/bench/core/bench_string.rb",0,0.996491228070175,1,1,2
"test/externals/ruby_test/bench/misc/adaptive_benchmark.rb",0,1,0,1,1
"test/externals/ruby_test/bench/misc/bench_shootout.rb",0,1,0,1,1
"test/externals/ruby_test/bench/misc/shootout.rb",0,1,0,1,1
"test/externals/ruby_test/bench/stdlib/bench_pathname.rb",0,1,0,1,1
"test/externals/ruby_test/bench/stdlib/bench_rational.rb",0,1,0,1,1
"test/externals/ruby_test/lib/test/helper.rb",0,1,0,1,1
"test/externals/ruby_test/test/core/Array/class/tc_aset.rb",0,1,0,1,1
"test/externals/ruby_test/test/core/Array/class/tc_new.rb",0,1,0,1,1
"test/externals/ruby_test/test/core/Array/instance/tc_append.rb",0,1,0,1,1
"test/externals/ruby_test/test/core/Array/instance/tc_aref.rb",0,1,0,1,1
"test/externals/ruby_test/test/core/Array/instance/tc_aset.rb",0,1,0,1,1
"test/externals/ruby_test/test/core/Array/instance/tc_assoc.rb",0,1,0,1,1
"test/externals/ruby_test/test/core/Array/instance/tc_at.rb",0,1,0,1,1
"test/externals/ruby_test/test/core/Array/instance/tc_clear.rb",0,1,0,1,1
"test/externals/ruby_test/test/core/Array/instance/tc_collect.rb",0,1,0,1,1
"test/externals/ruby_test/test/core/Array/instance/tc_compact.rb",0,1,0,1,1
"test/externals/ruby_test/test/core/Array/instance/tc_comparison.rb",0,1,0,1,1
"test/externals/ruby_test/test/core/Array/instance/tc_concat.rb",0,1,0,1,1
"test/externals/ruby_test/test/core/Array/instance/tc_concatenation.rb",0,1,0,1,1
"test/externals/ruby_test/test/core/Array/instance/tc_delete.rb",0,1,0,1,1
"test/externals/ruby_test/test/core/Array/instance/tc_delete_at.rb",0,1,0,1,1
"test/externals/ruby_test/test/core/Array/instance/tc_delete_if.rb",0,1,0,1,1
"test/externals/ruby_test/test/core/Array/instance/tc_difference.rb",0,1,0,1,1
"test/externals/ruby_test/test/core/Array/instance/tc_each.rb",0,1,0,1,1
"test/externals/ruby_test/test/core/Array/instance/tc_each_index.rb",0,1,0,1,1
"test/externals/ruby_test/test/core/Array/instance/tc_empty.rb",0,1,0,1,1
"test/externals/ruby_test/test/core/Array/instance/tc_eql.rb",0,1,0,1,1
"test/externals/ruby_test/test/core/Array/instance/tc_equality.rb",0,1,0,1,1
"test/externals/ruby_test/test/core/Array/instance/tc_fetch.rb",0,1,0,1,1
"test/externals/ruby_test/test/core/Array/instance/tc_fill.rb",0,1,0,1,1
"test/externals/ruby_test/test/core/Array/instance/tc_first.rb",0,1,0,1,1
"test/externals/ruby_test/test/core/Array/instance/tc_flatten.rb",0,1,0,1,1
"test/externals/ruby_test/test/core/Array/instance/tc_include.rb",0,1,0,1,1
"test/externals/ruby_test/test/core/Array/instance/tc_index.rb",0,1,0,1,1
"test/externals/ruby_test/test/core/Array/instance/tc_insert.rb",0,1,0,1,1
"test/externals/ruby_test/test/core/Array/instance/tc_intersection.rb",0,1,0,1,1
"test/externals/ruby_test/test/core/Array/instance/tc_join.rb",0,1,0,1,1
"test/externals/ruby_test/test/core/Array/instance/tc_last.rb",0,1,0,1,1
"test/externals/ruby_test/test/core/Array/instance/tc_length.rb",0,1,0,1,1
"test/externals/ruby_test/test/core/Array/instance/tc_nitems.rb",0,1,0,1,1
"test/externals/ruby_test/test/core/Array/instance/tc_pack.rb",0,1,0,1,1
"test/externals/ruby_test/test/core/Array/instance/tc_pop.rb",0,1,0,1,1
"test/externals/ruby_test/test/core/Array/instance/tc_push.rb",0,1,0,1,1
"test/externals/ruby_test/test/core/Array/instance/tc_rassoc.rb",0,1,0,1,1
"test/externals/ruby_test/test/core/Array/instance/tc_reject.rb",0,1,0,1,1
"test/externals/ruby_test/test/core/Array/instance/tc_repetition.rb",0,1,0,1,1
"test/externals/ruby_test/test/core/Array/instance/tc_replace.rb",0,1,0,1,1
"test/externals/ruby_test/test/core/Array/instance/tc_reverse.rb",0,1,0,1,1
"test/externals/ruby_test/test/core/Array/instance/tc_reverse_each.rb",0,1,0,1,1
"test/externals/ruby_test/test/core/Array/instance/tc_rindex.rb",0,1,0,1,1
"test/externals/ruby_test/test/core/Array/instance/tc_shift.rb",0,1,0,1,1
"test/externals/ruby_test/test/core/Array/instance/tc_slice.rb",0,1,0,1,1
"test/externals/ruby_test/test/core/Array/instance/tc_sort.rb",0,1,0,1,1
"test/externals/ruby_test/test/core/Array/instance/tc_to_a.rb",0,1,0,1,1
"test/externals/ruby_test/test/core/Array/instance/tc_to_ary.rb",0,1,0,1,1
"test/externals/ruby_test/test/core/Array/instance/tc_to_s.rb",0,1,0,1,1
"test/externals/ruby_test/test/core/Array/instance/tc_transpose.rb",0,1,0,1,1
"test/externals/ruby_test/test/core/Array/instance/tc_union.rb",0,1,0,1,1
"test/externals/ruby_test/test/core/Array/instance/tc_uniq.rb",0,1,0,1,1
"test/externals/ruby_test/test/core/Array/instance/tc_unshift.rb",0,1,0,1,1
"test/externals/ruby_test/test/core/Array/instance/tc_values_at.rb",0,1,0,1,1
"test/externals/ruby_test/test/core/Bignum/instance/tc_arithmetic_ops.rb",0,1,0,1,1
"test/externals/ruby_test/test/core/Bignum/instance/tc_bit_ops.rb",0,1,0,1,1
"test/externals/ruby_test/test/core/Bignum/instance/tc_comparison.rb",0,1,0,1,1
"test/externals/ruby_test/test/core/Bignum/instance/tc_to_s.rb",0,1,0,1,1
"test/externals/ruby_test/test/core/Binding/instance/tc_binding.rb",0,1,0,1,1
"test/externals/ruby_test/test/core/Class/class/tc_inherited.rb",0,1,0,1,1
"test/externals/ruby_test/test/core/Class/class/tc_new.rb",0,1,0,1,1
"test/externals/ruby_test/test/core/Class/instance/tc_allocate.rb",0,1,0,1,1
"test/externals/ruby_test/test/core/Comparable/instance/tc_less_than.rb",0,1,0,1,1
"test/externals/ruby_test/test/core/Dir/class/tc_chdir.rb",0,1,0,1,1
"test/externals/ruby_test/test/core/Dir/class/tc_chroot.rb",0,1,0,1,1
"test/externals/ruby_test/test/core/Dir/class/tc_delete.rb",0,1,0,1,1
"test/externals/ruby_test/test/core/Dir/class/tc_entries.rb",0,1,0,1,1
"test/externals/ruby_test/test/core/Dir/class/tc_foreach.rb",0,1,0,1,1
"test/externals/ruby_test/test/core/Dir/class/tc_getwd.rb",0,1,0,1,1
"test/externals/ruby_test/test/core/Dir/class/tc_glob.rb",0,1,0,1,1
"test/externals/ruby_test/test/core/Dir/class/tc_mkdir.rb",0,1,0,1,1
"test/externals/ruby_test/test/core/Dir/class/tc_new.rb",0,1,0,1,1
"test/externals/ruby_test/test/core/Dir/class/tc_open.rb",0,1,0,1,1
"test/externals/ruby_test/test/core/Dir/instance/tc_close.rb",0,1,0,1,1
"test/externals/ruby_test/test/core/Dir/instance/tc_each.rb",0,1,0,1,1
"test/externals/ruby_test/test/core/Dir/instance/tc_path.rb",0,1,0,1,1
"test/externals/ruby_test/test/core/Dir/instance/tc_pos.rb",0,1,0,1,1
"test/externals/ruby_test/test/core/Dir/instance/tc_read.rb",0,1,0,1,1
"test/externals/ruby_test/test/core/Dir/instance/tc_rewind.rb",0,1,0,1,1
"test/externals/ruby_test/test/core/Dir/instance/tc_seek.rb",0,1,0,1,1
"test/externals/ruby_test/test/core/Dir/instance/tc_tell.rb",0,1,0,1,1
"test/externals/ruby_test/test/core/Enumerable/instance/tc_all.rb",0,1,0,1,1
"test/externals/ruby_test/test/core/FalseClass/instance/tc_and.rb",0,1,0,1,1
"test/externals/ruby_test/test/core/FalseClass/instance/tc_or.rb",0,1,0,1,1
"test/externals/ruby_test/test/core/FalseClass/instance/tc_xor.rb",0,1,0,1,1
"test/externals/ruby_test/test/core/File/class/tc_atime.rb",0,1,0,1,1
"test/externals/ruby_test/test/core/File/class/tc_basename.rb",0,1,0,1,1
"test/externals/ruby_test/test/core/File/class/tc_blockdev.rb",0,1,0,1,1
"test/externals/ruby_test/test/core/File/class/tc_chardev.rb",0,1,0,1,1
"test/externals/ruby_test/test/core/File/class/tc_chmod.rb",0,1,0,1,1
"test/externals/ruby_test/test/core/File/class/tc_chown.rb",0,1,0,1,1
"test/externals/ruby_test/test/core/File/class/tc_constants.rb",0,1,0,1,1
"test/externals/ruby_test/test/core/File/class/tc_ctime.rb",0,1,0,1,1
"test/externals/ruby_test/test/core/File/class/tc_delete.rb",0,1,0,1,1
"test/externals/ruby_test/test/core/File/class/tc_directory.rb",0,1,0,1,1
"test/externals/ruby_test/test/core/File/class/tc_dirname.rb",0,1,0,1,1
"test/externals/ruby_test/test/core/File/class/tc_executable.rb",0,1,0,1,1
"test/externals/ruby_test/test/core/File/class/tc_executable_real.rb",0,1,0,1,1
"test/externals/ruby_test/test/core/File/class/tc_exist.rb",0,1,0,1,1
"test/externals/ruby_test/test/core/File/class/tc_expand_path.rb",0,1,0,1,1
"test/externals/ruby_test/test/core/File/class/tc_extname.rb",0,1,0,1,1
"test/externals/ruby_test/test/core/File/class/tc_file.rb",0,1,0,1,1
"test/externals/ruby_test/test/core/File/class/tc_fnmatch.rb",0,1,0,1,1
"test/externals/ruby_test/test/core/File/class/tc_ftype.rb",0,1,0,1,1
"test/externals/ruby_test/test/core/File/class/tc_grpowned.rb",0,1,0,1,1
"test/externals/ruby_test/test/core/File/class/tc_identical.rb",0,1,0,1,1
"test/externals/ruby_test/test/core/File/class/tc_join.rb",0,1,0,1,1
"test/externals/ruby_test/test/core/File/class/tc_lchmod.rb",0,1,0,1,1
"test/externals/ruby_test/test/core/File/class/tc_link.rb",0,1,0,1,1
"test/externals/ruby_test/test/core/File/class/tc_mtime.rb",0,1,0,1,1
"test/externals/ruby_test/test/core/File/class/tc_new.rb",0,1,0,1,1
"test/externals/ruby_test/test/core/File/class/tc_open.rb",0,1,0,1,1
"test/externals/ruby_test/test/core/File/class/tc_size.rb",0,1,0,1,1
"test/externals/ruby_test/test/core/File/class/tc_split.rb",0,1,0,1,1
"test/externals/ruby_test/test/core/File/class/tc_truncate.rb",0,1,0,1,1
"test/externals/ruby_test/test/core/File/class/tc_umask.rb",0,1,0,1,1
"test/externals/ruby_test/test/core/File/class/tc_utime.rb",0,1,0,1,1
"test/externals/ruby_test/test/core/File/class/tc_writable.rb",0,1,0,1,1
"test/externals/ruby_test/test/core/File/class/tc_writable_real.rb",0,1,0,1,1
"test/externals/ruby_test/test/core/File/class/tc_zero.rb",0,1,0,1,1
"test/externals/ruby_test/test/core/File/instance/tc_atime.rb",0,1,0,1,1
"test/externals/ruby_test/test/core/File/instance/tc_chmod.rb",0,1,0,1,1
"test/externals/ruby_test/test/core/File/instance/tc_chown.rb",0,1,0,1,1
"test/externals/ruby_test/test/core/File/instance/tc_path.rb",0,1,0,1,1
"test/externals/ruby_test/test/core/FileStat/instance/tc_atime.rb",0,1,0,1,1
"test/externals/ruby_test/test/core/FileStat/instance/tc_blksize.rb",0,1,0,1,1
"test/externals/ruby_test/test/core/FileStat/instance/tc_blockdev.rb",0,1,0,1,1
"test/externals/ruby_test/test/core/FileStat/instance/tc_blocks.rb",0,1,0,1,1
"test/externals/ruby_test/test/core/FileStat/instance/tc_chardev.rb",0,1,0,1,1
"test/externals/ruby_test/test/core/FileStat/instance/tc_ctime.rb",0,1,0,1,1
"test/externals/ruby_test/test/core/FileStat/instance/tc_dev.rb",0,1,0,1,1
"test/externals/ruby_test/test/core/FileStat/instance/tc_dev_major.rb",0,1,0,1,1
"test/externals/ruby_test/test/core/FileStat/instance/tc_dev_minor.rb",0,1,0,1,1
"test/externals/ruby_test/test/core/FileStat/instance/tc_directory.rb",0,1,0,1,1
"test/externals/ruby_test/test/core/FileStat/instance/tc_executable.rb",0,1,0,1,1
"test/externals/ruby_test/test/core/FileStat/instance/tc_executable_real.rb",0,1,0,1,1
"test/externals/ruby_test/test/core/FileStat/instance/tc_file.rb",0,1,0,1,1
"test/externals/ruby_test/test/core/FileStat/instance/tc_ftype.rb",0,1,0,1,1
"test/externals/ruby_test/test/core/FileStat/instance/tc_gid.rb",0,1,0,1,1
"test/externals/ruby_test/test/core/FileStat/instance/tc_grpowned.rb",0,1,0,1,1
"test/externals/ruby_test/test/core/FileStat/instance/tc_ino.rb",0,1,0,1,1
"test/externals/ruby_test/test/core/FileStat/instance/tc_mode.rb",0,1,0,1,1
"test/externals/ruby_test/test/core/FileStat/instance/tc_mtime.rb",0,1,0,1,1
"test/externals/ruby_test/test/core/FileStat/instance/tc_nlink.rb",0,1,0,1,1
"test/externals/ruby_test/test/core/FileStat/instance/tc_owned.rb",0,1,0,1,1
"test/externals/ruby_test/test/core/FileStat/instance/tc_pipe.rb",0,1,0,1,1
"test/externals/ruby_test/test/core/FileStat/instance/tc_rdev.rb",0,1,0,1,1
"test/externals/ruby_test/test/core/FileStat/instance/tc_rdev_major.rb",0,1,0,1,1
"test/externals/ruby_test/test/core/FileStat/instance/tc_rdev_minor.rb",0,1,0,1,1
"test/externals/ruby_test/test/core/FileStat/instance/tc_readable.rb",0,1,0,1,1
"test/externals/ruby_test/test/core/FileStat/instance/tc_readable_real.rb",0,1,0,1,1
"test/externals/ruby_test/test/core/FileStat/instance/tc_setgid.rb",0,1,0,1,1
"test/externals/ruby_test/test/core/FileStat/instance/tc_setuid.rb",0,1,0,1,1
"test/externals/ruby_test/test/core/FileStat/instance/tc_size.rb",0,1,0,1,1
"test/externals/ruby_test/test/core/FileStat/instance/tc_socket.rb",0,1,0,1,1
"test/externals/ruby_test/test/core/FileStat/instance/tc_sticky.rb",0,1,0,1,1
"test/externals/ruby_test/test/core/FileStat/instance/tc_symlink.rb",0,1,0,1,1
"test/externals/ruby_test/test/core/FileStat/instance/tc_uid.rb",0,1,0,1,1
"test/externals/ruby_test/test/core/FileStat/instance/tc_writable.rb",0,1,0,1,1
"test/externals/ruby_test/test/core/FileStat/instance/tc_writable_real.rb",0,1,0,1,1
"test/externals/ruby_test/test/core/FileStat/instance/tc_zero.rb",0,1,0,1,1
"test/externals/ruby_test/test/core/Fixnum/instance/tc_addition.rb",0,1,0,1,1
"test/externals/ruby_test/test/core/Float/class/tc_constants.rb",0,1,0,1,1
"test/externals/ruby_test/test/core/Float/instance/tc_ceil.rb",0,1,0,1,1
"test/externals/ruby_test/test/core/Float/instance/tc_finite.rb",0,1,0,1,1
"test/externals/ruby_test/test/core/Float/instance/tc_floor.rb",0,1,0,1,1
"test/externals/ruby_test/test/core/Float/instance/tc_infinite.rb",0,1,0,1,1
"test/externals/ruby_test/test/core/Float/instance/tc_nan.rb",0,1,0,1,1
"test/externals/ruby_test/test/core/Float/instance/tc_zero.rb",0,1,0,1,1
"test/externals/ruby_test/test/core/Hash/class/tc_aset.rb",0,1,0,1,1
"test/externals/ruby_test/test/core/Hash/class/tc_new.rb",0,1,0,1,1
"test/externals/ruby_test/test/core/Hash/instance/tc_aref.rb",0,1,0,1,1
"test/externals/ruby_test/test/core/Hash/instance/tc_aset.rb",0,1,0,1,1
"test/externals/ruby_test/test/core/Hash/instance/tc_clear.rb",0,1,0,1,1
"test/externals/ruby_test/test/core/Hash/instance/tc_default.rb",0,1,0,1,1
"test/externals/ruby_test/test/core/Hash/instance/tc_default_proc.rb",0,1,0,1,1
"test/externals/ruby_test/test/core/Hash/instance/tc_delete.rb",0,1,0,1,1
"test/externals/ruby_test/test/core/Hash/instance/tc_delete_if.rb",0,1,0,1,1
"test/externals/ruby_test/test/core/Hash/instance/tc_each.rb",0,1,0,1,1
"test/externals/ruby_test/test/core/Hash/instance/tc_each_key.rb",0,1,0,1,1
"test/externals/ruby_test/test/core/Hash/instance/tc_each_value.rb",0,1,0,1,1
"test/externals/ruby_test/test/core/Hash/instance/tc_empty.rb",0,1,0,1,1
"test/externals/ruby_test/test/core/Hash/instance/tc_equality.rb",0,1,0,1,1
"test/externals/ruby_test/test/core/Hash/instance/tc_fetch.rb",0,1,0,1,1
"test/externals/ruby_test/test/core/Hash/instance/tc_has_key.rb",0,1,0,1,1
"test/externals/ruby_test/test/core/Hash/instance/tc_has_value.rb",0,1,0,1,1
"test/externals/ruby_test/test/core/Hash/instance/tc_index.rb",0,1,0,1,1
"test/externals/ruby_test/test/core/Hash/instance/tc_invert.rb",0,1,0,1,1
"test/externals/ruby_test/test/core/Hash/instance/tc_keys.rb",0,1,0,1,1
"test/externals/ruby_test/test/core/Hash/instance/tc_length.rb",0,1,0,1,1
"test/externals/ruby_test/test/core/Hash/instance/tc_merge.rb",0,1,0,1,1
"test/externals/ruby_test/test/core/Hash/instance/tc_rehash.rb",0,1,0,1,1
"test/externals/ruby_test/test/core/Hash/instance/tc_reject.rb",0,1,0,1,1
"test/externals/ruby_test/test/core/Hash/instance/tc_replace.rb",0,1,0,1,1
"test/externals/ruby_test/test/core/Hash/instance/tc_select.rb",0,1,0,1,1
"test/externals/ruby_test/test/core/Hash/instance/tc_shift.rb",0,1,0,1,1
"test/externals/ruby_test/test/core/Hash/instance/tc_sort.rb",0,0.973684210526316,1,1,2
"test/externals/ruby_test/test/core/Hash/instance/tc_to_a.rb",0,1,0,1,1
"test/externals/ruby_test/test/core/Hash/instance/tc_to_hash.rb",0,1,0,1,1
"test/externals/ruby_test/test/core/Hash/instance/tc_to_s.rb",0,1,0,1,1
"test/externals/ruby_test/test/core/Hash/instance/tc_values.rb",0,1,0,1,1
"test/externals/ruby_test/test/core/Hash/instance/tc_values_at.rb",0,1,0,1,1
"test/externals/ruby_test/test/core/IO/class/tc_new.rb",0,1,0,1,1
"test/externals/ruby_test/test/core/IO/class/tc_open.rb",0,1,0,1,1
"test/externals/ruby_test/test/core/IO/class/tc_pipe.rb",0,1,0,1,1
"test/externals/ruby_test/test/core/IO/class/tc_popen.rb",0,1,0,1,1
"test/externals/ruby_test/test/core/IO/class/tc_read.rb",0,1,0,1,1
"test/externals/ruby_test/test/core/IO/class/tc_readlines.rb",0,1,0,1,1
"test/externals/ruby_test/test/core/IO/class/tc_sysopen.rb",0,1,0,1,1
"test/externals/ruby_test/test/core/IO/instance/tc_append.rb",0,1,0,1,1
"test/externals/ruby_test/test/core/IO/instance/tc_close.rb",0,1,0,1,1
"test/externals/ruby_test/test/core/Integer/instance/tc_chr.rb",0,1,0,1,1
"test/externals/ruby_test/test/core/Integer/instance/tc_downto.rb",0,1,0,1,1
"test/externals/ruby_test/test/core/Integer/instance/tc_floor.rb",0,1,0,1,1
"test/externals/ruby_test/test/core/Integer/instance/tc_integer.rb",0,1,0,1,1
"test/externals/ruby_test/test/core/Integer/instance/tc_next.rb",0,1,0,1,1
"test/externals/ruby_test/test/core/Integer/instance/tc_round.rb",0,1,0,1,1
"test/externals/ruby_test/test/core/Integer/instance/tc_times.rb",0,1,0,1,1
"test/externals/ruby_test/test/core/Integer/instance/tc_to_i.rb",0,1,0,1,1
"test/externals/ruby_test/test/core/Integer/instance/tc_upto.rb",0,1,0,1,1
"test/externals/ruby_test/test/core/Math/class/tc_acos.rb",0,1,0,1,1
"test/externals/ruby_test/test/core/Math/class/tc_acosh.rb",0,1,0,1,1
"test/externals/ruby_test/test/core/Math/class/tc_asin.rb",0,1,0,1,1
"test/externals/ruby_test/test/core/Math/class/tc_asinh.rb",0,1,0,1,1
"test/externals/ruby_test/test/core/Math/class/tc_atan.rb",0,1,0,1,1
"test/externals/ruby_test/test/core/Math/class/tc_atan2.rb",0,1,0,1,1
"test/externals/ruby_test/test/core/Math/class/tc_atanh.rb",0,1,0,1,1
"test/externals/ruby_test/test/core/Math/class/tc_constants.rb",0,1,0,1,1
"test/externals/ruby_test/test/core/Math/class/tc_cos.rb",0,1,0,1,1
"test/externals/ruby_test/test/core/Math/class/tc_cosh.rb",0,1,0,1,1
"test/externals/ruby_test/test/core/Math/class/tc_erf.rb",0,1,0,1,1
"test/externals/ruby_test/test/core/Math/class/tc_erfc.rb",0,1,0,1,1
"test/externals/ruby_test/test/core/Math/class/tc_exp.rb",0,1,0,1,1
"test/externals/ruby_test/test/core/Math/class/tc_frexp.rb",0,1,0,1,1
"test/externals/ruby_test/test/core/Math/class/tc_hypot.rb",0,1,0,1,1
"test/externals/ruby_test/test/core/Math/class/tc_ldexp.rb",0,1,0,1,1
"test/externals/ruby_test/test/core/Math/class/tc_log.rb",0,1,0,1,1
"test/externals/ruby_test/test/core/Math/class/tc_log10.rb",0,1,0,1,1
"test/externals/ruby_test/test/core/Math/class/tc_sin.rb",0,1,0,1,1
"test/externals/ruby_test/test/core/Math/class/tc_sinh.rb",0,1,0,1,1
"test/externals/ruby_test/test/core/Math/class/tc_sqrt.rb",0,1,0,1,1
"test/externals/ruby_test/test/core/Math/class/tc_tan.rb",0,1,0,1,1
"test/externals/ruby_test/test/core/Math/class/tc_tanh.rb",0,1,0,1,1
"test/externals/ruby_test/test/core/Module/class/tc_constants.rb",0,1,0,1,1
"test/externals/ruby_test/test/core/Module/class/tc_nesting.rb",0,1,0,1,1
"test/externals/ruby_test/test/core/Module/class/tc_new.rb",0,1,0,1,1
"test/externals/ruby_test/test/core/NilClass/instance/tc_and.rb",0,1,0,1,1
"test/externals/ruby_test/test/core/NilClass/instance/tc_nil.rb",0,1,0,1,1
"test/externals/ruby_test/test/core/NilClass/instance/tc_or.rb",0,1,0,1,1
"test/externals/ruby_test/test/core/NilClass/instance/tc_to_a.rb",0,1,0,1,1
"test/externals/ruby_test/test/core/NilClass/instance/tc_to_f.rb",0,1,0,1,1
"test/externals/ruby_test/test/core/NilClass/instance/tc_to_i.rb",0,1,0,1,1
"test/externals/ruby_test/test/core/NilClass/instance/tc_to_s.rb",0,1,0,1,1
"test/externals/ruby_test/test/core/NilClass/instance/tc_xor.rb",0,1,0,1,1
"test/externals/ruby_test/test/core/Numeric/instance/tc_abs.rb",0,1,0,1,1
"test/externals/ruby_test/test/core/Numeric/instance/tc_ceil.rb",0,1,0,1,1
"test/externals/ruby_test/test/core/Numeric/instance/tc_coerce.rb",0,1,0,1,1
"test/externals/ruby_test/test/core/Numeric/instance/tc_divmod.rb",0,1,0,1,1
"test/externals/ruby_test/test/core/Numeric/instance/tc_eql.rb",0,1,0,1,1
"test/externals/ruby_test/test/core/Numeric/instance/tc_floor.rb",0,1,0,1,1
"test/externals/ruby_test/test/core/Numeric/instance/tc_integer.rb",0,1,0,1,1
"test/externals/ruby_test/test/core/Numeric/instance/tc_nonzero.rb",0,1,0,1,1
"test/externals/ruby_test/test/core/Numeric/instance/tc_to_int.rb",0,1,0,1,1
"test/externals/ruby_test/test/core/Numeric/instance/tc_truncate.rb",0,1,0,1,1
"test/externals/ruby_test/test/core/Numeric/instance/tc_zero.rb",0,1,0,1,1
"test/externals/ruby_test/test/core/ObjectSpace/class/tc_id2ref.rb",0,1,0,1,1
"test/externals/ruby_test/test/core/Process/class/tc_abort.rb",0,1,0,1,1
"test/externals/ruby_test/test/core/Process/class/tc_constants.rb",0,1,0,1,1
"test/externals/ruby_test/test/core/Process/class/tc_detach.rb",0,1,0,1,1
"test/externals/ruby_test/test/core/Process/class/tc_egid.rb",0,1,0,1,1
"test/externals/ruby_test/test/core/Process/class/tc_euid.rb",0,1,0,1,1
"test/externals/ruby_test/test/core/Process/class/tc_exit.rb",0,1,0,1,1
"test/externals/ruby_test/test/core/Process/class/tc_gid.rb",0,1,0,1,1
"test/externals/ruby_test/test/core/Process/class/tc_pid.rb",0,1,0,1,1
"test/externals/ruby_test/test/core/Process/class/tc_ppid.rb",0,1,0,1,1
"test/externals/ruby_test/test/core/Process/class/tc_times.rb",0,1,0,1,1
"test/externals/ruby_test/test/core/ProcessGID/class/tc_change_privilege.rb",0,1,0,1,1
"test/externals/ruby_test/test/core/ProcessGID/class/tc_eid.rb",0,1,0,1,1
"test/externals/ruby_test/test/core/ProcessGID/class/tc_grant_privilege.rb",0,1,0,1,1
"test/externals/ruby_test/test/core/ProcessGID/class/tc_re_exchange.rb",0,1,0,1,1
"test/externals/ruby_test/test/core/ProcessGID/class/tc_re_exchangeable.rb",0,1,0,1,1
"test/externals/ruby_test/test/core/ProcessGID/class/tc_rid.rb",0,1,0,1,1
"test/externals/ruby_test/test/core/ProcessGID/class/tc_sid_available.rb",0,1,0,1,1
"test/externals/ruby_test/test/core/ProcessGID/class/tc_switch.rb",0,1,0,1,1
"test/externals/ruby_test/test/core/ProcessSys/class/tc_getegid.rb",0,1,0,1,1
"test/externals/ruby_test/test/core/ProcessSys/class/tc_geteuid.rb",0,1,0,1,1
"test/externals/ruby_test/test/core/ProcessSys/class/tc_getgid.rb",0,1,0,1,1
"test/externals/ruby_test/test/core/ProcessSys/class/tc_getuid.rb",0,1,0,1,1
"test/externals/ruby_test/test/core/ProcessSys/class/tc_issetugid.rb",0,1,0,1,1
"test/externals/ruby_test/test/core/ProcessSys/class/tc_setegid.rb",0,1,0,1,1
"test/externals/ruby_test/test/core/ProcessSys/class/tc_seteuid.rb",0,1,0,1,1
"test/externals/ruby_test/test/core/ProcessSys/class/tc_setgid.rb",0,1,0,1,1
"test/externals/ruby_test/test/core/ProcessUID/class/tc_change_privilege.rb",0,1,0,1,1
"test/externals/ruby_test/test/core/ProcessUID/class/tc_eid.rb",0,1,0,1,1
"test/externals/ruby_test/test/core/ProcessUID/class/tc_grant_privilege.rb",0,1,0,1,1
"test/externals/ruby_test/test/core/ProcessUID/class/tc_re_exchange.rb",0,1,0,1,1
"test/externals/ruby_test/test/core/ProcessUID/class/tc_re_exchangeable.rb",0,1,0,1,1
"test/externals/ruby_test/test/core/ProcessUID/class/tc_rid.rb",0,1,0,1,1
"test/externals/ruby_test/test/core/ProcessUID/class/tc_sid_available.rb",0,1,0,1,1
"test/externals/ruby_test/test/core/ProcessUID/class/tc_switch.rb",0,1,0,1,1
"test/externals/ruby_test/test/core/Range/class/tc_new.rb",0,1,0,1,1
"test/externals/ruby_test/test/core/Range/instance/tc_begin.rb",0,1,0,1,1
"test/externals/ruby_test/test/core/Range/instance/tc_each.rb",0,1,0,1,1
"test/externals/ruby_test/test/core/Range/instance/tc_equal.rb",0,1,0,1,1
"test/externals/ruby_test/test/core/Range/instance/tc_threequals.rb",0,1,0,1,1
"test/externals/ruby_test/test/core/String/class/tc_new.rb",0,1,0,1,1
"test/externals/ruby_test/test/core/String/instance/tc_aref.rb",0,1,0,1,1
"test/externals/ruby_test/test/core/String/instance/tc_aset.rb",0,1,0,1,1
"test/externals/ruby_test/test/core/String/instance/tc_capitalize.rb",0,1,0,1,1
"test/externals/ruby_test/test/core/String/instance/tc_casecmp.rb",0,1,0,1,1
"test/externals/ruby_test/test/core/String/instance/tc_center.rb",0,1,0,1,1
"test/externals/ruby_test/test/core/String/instance/tc_chomp.rb",0,1,0,1,1
"test/externals/ruby_test/test/core/String/instance/tc_chop.rb",0,1,0,1,1
"test/externals/ruby_test/test/core/String/instance/tc_count.rb",0,1,0,1,1
"test/externals/ruby_test/test/core/String/instance/tc_crypt.rb",0,1,0,1,1
"test/externals/ruby_test/test/core/String/instance/tc_delete.rb",0,1,0,1,1
"test/externals/ruby_test/test/core/String/instance/tc_downcase.rb",0,1,0,1,1
"test/externals/ruby_test/test/core/String/instance/tc_dump.rb",0,1,0,1,1
"test/externals/ruby_test/test/core/String/instance/tc_empty.rb",0,1,0,1,1
"test/externals/ruby_test/test/core/String/instance/tc_eql.rb",0,1,0,1,1
"test/externals/ruby_test/test/core/String/instance/tc_equality.rb",0,1,0,1,1
"test/externals/ruby_test/test/core/String/instance/tc_format.rb",0,1,0,1,1
"test/externals/ruby_test/test/core/String/instance/tc_hex.rb",0,1,0,1,1
"test/externals/ruby_test/test/core/String/instance/tc_include.rb",0,1,0,1,1
"test/externals/ruby_test/test/core/String/instance/tc_index.rb",0,1,0,1,1
"test/externals/ruby_test/test/core/String/instance/tc_insert.rb",0,1,0,1,1
"test/externals/ruby_test/test/core/String/instance/tc_intern.rb",0,1,0,1,1
"test/externals/ruby_test/test/core/String/instance/tc_length.rb",0,1,0,1,1
"test/externals/ruby_test/test/core/String/instance/tc_ljust.rb",0,1,0,1,1
"test/externals/ruby_test/test/core/String/instance/tc_lstrip.rb",0,1,0,1,1
"test/externals/ruby_test/test/core/String/instance/tc_match.rb",0,1,0,1,1
"test/externals/ruby_test/test/core/String/instance/tc_replace.rb",0,1,0,1,1
"test/externals/ruby_test/test/core/String/instance/tc_reverse.rb",0,1,0,1,1
"test/externals/ruby_test/test/core/String/instance/tc_rindex.rb",0,1,0,1,1
"test/externals/ruby_test/test/core/String/instance/tc_rjust.rb",0,1,0,1,1
"test/externals/ruby_test/test/core/String/instance/tc_rstrip.rb",0,1,0,1,1
"test/externals/ruby_test/test/core/String/instance/tc_scan.rb",0,1,0,1,1
"test/externals/ruby_test/test/core/String/instance/tc_slice.rb",0,1,0,1,1
"test/externals/ruby_test/test/core/String/instance/tc_split.rb",0,1,0,1,1
"test/externals/ruby_test/test/core/String/instance/tc_squeeze.rb",0,1,0,1,1
"test/externals/ruby_test/test/core/String/instance/tc_strip.rb",0,1,0,1,1
"test/externals/ruby_test/test/core/String/instance/tc_succ.rb",0,1,0,1,1
"test/externals/ruby_test/test/core/String/instance/tc_sum.rb",0,1,0,1,1
"test/externals/ruby_test/test/core/String/instance/tc_swapcase.rb",0,1,0,1,1
"test/externals/ruby_test/test/core/String/instance/tc_to_f.rb",0,1,0,1,1
"test/externals/ruby_test/test/core/String/instance/tc_to_i.rb",0,1,0,1,1
"test/externals/ruby_test/test/core/String/instance/tc_to_s.rb",0,1,0,1,1
"test/externals/ruby_test/test/core/String/instance/tc_tr.rb",0,1,0,1,1
"test/externals/ruby_test/test/core/String/instance/tc_tr_s.rb",0,1,0,1,1
"test/externals/ruby_test/test/core/String/instance/tc_unpack.rb",0,1,0,1,1
"test/externals/ruby_test/test/core/String/instance/tc_upcase.rb",0,1,0,1,1
"test/externals/ruby_test/test/core/String/instance/tc_upto.rb",0,1,0,1,1
"test/externals/ruby_test/test/core/Struct/class/tc_aref.rb",0,1,0,1,1
"test/externals/ruby_test/test/core/Struct/class/tc_members.rb",0,1,0,1,1
"test/externals/ruby_test/test/core/Struct/class/tc_new.rb",0,1,0,1,1
"test/externals/ruby_test/test/core/Struct/instance/tc_aref.rb",0,1,0,1,1
"test/externals/ruby_test/test/core/Struct/instance/tc_aset.rb",0,1,0,1,1
"test/externals/ruby_test/test/core/Struct/instance/tc_each.rb",0,1,0,1,1
"test/externals/ruby_test/test/core/Struct/instance/tc_each_pair.rb",0,1,0,1,1
"test/externals/ruby_test/test/core/Struct/instance/tc_equality.rb",0,1,0,1,1
"test/externals/ruby_test/test/core/Struct/instance/tc_length.rb",0,1,0,1,1
"test/externals/ruby_test/test/core/Struct/instance/tc_members.rb",0,1,0,1,1
"test/externals/ruby_test/test/core/Struct/instance/tc_to_a.rb",0,1,0,1,1
"test/externals/ruby_test/test/core/Struct/instance/tc_values_at.rb",0,1,0,1,1
"test/externals/ruby_test/test/core/TrueClass/class/tc_trueclass.rb",0,1,0,1,1
"test/externals/ruby_test/test/core/TrueClass/instance/tc_and.rb",0,1,0,1,1
"test/externals/ruby_test/test/core/TrueClass/instance/tc_or.rb",0,1,0,1,1
"test/externals/ruby_test/test/core/TrueClass/instance/tc_xor.rb",0,1,0,1,1
"test/externals/ruby_test/test/stdlib/English/tc_english.rb",0,1,0,1,1
"test/externals/ruby_test/test/stdlib/Pathname/tc_pathname.rb",0,1,0,1,1
"test/externals/ruby_test/test/stdlib/Rational/tc_integer.rb",0,1,0,1,1
"test/externals/ruby_test/test/stdlib/Rational/tc_rational.rb",0,1,0,1,1
"test/externals/ruby_test/test/stdlib/Set/tc_set.rb",0,1,0,1,1
"test/externals/ruby_test/test/stdlib/Set/tc_sorted_set.rb",0,1,0,1,1
"test/externals/ruby_test/test/stdlib/Socket/class/tc_tcpsocket.rb",0,1,0,1,1
"test/fib.rb",0,1,0,1,1
"test/foo.bar.rb",0,1,0,1,1
"test/funcTestSocket.rb",0,0.971830985915493,1,1,2
"test/junit_testrunner.rb",0,1,0,1,1
"test/load/load_timeout.rb",0,1,0,1,1
"test/loadTest.rb",0,1,0,1,1
"test/load_error.rb",0,1,0,1,1
"test/minirunit.rb",0,0.419642857142857,3,3,6
"test/mri/sample/test.rb",0,0.993596059113301,4,1,5
"test/org/jruby/javasupport/test/SimpleInterfaceImpl.rb",0,1,0,1,1
"test/parse_error.rb",0,1,0,1,1
"test/require_target.rb",0,1,0,1,1
"test/rubicon/file_info_testcase.rb",0,1,0,1,1
"test/rubicon/test_access_control.rb",0,1,0,1,1
"test/rubicon/test_array.rb",0,1,0,1,1
"test/rubicon/test_assignment.rb",0,1,0,1,1
"test/rubicon/test_basic_expressions.rb",0,1,0,1,1
"test/rubicon/test_bignum.rb",0,1,0,1,1
"test/rubicon/test_blocks_procs.rb",0,1,0,1,1
"test/rubicon/test_boolean_expressions.rb",0,1,0,1,1
"test/rubicon/test_case.rb",0,1,0,1,1
"test/rubicon/test_catch_throw.rb",0,1,0,1,1
"test/rubicon/test_class.rb",0,1,0,1,1
"test/rubicon/test_comparable.rb",0,1,0,1,1
"test/rubicon/test_constants.rb",0,1,0,1,1
"test/rubicon/test_continuation.rb",0,1,0,1,1
"test/rubicon/test_dir.rb",0,1,0,1,1
"test/rubicon/test_enumerable.rb",0,1,0,1,1
"test/rubicon/test_eval.rb",0,1,0,1,1
"test/rubicon/test_exception.rb",0,1,0,1,1
"test/rubicon/test_exceptions.rb",0,1,0,1,1
"test/rubicon/test_false_class.rb",0,1,0,1,1
"test/rubicon/test_file.rb",0,1,0,1,1
"test/rubicon/test_file_stat.rb",0,1,0,1,1
"test/rubicon/test_file_test.rb",0,1,0,1,1
"test/rubicon/test_fixnum.rb",0,1,0,1,1
"test/rubicon/test_flip.rb",0,1,0,1,1
"test/rubicon/test_float.rb",0,1,0,1,1
"test/rubicon/test_floats.rb",0,0.723809523809524,0,2,2
"test/rubicon/test_gc.rb",0,1,0,1,1
"test/rubicon/test_hash.rb",0,1,0,1,1
"test/rubicon/test_if_unless.rb",0,1,0,1,1
"test/rubicon/test_integer.rb",0,1,0,1,1
"test/rubicon/test_invocation.rb",0,1,0,1,1
"test/rubicon/test_io.rb",0,1,0,1,1
"test/rubicon/test_kanji_index.rb",0,1,0,1,1
"test/rubicon/test_kernel.rb",0,1,0,1,1
"test/rubicon/test_loop_stuff.rb",0,1,0,1,1
"test/rubicon/test_marshal.rb",0,1,0,1,1
"test/rubicon/test_match_data.rb",0,1,0,1,1
"test/rubicon/test_math.rb",0,1,0,1,1
"test/rubicon/test_method.rb",0,1,0,1,1
"test/rubicon/test_methods.rb",0,1,0,1,1
"test/rubicon/test_module.rb",0,1,0,1,1
"test/rubicon/test_module_private.rb",0,1,0,1,1
"test/rubicon/test_nil_class.rb",0,1,0,1,1
"test/rubicon/test_numeric.rb",0,1,0,1,1
"test/rubicon/test_object.rb",0,1,0,1,1
"test/rubicon/test_object_space.rb",0,0.95,0,2,2
"test/rubicon/test_pack.rb",0,1,0,1,1
"test/rubicon/test_predefined_variables.rb",0,1,0,1,1
"test/rubicon/test_proc.rb",0,1,0,1,1
"test/rubicon/test_range.rb",0,1,0,1,1
"test/rubicon/test_regexp.rb",0,1,0,1,1
"test/rubicon/test_regular_expressions.rb",0,1,0,1,1
"test/rubicon/test_scope.rb",0,1,0,1,1
"test/rubicon/test_source_layout.rb",0,1,0,1,1
"test/rubicon/test_string.rb",0,1,0,1,1
"test/rubicon/test_strings.rb",0,1,0,1,1
"test/rubicon/test_struct.rb",0,1,0,1,1
"test/rubicon/test_struct_tms.rb",0,1,0,1,1
"test/rubicon/test_symbol.rb",0,1,0,1,1
"test/rubicon/test_thread.rb",0,1,0,1,1
"test/rubicon/test_thread_group.rb",0,1,0,1,1
"test/rubicon/test_time.rb",0,1,0,1,1
"test/rubicon/test_true_class.rb",0,1,0,1,1
"test/superReq1.rb",0,1,0,1,1
"test/superReq2.rb",0,1,0,1,1
"test/testClasses.rb",0,0.720430107526882,2,3,5
"test/testCompiler.rb",0,0.937238493723849,2,1,3
"test/testConstant.rb",0,0.794759825327511,0,3,3
"test/testCornerCases.rb",0,1,0,1,1
"test/testDigest.rb",0,0.833333333333333,0,2,2
"test/testEnumerable.rb",0,0.657894736842105,0,3,3
"test/testEnumerator.rb",0,1,0,1,1
"test/testEnv.rb",0,0.911392405063291,0,2,2
"test/testEval.rb",0,0.391304347826087,0,3,3
"test/testException.rb",0,0.462264150943396,4,4,8
"test/testException2.rb",0,0.423423423423423,0,4,4
"test/testException3.rb",0,1,0,1,1
"test/testExpressions.rb",0,1,0,1,1
"test/testFixnum.rb",0,0.952380952380952,1,1,2
"test/testFixnumBignumAutoconversion.rb",0,0.9375,0,2,2
"test/testFloat.rb",0,0.582089552238806,1,5,6
"test/testGC.rb",0,1,0,1,1
"test/testHash.rb",0,0.357664233576642,0,4,4
"test/testHereDocument.rb",0,0.876404494382023,2,2,4
"test/testHooks.rb",0,1,0,1,1
"test/testIconv.rb",0,0.529411764705882,0,2,2
"test/testIf.rb",0,0.566666666666667,1,2,3
"test/testInspect.rb",0,1,0,1,1
"test/testInstantiatingInterfaces.rb",0,0.933333333333333,0,2,2
"test/testInteger.rb",0,0.9,0,2,2
"test/testJavaArraySupport.rb",0,1,0,1,1
"test/testJavaIntegration.rb",0,1,0,1,1
"test/testLine.rb",0,0.6,0,2,2
"test/testLine_block_comment.rb",0,0.875,0,2,2
"test/testLine_block_comment_start.rb",0,1,0,1,1
"test/testLine_code.rb",0,1,0,1,1
"test/testLine_comment.rb",0,1,0,1,1
"test/testLine_line_comment_start.rb",0,1,0,1,1
"test/testLine_mixed_comment.rb",0,1,0,1,1
"test/testLoops.rb",0,0.658227848101266,1,3,4
"test/testLowerJavaSupport.rb",0,0.625,2,4,6
"test/testMarshal.rb",0,0.339759036144578,0,5,5
"test/testMath.rb",0,1,0,1,1
"test/testMethods.rb",0,0.413173652694611,1,4,5
"test/testModule.rb",0,0.344743276283619,0,5,5
"test/testNesting.rb",0,1,0,1,1
"test/testNoMethodError.rb",0,1,0,1,1
"test/testNumber.rb",0,0.343234323432343,3,3,6
"test/testObject.rb",0,0.503105590062112,0,3,3
"test/testObjectSpace.rb",0,0.704545454545455,0,2,2
"test/testPackUnpack.rb",0,0.537037037037037,1,3,4
"test/testPipe.rb",0,0.941176470588235,0,2,2
"test/testPositions.rb",0,0.867869615832363,0,3,3
"test/testProc.rb",0,0.447368421052632,0,4,4
"test/testRange.rb",0,0.452054794520548,1,4,5
"test/testRbConfig.rb",0,0.777777777777778,0,3,3
"test/testReadline.rb",0,1,0,1,1
"test/testRedefine.rb",0,1,0,1,1
"test/testRegexp.rb",0,0.279411764705882,3,6,9
"test/testReturn.rb",0,0.86734693877551,0,2,2
"test/testRuntimeCallbacks.rb",0,1,0,1,1
"test/testSingletonClass.rb",0,1,0,1,1
"test/testSocket.rb",0,0.555555555555556,0,3,3
"test/testSplat.rb",0,1,0,1,1
"test/testString.rb",0,0.530538922155689,4,3,7
"test/testStringChomp.rb",0,0.936936936936937,0,2,2
"test/testStringEachLineStress.rb",0,1,0,1,1
"test/testStringEval.rb",0,0.615384615384615,0,3,3
"test/testStringGsubStress.rb",0,1,0,1,1
"test/testStringIO.rb",0,0.838709677419355,1,2,3
"test/testStringScan.rb",0,0.571428571428571,0,3,3
"test/testStringScanStress.rb",0,1,0,1,1
"test/testStringSplitStress.rb",0,1,0,1,1
"test/testStringSubclassBehavior.rb",0,0.977777777777778,1,1,2
"test/testStruct.rb",0,0.330827067669173,0,4,4
"test/testSuper.rb",0,0.780722891566265,0,3,3
"test/testSymbol.rb",0,0.708955223880597,0,2,2
"test/testTime.rb",0,0.396825396825397,0,5,5
"test/testUTF8Regex.rb",0,1,0,1,1
"test/testUnboundMethod.rb",0,1,0,1,1
"test/testVariableAndMethod.rb",0,0.806451612903226,1,2,3
"test/testVisibility.rb",0,0.607142857142857,1,3,4
"test/testXML.rb",0,1,0,1,1
"test/testYAML.rb",0,1,0,1,1
"test/test_argf.rb",0,1,0,1,1
"test/test_array.rb",0,0.656603773584906,0,4,4
"test/test_array_subclass_behavior.rb",0,0.971428571428571,1,1,2
"test/test_autoload.rb",0,0.764705882352941,0,3,3
"test/test_backquote.rb",0,0.76271186440678,1,2,3
"test/test_backtraces.rb",0,1,0,1,1
"test/test_base64_strangeness.rb",0,1,0,1,1
"test/test_big_decimal.rb",0,0.603686635944701,0,3,3
"test/test_bignum.rb",0,0.91304347826087,0,2,2
"test/test_block.rb",0,0.653136531365314,1,2,3
"test/test_block_arg_processing.rb",0,1,0,1,1
"test/test_cache_map_leak.rb",0,0.9,0,2,2
"test/test_case.rb",0,0.89873417721519,0,2,2
"test/test_class.rb",0,0.693498452012384,0,3,3
"test/test_command_line_switches.rb",0,1,0,1,1
"test/test_comparable.rb",0,1,0,1,1
"test/test_core_arities.rb",0,1,0,1,1
"test/test_crazy_blocks.rb",0,1,0,1,1
"test/test_date_time.rb",0,1,0,1,1
"test/test_defined.rb",0,0.90228013029316,1,2,3
"test/test_digest2.rb",0,1,0,1,1
"test/test_dir.rb",0,0.570200573065903,2,2,4
"test/test_dup_clone_taint_freeze.rb",0,0.721311475409836,0,2,2
"test/test_env.rb",0,1,0,1,1
"test/test_eval.rb",0,1,0,1,1
"test/test_eval_with_binding.rb",0,1,0,1,1
"test/test_file.rb",0,0.434169278996865,1,4,5
"test/test_flip.rb",0,0.512396694214876,1,2,3
"test/test_globals.rb",0,0.481481481481481,1,4,5
"test/test_hash.rb",0,0.847457627118644,0,2,2
"test/test_helper.rb",0,1,0,1,1
"test/test_higher_javasupport.rb",0,0.609090909090909,2,4,6
"test/test_iconv.rb",0,1,0,1,1
"test/test_io.rb",0,0.455696202531646,3,3,6
"test/test_java_accessible_object.rb",0,1,0,1,1
"test/test_java_extension.rb",0,0.842307692307692,1,2,3
"test/test_jruby_internals.rb",0,1,0,1,1
"test/test_kernel.rb",0,0.92022792022792,3,1,4
"test/test_kernel_1_9_features.rb",0,1,0,1,1
"test/test_launching_by_shell_script.rb",0,0.583333333333333,0,2,2
"test/test_load.rb",0,0.863636363636364,0,2,2
"test/test_loading_builtin_libraries.rb",0,1,0,1,1
"test/test_loading_builtin_libraries_1_9.rb",0,1,0,1,1
"test/test_local_jump_error.rb",0,1,0,1,1
"test/test_marshal_gemspec.rb",0,1,0,1,1
"test/test_method_missing.rb",0,0.875,0,2,2
"test/test_methods.rb",0,0.642424242424242,0,4,4
"test/test_nkf.rb",0,1,0,1,1
"test/test_numeric.rb",0,0.984293193717278,1,1,2
"test/test_object_persistence.rb",0,1,0,1,1
"test/test_pack.rb",0,0.939393939393939,0,2,2
"test/test_parsing.rb",0,0.586206896551724,0,3,3
"test/test_primitive_to_java.rb",0,0.466666666666667,0,4,4
"test/test_proc_visibility.rb",0,1,0,1,1
"test/test_process.rb",0,0.843137254901961,1,2,3
"test/test_random.rb",0,1,0,1,1
"test/test_rbconfig.rb",0,1,0,1,1
"test/test_rewriter.rb",0,1,0,1,1
"test/test_singleton_with_transient.rb",0,1,0,1,1
"test/test_socket.rb",0,0.851590106007067,0,3,3
"test/test_string_java_bytes.rb",0,1,0,1,1
"test/test_string_printf.rb",0,0.807692307692308,0,2,2
"test/test_string_sub.rb",0,1,0,1,1
"test/test_string_to_number.rb",0,1,0,1,1
"test/test_symbol.rb",0,1,0,1,1
"test/test_system_error.rb",0,0.568627450980392,0,2,2
"test/test_tb_yaml.rb",0,1,0,1,1
"test/test_thread.rb",0,0.438914027149321,2,3,5
"test/test_time_nil_ops.rb",0,1,0,1,1
"test/test_timeout.rb",0,1,0,1,1
"test/test_trace_func.rb",0,1,0,1,1
"test/test_variables.rb",0,1,0,1,1
"test/test_vietnamese_charset.rb",0,1,0,1,1
"test/test_yaml.rb",0,0.965288035450517,1,1,2
"test/test_zlib.rb",0,0.401960784313726,0,3,3
"tool/nailgun/src/c/ng.c",0,1,0,1,1
"tool/snapshot.rb",0,1,0,1,1
"tool/yarvinsns.rb",0,1,0,1,1
