"Filename","X","LineOWN","LineMinor","LineMajor","LineNumDev"
"contrib/analyzers/common/src/java/org/apache/lucene/analysis/ar/ArabicAnalyzer.java",0,0.448598130841122,0,5,5
"contrib/analyzers/common/src/java/org/apache/lucene/analysis/ar/ArabicLetterTokenizer.java",0,0.763636363636364,1,3,4
"contrib/analyzers/common/src/java/org/apache/lucene/analysis/ar/ArabicNormalizationFilter.java",0,0.745098039215686,3,2,5
"contrib/analyzers/common/src/java/org/apache/lucene/analysis/ar/ArabicNormalizer.java",0,0.808695652173913,0,2,2
"contrib/analyzers/common/src/java/org/apache/lucene/analysis/ar/ArabicStemFilter.java",0,0.730769230769231,3,2,5
"contrib/analyzers/common/src/java/org/apache/lucene/analysis/ar/ArabicStemmer.java",0,0.99438202247191,1,1,2
"contrib/analyzers/common/src/java/org/apache/lucene/analysis/br/BrazilianAnalyzer.java",0,0.309917355371901,3,5,8
"contrib/analyzers/common/src/java/org/apache/lucene/analysis/br/BrazilianStemFilter.java",0,0.376811594202899,2,4,6
"contrib/analyzers/common/src/java/org/apache/lucene/analysis/br/BrazilianStemmer.java",0,0.941234084231146,5,1,6
"contrib/analyzers/common/src/java/org/apache/lucene/analysis/cjk/CJKAnalyzer.java",0,0.291139240506329,2,5,7
"contrib/analyzers/common/src/java/org/apache/lucene/analysis/cjk/CJKTokenizer.java",0,0.579439252336449,3,4,7
"contrib/analyzers/common/src/java/org/apache/lucene/analysis/cn/ChineseAnalyzer.java",0,0.467532467532468,0,4,4
"contrib/analyzers/common/src/java/org/apache/lucene/analysis/cn/ChineseFilter.java",0,0.475728155339806,2,6,8
"contrib/analyzers/common/src/java/org/apache/lucene/analysis/cn/ChineseTokenizer.java",0,0.444444444444444,3,4,7
"contrib/analyzers/common/src/java/org/apache/lucene/analysis/compound/CompoundWordTokenFilterBase.java",0,0.710280373831776,3,2,5
"contrib/analyzers/common/src/java/org/apache/lucene/analysis/compound/DictionaryCompoundWordTokenFilter.java",0,0.923728813559322,0,2,2
"contrib/analyzers/common/src/java/org/apache/lucene/analysis/compound/HyphenationCompoundWordTokenFilter.java",0,0.950226244343891,2,1,3
"contrib/analyzers/common/src/java/org/apache/lucene/analysis/compound/hyphenation/ByteVector.java",0,1,0,1,1
"contrib/analyzers/common/src/java/org/apache/lucene/analysis/compound/hyphenation/CharVector.java",0,0.992700729927007,1,1,2
"contrib/analyzers/common/src/java/org/apache/lucene/analysis/compound/hyphenation/Hyphen.java",0,0.971428571428571,2,1,3
"contrib/analyzers/common/src/java/org/apache/lucene/analysis/compound/hyphenation/Hyphenation.java",0,1,0,1,1
"contrib/analyzers/common/src/java/org/apache/lucene/analysis/compound/hyphenation/HyphenationException.java",0,1,0,1,1
"contrib/analyzers/common/src/java/org/apache/lucene/analysis/compound/hyphenation/HyphenationTree.java",0,0.985294117647059,2,1,3
"contrib/analyzers/common/src/java/org/apache/lucene/analysis/compound/hyphenation/PatternConsumer.java",0,1,0,1,1
"contrib/analyzers/common/src/java/org/apache/lucene/analysis/compound/hyphenation/PatternParser.java",0,0.971374045801527,3,1,4
"contrib/analyzers/common/src/java/org/apache/lucene/analysis/compound/hyphenation/TernaryTree.java",0,0.986466165413534,3,1,4
"contrib/analyzers/common/src/java/org/apache/lucene/analysis/cz/CzechAnalyzer.java",0,0.413636363636364,4,4,8
"contrib/analyzers/common/src/java/org/apache/lucene/analysis/de/GermanAnalyzer.java",0,0.412955465587045,3,4,7
"contrib/analyzers/common/src/java/org/apache/lucene/analysis/de/GermanStemFilter.java",0,0.646464646464647,2,4,6
"contrib/analyzers/common/src/java/org/apache/lucene/analysis/de/GermanStemmer.java",0,0.936329588014981,3,1,4
"contrib/analyzers/common/src/java/org/apache/lucene/analysis/el/GreekAnalyzer.java",0,0.361963190184049,1,4,5
"contrib/analyzers/common/src/java/org/apache/lucene/analysis/el/GreekLowerCaseFilter.java",0,0.612068965517241,0,3,3
"contrib/analyzers/common/src/java/org/apache/lucene/analysis/fa/PersianAnalyzer.java",0,0.668181818181818,1,3,4
"contrib/analyzers/common/src/java/org/apache/lucene/analysis/fa/PersianNormalizationFilter.java",0,0.905660377358491,1,2,3
"contrib/analyzers/common/src/java/org/apache/lucene/analysis/fa/PersianNormalizer.java",0,0.861386138613861,0,2,2
"contrib/analyzers/common/src/java/org/apache/lucene/analysis/fr/ElisionFilter.java",0,0.518181818181818,2,4,6
"contrib/analyzers/common/src/java/org/apache/lucene/analysis/fr/FrenchAnalyzer.java",0,0.356862745098039,2,5,7
"contrib/analyzers/common/src/java/org/apache/lucene/analysis/fr/FrenchStemFilter.java",0,0.610526315789474,1,5,6
"contrib/analyzers/common/src/java/org/apache/lucene/analysis/fr/FrenchStemmer.java",0,0.922535211267606,5,1,6
"contrib/analyzers/common/src/java/org/apache/lucene/analysis/miscellaneous/EmptyTokenStream.java",0,0.828571428571429,2,2,4
"contrib/analyzers/common/src/java/org/apache/lucene/analysis/miscellaneous/PatternAnalyzer.java",0,0.661224489795918,6,3,9
"contrib/analyzers/common/src/java/org/apache/lucene/analysis/miscellaneous/PrefixAndSuffixAwareTokenFilter.java",0,0.835443037974684,0,3,3
"contrib/analyzers/common/src/java/org/apache/lucene/analysis/miscellaneous/PrefixAwareTokenFilter.java",0,0.528205128205128,2,3,5
"contrib/analyzers/common/src/java/org/apache/lucene/analysis/miscellaneous/SingleTokenTokenStream.java",0,0.597222222222222,2,3,5
"contrib/analyzers/common/src/java/org/apache/lucene/analysis/ngram/EdgeNGramTokenFilter.java",0,0.628930817610063,0,4,4
"contrib/analyzers/common/src/java/org/apache/lucene/analysis/ngram/EdgeNGramTokenizer.java",0,0.446351931330472,5,3,8
"contrib/analyzers/common/src/java/org/apache/lucene/analysis/ngram/NGramTokenFilter.java",0,0.551401869158878,1,3,4
"contrib/analyzers/common/src/java/org/apache/lucene/analysis/ngram/NGramTokenizer.java",0,0.490066225165563,3,3,6
"contrib/analyzers/common/src/java/org/apache/lucene/analysis/nl/DutchAnalyzer.java",0,0.335820895522388,1,6,7
"contrib/analyzers/common/src/java/org/apache/lucene/analysis/nl/DutchStemFilter.java",0,0.447368421052632,3,5,8
"contrib/analyzers/common/src/java/org/apache/lucene/analysis/nl/DutchStemmer.java",0,0.85012285012285,6,1,7
"contrib/analyzers/common/src/java/org/apache/lucene/analysis/payloads/AbstractEncoder.java",0,0.548387096774194,1,2,3
"contrib/analyzers/common/src/java/org/apache/lucene/analysis/payloads/DelimitedPayloadTokenFilter.java",0,0.930232558139535,3,1,4
"contrib/analyzers/common/src/java/org/apache/lucene/analysis/payloads/FloatEncoder.java",0,0.972972972972973,1,1,2
"contrib/analyzers/common/src/java/org/apache/lucene/analysis/payloads/IdentityEncoder.java",0,1,0,1,1
"contrib/analyzers/common/src/java/org/apache/lucene/analysis/payloads/IntegerEncoder.java",0,1,0,1,1
"contrib/analyzers/common/src/java/org/apache/lucene/analysis/payloads/NumericPayloadTokenFilter.java",0,0.737704918032787,2,2,4
"contrib/analyzers/common/src/java/org/apache/lucene/analysis/payloads/PayloadEncoder.java",0,0.95,0,2,2
"contrib/analyzers/common/src/java/org/apache/lucene/analysis/payloads/PayloadHelper.java",0,0.972972972972973,1,1,2
"contrib/analyzers/common/src/java/org/apache/lucene/analysis/payloads/TokenOffsetPayloadTokenFilter.java",0,0.694915254237288,2,2,4
"contrib/analyzers/common/src/java/org/apache/lucene/analysis/payloads/TypeAsPayloadTokenFilter.java",0,0.711864406779661,2,2,4
"contrib/analyzers/common/src/java/org/apache/lucene/analysis/position/PositionFilter.java",0,0.821428571428571,2,2,4
"contrib/analyzers/common/src/java/org/apache/lucene/analysis/query/QueryAutoStopWordAnalyzer.java",0,0.564625850340136,1,3,4
"contrib/analyzers/common/src/java/org/apache/lucene/analysis/reverse/ReverseStringFilter.java",0,0.488549618320611,1,3,4
"contrib/analyzers/common/src/java/org/apache/lucene/analysis/ru/RussianAnalyzer.java",0,0.433962264150943,4,4,8
"contrib/analyzers/common/src/java/org/apache/lucene/analysis/ru/RussianLetterTokenizer.java",0,0.5,0,4,4
"contrib/analyzers/common/src/java/org/apache/lucene/analysis/ru/RussianLowerCaseFilter.java",0,0.964912280701754,1,1,2
"contrib/analyzers/common/src/java/org/apache/lucene/analysis/ru/RussianStemFilter.java",0,0.556962025316456,3,4,7
"contrib/analyzers/common/src/java/org/apache/lucene/analysis/ru/RussianStemmer.java",0,0.872727272727273,3,2,5
"contrib/analyzers/common/src/java/org/apache/lucene/analysis/shingle/ShingleAnalyzerWrapper.java",0,0.386666666666667,0,4,4
"contrib/analyzers/common/src/java/org/apache/lucene/analysis/shingle/ShingleFilter.java",0,0.556851311953353,3,3,6
"contrib/analyzers/common/src/java/org/apache/lucene/analysis/shingle/ShingleMatrixFilter.java",0,0.872985781990521,6,1,7
"contrib/analyzers/common/src/java/org/apache/lucene/analysis/sinks/DateRecognizerSinkFilter.java",0,0.884057971014493,1,2,3
"contrib/analyzers/common/src/java/org/apache/lucene/analysis/sinks/TokenRangeSinkFilter.java",0,0.964285714285714,1,1,2
"contrib/analyzers/common/src/java/org/apache/lucene/analysis/sinks/TokenTypeSinkFilter.java",0,0.928571428571429,2,1,3
"contrib/analyzers/common/src/java/org/apache/lucene/analysis/th/ThaiAnalyzer.java",0,0.423529411764706,0,3,3
"contrib/analyzers/common/src/java/org/apache/lucene/analysis/th/ThaiWordFilter.java",0,0.582417582417582,1,3,4
"contrib/analyzers/common/src/test/org/apache/lucene/analysis/ar/TestArabicAnalyzer.java",0,0.541176470588235,1,2,3
"contrib/analyzers/common/src/test/org/apache/lucene/analysis/ar/TestArabicNormalizationFilter.java",0,0.957446808510638,2,1,3
"contrib/analyzers/common/src/test/org/apache/lucene/analysis/ar/TestArabicStemFilter.java",0,0.934426229508197,3,1,4
"contrib/analyzers/common/src/test/org/apache/lucene/analysis/br/TestBrazilianStemmer.java",0,0.754716981132076,2,2,4
"contrib/analyzers/common/src/test/org/apache/lucene/analysis/cjk/TestCJKTokenizer.java",0,0.454545454545455,1,3,4
"contrib/analyzers/common/src/test/org/apache/lucene/analysis/cn/TestChineseTokenizer.java",0,0.633333333333333,2,5,7
"contrib/analyzers/common/src/test/org/apache/lucene/analysis/compound/TestCompoundWordTokenFilter.java",0,0.725738396624473,2,3,5
"contrib/analyzers/common/src/test/org/apache/lucene/analysis/cz/TestCzechAnalyzer.java",0,0.540229885057471,1,2,3
"contrib/analyzers/common/src/test/org/apache/lucene/analysis/de/TestGermanStemFilter.java",0,0.327102803738318,1,5,6
"contrib/analyzers/common/src/test/org/apache/lucene/analysis/el/GreekAnalyzerTest.java",0,0.696969696969697,2,2,4
"contrib/analyzers/common/src/test/org/apache/lucene/analysis/fa/TestPersianAnalyzer.java",0,0.955947136563877,2,1,3
"contrib/analyzers/common/src/test/org/apache/lucene/analysis/fa/TestPersianNormalizationFilter.java",0,0.9375,0,2,2
"contrib/analyzers/common/src/test/org/apache/lucene/analysis/fr/TestElision.java",0,0.836065573770492,2,2,4
"contrib/analyzers/common/src/test/org/apache/lucene/analysis/fr/TestFrenchAnalyzer.java",0,0.62,3,3,6
"contrib/analyzers/common/src/test/org/apache/lucene/analysis/miscellaneous/PatternAnalyzerTest.java",0,0.711111111111111,2,3,5
"contrib/analyzers/common/src/test/org/apache/lucene/analysis/miscellaneous/TestEmptyTokenStream.java",0,0.882352941176471,0,3,3
"contrib/analyzers/common/src/test/org/apache/lucene/analysis/miscellaneous/TestPrefixAndSuffixAwareTokenFilter.java",0,0.587301587301587,0,4,4
"contrib/analyzers/common/src/test/org/apache/lucene/analysis/miscellaneous/TestPrefixAwareTokenFilter.java",0,0.583333333333333,0,4,4
"contrib/analyzers/common/src/test/org/apache/lucene/analysis/miscellaneous/TestSingleTokenTokenFilter.java",0,0.625,0,2,2
"contrib/analyzers/common/src/test/org/apache/lucene/analysis/ngram/EdgeNGramTokenFilterTest.java",0,0.820754716981132,0,3,3
"contrib/analyzers/common/src/test/org/apache/lucene/analysis/ngram/EdgeNGramTokenizerTest.java",0,0.826530612244898,0,3,3
"contrib/analyzers/common/src/test/org/apache/lucene/analysis/ngram/NGramTokenFilterTest.java",0,0.760416666666667,1,3,4
"contrib/analyzers/common/src/test/org/apache/lucene/analysis/ngram/NGramTokenizerTest.java",0,0.741573033707865,1,3,4
"contrib/analyzers/common/src/test/org/apache/lucene/analysis/nl/TestDutchStemmer.java",0,0.694915254237288,0,3,3
"contrib/analyzers/common/src/test/org/apache/lucene/analysis/payloads/DelimitedPayloadTokenFilterTest.java",0,0.913669064748201,1,2,3
"contrib/analyzers/common/src/test/org/apache/lucene/analysis/payloads/NumericPayloadTokenFilterTest.java",0,0.630952380952381,1,3,4
"contrib/analyzers/common/src/test/org/apache/lucene/analysis/payloads/TokenOffsetPayloadTokenFilterTest.java",0,0.810344827586207,0,3,3
"contrib/analyzers/common/src/test/org/apache/lucene/analysis/payloads/TypeAsPayloadTokenFilterTest.java",0,0.645569620253165,1,3,4
"contrib/analyzers/common/src/test/org/apache/lucene/analysis/position/PositionFilterTest.java",0,0.633802816901408,1,3,4
"contrib/analyzers/common/src/test/org/apache/lucene/analysis/query/QueryAutoStopWordAnalyzerTest.java",0,0.536585365853659,2,3,5
"contrib/analyzers/common/src/test/org/apache/lucene/analysis/reverse/TestReverseStringFilter.java",0,0.552631578947368,0,4,4
"contrib/analyzers/common/src/test/org/apache/lucene/analysis/ru/TestRussianAnalyzer.java",0,0.470588235294118,0,7,7
"contrib/analyzers/common/src/test/org/apache/lucene/analysis/ru/TestRussianStem.java",0,0.831578947368421,1,3,4
"contrib/analyzers/common/src/test/org/apache/lucene/analysis/shingle/ShingleAnalyzerWrapperTest.java",0,0.59409594095941,2,3,5
"contrib/analyzers/common/src/test/org/apache/lucene/analysis/shingle/ShingleFilterTest.java",0,0.389221556886228,2,4,6
"contrib/analyzers/common/src/test/org/apache/lucene/analysis/shingle/TestShingleMatrixFilter.java",0,0.512367491166078,2,3,5
"contrib/analyzers/common/src/test/org/apache/lucene/analysis/sinks/DateRecognizerSinkTokenizerTest.java",0,0.631578947368421,0,3,3
"contrib/analyzers/common/src/test/org/apache/lucene/analysis/sinks/TokenRangeSinkTokenizerTest.java",0,0.6,1,2,3
"contrib/analyzers/common/src/test/org/apache/lucene/analysis/sinks/TokenTypeSinkTokenizerTest.java",0,0.528089887640449,2,3,5
"contrib/analyzers/common/src/test/org/apache/lucene/analysis/th/TestThaiAnalyzer.java",0,0.344827586206897,3,3,6
"contrib/analyzers/smartcn/src/java/org/apache/lucene/analysis/cn/smart/AnalyzerProfile.java",0,0.845360824742268,2,2,4
"contrib/analyzers/smartcn/src/java/org/apache/lucene/analysis/cn/smart/CharType.java",0,0.528571428571429,2,2,4
"contrib/analyzers/smartcn/src/java/org/apache/lucene/analysis/cn/smart/SentenceTokenizer.java",0,0.54014598540146,2,4,6
"contrib/analyzers/smartcn/src/java/org/apache/lucene/analysis/cn/smart/SmartChineseAnalyzer.java",0,0.590425531914894,2,2,4
"contrib/analyzers/smartcn/src/java/org/apache/lucene/analysis/cn/smart/Utility.java",0,0.728260869565217,2,2,4
"contrib/analyzers/smartcn/src/java/org/apache/lucene/analysis/cn/smart/WordSegmenter.java",0,0.591397849462366,1,4,5
"contrib/analyzers/smartcn/src/java/org/apache/lucene/analysis/cn/smart/WordTokenFilter.java",0,0.371134020618557,2,4,6
"contrib/analyzers/smartcn/src/java/org/apache/lucene/analysis/cn/smart/WordType.java",0,0.5,2,2,4
"contrib/analyzers/smartcn/src/java/org/apache/lucene/analysis/cn/smart/hhmm/AbstractDictionary.java",0,0.696261682242991,2,2,4
"contrib/analyzers/smartcn/src/java/org/apache/lucene/analysis/cn/smart/hhmm/BiSegGraph.java",0,0.73728813559322,2,3,5
"contrib/analyzers/smartcn/src/java/org/apache/lucene/analysis/cn/smart/hhmm/BigramDictionary.java",0,0.924187725631769,2,2,4
"contrib/analyzers/smartcn/src/java/org/apache/lucene/analysis/cn/smart/hhmm/HHMMSegmenter.java",0,0.803827751196172,2,3,5
"contrib/analyzers/smartcn/src/java/org/apache/lucene/analysis/cn/smart/hhmm/PathNode.java",0,0.525641025641026,1,3,4
"contrib/analyzers/smartcn/src/java/org/apache/lucene/analysis/cn/smart/hhmm/SegGraph.java",0,0.662162162162162,2,3,5
"contrib/analyzers/smartcn/src/java/org/apache/lucene/analysis/cn/smart/hhmm/SegToken.java",0,0.912,2,2,4
"contrib/analyzers/smartcn/src/java/org/apache/lucene/analysis/cn/smart/hhmm/SegTokenFilter.java",0,0.652777777777778,2,2,4
"contrib/analyzers/smartcn/src/java/org/apache/lucene/analysis/cn/smart/hhmm/SegTokenPair.java",0,0.505263157894737,2,2,4
"contrib/analyzers/smartcn/src/java/org/apache/lucene/analysis/cn/smart/hhmm/WordDictionary.java",0,0.85451197053407,1,3,4
"contrib/analyzers/smartcn/src/test/org/apache/lucene/analysis/cn/smart/TestSmartChineseAnalyzer.java",0,0.4375,2,3,5
"contrib/ant/src/java/org/apache/lucene/ant/ConfigurableDocumentHandler.java",0,0.75,0,2,2
"contrib/ant/src/java/org/apache/lucene/ant/DocumentHandler.java",0,0.825,1,2,3
"contrib/ant/src/java/org/apache/lucene/ant/DocumentHandlerException.java",0,0.879518072289157,2,2,4
"contrib/ant/src/java/org/apache/lucene/ant/FileExtensionDocumentHandler.java",0,0.876923076923077,2,2,4
"contrib/ant/src/java/org/apache/lucene/ant/HtmlDocument.java",0,0.758503401360544,3,2,5
"contrib/ant/src/java/org/apache/lucene/ant/IndexTask.java",0,0.631818181818182,4,2,6
"contrib/ant/src/java/org/apache/lucene/ant/TextDocument.java",0,0.897959183673469,3,2,5
"contrib/ant/src/test/org/apache/lucene/ant/DocumentTestCase.java",0,0.775,0,3,3
"contrib/ant/src/test/org/apache/lucene/ant/HtmlDocumentTest.java",0,0.833333333333333,1,2,3
"contrib/ant/src/test/org/apache/lucene/ant/IndexTaskTest.java",0,0.78125,4,3,7
"contrib/ant/src/test/org/apache/lucene/ant/TextDocumentTest.java",0,0.829787234042553,1,2,3
"contrib/benchmark/src/java/org/apache/lucene/benchmark/Constants.java",0,1,0,1,1
"contrib/benchmark/src/java/org/apache/lucene/benchmark/byTask/Benchmark.java",0,0.992592592592593,1,1,2
"contrib/benchmark/src/java/org/apache/lucene/benchmark/byTask/PerfRunData.java",0,0.641843971631206,2,4,6
"contrib/benchmark/src/java/org/apache/lucene/benchmark/byTask/feeds/AbstractQueryMaker.java",0,1,0,1,1
"contrib/benchmark/src/java/org/apache/lucene/benchmark/byTask/feeds/ContentSource.java",0,0.975728155339806,1,1,2
"contrib/benchmark/src/java/org/apache/lucene/benchmark/byTask/feeds/DemoHTMLParser.java",0,0.858974358974359,0,2,2
"contrib/benchmark/src/java/org/apache/lucene/benchmark/byTask/feeds/DirContentSource.java",0,0.502008032128514,4,2,6
"contrib/benchmark/src/java/org/apache/lucene/benchmark/byTask/feeds/DocData.java",0,0.59375,0,2,2
"contrib/benchmark/src/java/org/apache/lucene/benchmark/byTask/feeds/DocMaker.java",0,0.720554272517321,1,3,4
"contrib/benchmark/src/java/org/apache/lucene/benchmark/byTask/feeds/EnwikiContentSource.java",0,0.940789473684211,3,1,4
"contrib/benchmark/src/java/org/apache/lucene/benchmark/byTask/feeds/EnwikiQueryMaker.java",0,0.91970802919708,3,1,4
"contrib/benchmark/src/java/org/apache/lucene/benchmark/byTask/feeds/FileBasedQueryMaker.java",0,0.71,2,3,5
"contrib/benchmark/src/java/org/apache/lucene/benchmark/byTask/feeds/HTMLParser.java",0,0.92156862745098,0,2,2
"contrib/benchmark/src/java/org/apache/lucene/benchmark/byTask/feeds/LineDocSource.java",0,0.967741935483871,1,1,2
"contrib/benchmark/src/java/org/apache/lucene/benchmark/byTask/feeds/NoMoreDataException.java",0,0.962962962962963,1,1,2
"contrib/benchmark/src/java/org/apache/lucene/benchmark/byTask/feeds/QueryMaker.java",0,1,0,1,1
"contrib/benchmark/src/java/org/apache/lucene/benchmark/byTask/feeds/ReutersContentSource.java",0,0.947019867549669,2,1,3
"contrib/benchmark/src/java/org/apache/lucene/benchmark/byTask/feeds/ReutersQueryMaker.java",0,0.825,3,3,6
"contrib/benchmark/src/java/org/apache/lucene/benchmark/byTask/feeds/SimpleQueryMaker.java",0,0.746478873239437,4,3,7
"contrib/benchmark/src/java/org/apache/lucene/benchmark/byTask/feeds/SimpleSloppyPhraseQueryMaker.java",0,0.674698795180723,4,2,6
"contrib/benchmark/src/java/org/apache/lucene/benchmark/byTask/feeds/SingleDocSource.java",0,0.458333333333333,1,3,4
"contrib/benchmark/src/java/org/apache/lucene/benchmark/byTask/feeds/SortableSingleDocSource.java",0,0.982456140350877,1,1,2
"contrib/benchmark/src/java/org/apache/lucene/benchmark/byTask/feeds/TrecContentSource.java",0,0.94,3,1,4
"contrib/benchmark/src/java/org/apache/lucene/benchmark/byTask/programmatic/Sample.java",0,0.96,2,1,3
"contrib/benchmark/src/java/org/apache/lucene/benchmark/byTask/stats/Points.java",0,0.923076923076923,1,2,3
"contrib/benchmark/src/java/org/apache/lucene/benchmark/byTask/stats/Report.java",0,0.96875,2,1,3
"contrib/benchmark/src/java/org/apache/lucene/benchmark/byTask/stats/TaskStats.java",0,0.974226804123711,3,1,4
"contrib/benchmark/src/java/org/apache/lucene/benchmark/byTask/tasks/AddDocTask.java",0,0.755813953488372,1,3,4
"contrib/benchmark/src/java/org/apache/lucene/benchmark/byTask/tasks/BenchmarkHighlighter.java",0,1,0,1,1
"contrib/benchmark/src/java/org/apache/lucene/benchmark/byTask/tasks/ClearStatsTask.java",0,0.934782608695652,2,1,3
"contrib/benchmark/src/java/org/apache/lucene/benchmark/byTask/tasks/CloseIndexTask.java",0,0.615384615384615,2,2,4
"contrib/benchmark/src/java/org/apache/lucene/benchmark/byTask/tasks/CloseReaderTask.java",0,0.829787234042553,2,2,4
"contrib/benchmark/src/java/org/apache/lucene/benchmark/byTask/tasks/CommitIndexTask.java",0,0.538461538461538,1,2,3
"contrib/benchmark/src/java/org/apache/lucene/benchmark/byTask/tasks/ConsumeContentSourceTask.java",0,0.942857142857143,2,1,3
"contrib/benchmark/src/java/org/apache/lucene/benchmark/byTask/tasks/CreateIndexTask.java",0,0.719424460431655,3,2,5
"contrib/benchmark/src/java/org/apache/lucene/benchmark/byTask/tasks/DeleteByPercentTask.java",0,0.957446808510638,1,1,2
"contrib/benchmark/src/java/org/apache/lucene/benchmark/byTask/tasks/DeleteDocTask.java",0,0.677777777777778,2,4,6
"contrib/benchmark/src/java/org/apache/lucene/benchmark/byTask/tasks/FlushReaderTask.java",0,0.931034482758621,1,2,3
"contrib/benchmark/src/java/org/apache/lucene/benchmark/byTask/tasks/NearRealtimeReaderTask.java",0,0.98,1,1,2
"contrib/benchmark/src/java/org/apache/lucene/benchmark/byTask/tasks/NewAnalyzerTask.java",0,0.792079207920792,1,2,3
"contrib/benchmark/src/java/org/apache/lucene/benchmark/byTask/tasks/NewRoundTask.java",0,0.934782608695652,2,1,3
"contrib/benchmark/src/java/org/apache/lucene/benchmark/byTask/tasks/OpenIndexTask.java",0,0.5,1,3,4
"contrib/benchmark/src/java/org/apache/lucene/benchmark/byTask/tasks/OpenReaderTask.java",0,0.6,2,2,4
"contrib/benchmark/src/java/org/apache/lucene/benchmark/byTask/tasks/OptimizeTask.java",0,0.716981132075472,2,3,5
"contrib/benchmark/src/java/org/apache/lucene/benchmark/byTask/tasks/PerfTask.java",0,0.622641509433962,2,4,6
"contrib/benchmark/src/java/org/apache/lucene/benchmark/byTask/tasks/PrintReaderTask.java",0,0.928571428571429,1,2,3
"contrib/benchmark/src/java/org/apache/lucene/benchmark/byTask/tasks/ReadTask.java",0,0.44636678200692,2,3,5
"contrib/benchmark/src/java/org/apache/lucene/benchmark/byTask/tasks/ReadTokensTask.java",0,0.853146853146853,2,2,4
"contrib/benchmark/src/java/org/apache/lucene/benchmark/byTask/tasks/ReopenReaderTask.java",0,0.866666666666667,1,2,3
"contrib/benchmark/src/java/org/apache/lucene/benchmark/byTask/tasks/RepAllTask.java",0,0.539473684210526,2,2,4
"contrib/benchmark/src/java/org/apache/lucene/benchmark/byTask/tasks/RepSelectByPrefTask.java",0,0.567567567567568,2,2,4
"contrib/benchmark/src/java/org/apache/lucene/benchmark/byTask/tasks/RepSumByNameRoundTask.java",0,0.5375,1,3,4
"contrib/benchmark/src/java/org/apache/lucene/benchmark/byTask/tasks/RepSumByNameTask.java",0,0.5375,1,3,4
"contrib/benchmark/src/java/org/apache/lucene/benchmark/byTask/tasks/RepSumByPrefRoundTask.java",0,0.558441558441558,1,3,4
"contrib/benchmark/src/java/org/apache/lucene/benchmark/byTask/tasks/RepSumByPrefTask.java",0,0.933333333333333,2,1,3
"contrib/benchmark/src/java/org/apache/lucene/benchmark/byTask/tasks/ReportTask.java",0,0.677018633540373,3,2,5
"contrib/benchmark/src/java/org/apache/lucene/benchmark/byTask/tasks/ResetInputsTask.java",0,0.96,1,1,2
"contrib/benchmark/src/java/org/apache/lucene/benchmark/byTask/tasks/ResetSystemEraseTask.java",0,0.906976744186046,4,1,5
"contrib/benchmark/src/java/org/apache/lucene/benchmark/byTask/tasks/ResetSystemSoftTask.java",0,0.930232558139535,3,1,4
"contrib/benchmark/src/java/org/apache/lucene/benchmark/byTask/tasks/RollbackIndexTask.java",0,1,0,1,1
"contrib/benchmark/src/java/org/apache/lucene/benchmark/byTask/tasks/SearchTask.java",0,0.901639344262295,1,2,3
"contrib/benchmark/src/java/org/apache/lucene/benchmark/byTask/tasks/SearchTravRetHighlightTask.java",0,0.758389261744966,2,2,4
"contrib/benchmark/src/java/org/apache/lucene/benchmark/byTask/tasks/SearchTravRetLoadFieldSelectorTask.java",0,0.85,2,3,5
"contrib/benchmark/src/java/org/apache/lucene/benchmark/byTask/tasks/SearchTravRetTask.java",0,0.911111111111111,3,1,4
"contrib/benchmark/src/java/org/apache/lucene/benchmark/byTask/tasks/SearchTravRetVectorHighlightTask.java",0,0.923611111111111,2,1,3
"contrib/benchmark/src/java/org/apache/lucene/benchmark/byTask/tasks/SearchTravTask.java",0,0.662790697674419,0,3,3
"contrib/benchmark/src/java/org/apache/lucene/benchmark/byTask/tasks/SearchWithSortTask.java",0,0.585365853658537,1,3,4
"contrib/benchmark/src/java/org/apache/lucene/benchmark/byTask/tasks/SetPropTask.java",0,0.811594202898551,2,2,4
"contrib/benchmark/src/java/org/apache/lucene/benchmark/byTask/tasks/TaskSequence.java",0,0.506382978723404,4,3,7
"contrib/benchmark/src/java/org/apache/lucene/benchmark/byTask/tasks/UpdateDocTask.java",0,0.893617021276596,1,2,3
"contrib/benchmark/src/java/org/apache/lucene/benchmark/byTask/tasks/WaitTask.java",0,1,0,1,1
"contrib/benchmark/src/java/org/apache/lucene/benchmark/byTask/tasks/WarmTask.java",0,0.923076923076923,0,2,2
"contrib/benchmark/src/java/org/apache/lucene/benchmark/byTask/tasks/WriteLineDocTask.java",0,0.868965517241379,3,2,5
"contrib/benchmark/src/java/org/apache/lucene/benchmark/byTask/utils/Algorithm.java",0,0.81786941580756,4,2,6
"contrib/benchmark/src/java/org/apache/lucene/benchmark/byTask/utils/Config.java",0,0.73,3,3,6
"contrib/benchmark/src/java/org/apache/lucene/benchmark/byTask/utils/FileUtils.java",0,1,0,1,1
"contrib/benchmark/src/java/org/apache/lucene/benchmark/byTask/utils/Format.java",0,0.864,2,2,4
"contrib/benchmark/src/java/org/apache/lucene/benchmark/byTask/utils/StringBufferReader.java",0,0.950276243093923,2,1,3
"contrib/benchmark/src/java/org/apache/lucene/benchmark/quality/Judge.java",0,1,0,1,1
"contrib/benchmark/src/java/org/apache/lucene/benchmark/quality/QualityBenchmark.java",0,0.987577639751553,1,1,2
"contrib/benchmark/src/java/org/apache/lucene/benchmark/quality/QualityQuery.java",0,0.930232558139535,0,2,2
"contrib/benchmark/src/java/org/apache/lucene/benchmark/quality/QualityQueryParser.java",0,1,0,1,1
"contrib/benchmark/src/java/org/apache/lucene/benchmark/quality/QualityStats.java",0,0.986394557823129,2,1,3
"contrib/benchmark/src/java/org/apache/lucene/benchmark/quality/trec/QueryDriver.java",0,0.626506024096386,2,3,5
"contrib/benchmark/src/java/org/apache/lucene/benchmark/quality/trec/Trec1MQReader.java",0,0.96551724137931,1,1,2
"contrib/benchmark/src/java/org/apache/lucene/benchmark/quality/trec/TrecJudge.java",0,0.92948717948718,0,2,2
"contrib/benchmark/src/java/org/apache/lucene/benchmark/quality/trec/TrecTopicsReader.java",0,0.975609756097561,1,1,2
"contrib/benchmark/src/java/org/apache/lucene/benchmark/quality/utils/DocNameExtractor.java",0,1,0,1,1
"contrib/benchmark/src/java/org/apache/lucene/benchmark/quality/utils/QualityQueriesFinder.java",0,0.932835820895522,4,1,5
"contrib/benchmark/src/java/org/apache/lucene/benchmark/quality/utils/SimpleQQParser.java",0,0.932203389830508,1,2,3
"contrib/benchmark/src/java/org/apache/lucene/benchmark/quality/utils/SubmissionReport.java",0,1,0,1,1
"contrib/benchmark/src/java/org/apache/lucene/benchmark/stats/MemUsage.java",0,0.976744186046512,1,1,2
"contrib/benchmark/src/java/org/apache/lucene/benchmark/stats/QueryData.java",0,0.962025316455696,2,1,3
"contrib/benchmark/src/java/org/apache/lucene/benchmark/stats/TestData.java",0,0.930313588850174,2,2,4
"contrib/benchmark/src/java/org/apache/lucene/benchmark/stats/TestRunData.java",0,0.895348837209302,2,2,4
"contrib/benchmark/src/java/org/apache/lucene/benchmark/stats/TimeData.java",0,0.961165048543689,2,1,3
"contrib/benchmark/src/java/org/apache/lucene/benchmark/utils/ExtractReuters.java",0,0.994318181818182,1,1,2
"contrib/benchmark/src/java/org/apache/lucene/benchmark/utils/ExtractWikipedia.java",0,0.920529801324503,1,2,3
"contrib/benchmark/src/java/org/apache/lucene/benchmark/utils/NoDeletionPolicy.java",0,0.783783783783784,0,2,2
"contrib/benchmark/src/test/org/apache/lucene/benchmark/BenchmarkTestCase.java",0,1,0,1,1
"contrib/benchmark/src/test/org/apache/lucene/benchmark/byTask/TestPerfTasksLogic.java",0,0.463905325443787,2,4,6
"contrib/benchmark/src/test/org/apache/lucene/benchmark/byTask/TestPerfTasksParse.java",0,0.829545454545455,0,3,3
"contrib/benchmark/src/test/org/apache/lucene/benchmark/byTask/feeds/DocMakerTest.java",0,0.987730061349693,1,1,2
"contrib/benchmark/src/test/org/apache/lucene/benchmark/byTask/feeds/LineDocSourceTest.java",0,1,0,1,1
"contrib/benchmark/src/test/org/apache/lucene/benchmark/byTask/feeds/TrecContentSourceTest.java",0,0.847305389221557,1,2,3
"contrib/benchmark/src/test/org/apache/lucene/benchmark/byTask/tasks/CountingHighlighterTestTask.java",0,0.720588235294118,1,2,3
"contrib/benchmark/src/test/org/apache/lucene/benchmark/byTask/tasks/CountingSearchTestTask.java",0,0.781818181818182,1,2,3
"contrib/benchmark/src/test/org/apache/lucene/benchmark/byTask/tasks/CreateIndexTaskTest.java",0,1,0,1,1
"contrib/benchmark/src/test/org/apache/lucene/benchmark/byTask/tasks/PerfTaskTest.java",0,0.986301369863014,1,1,2
"contrib/benchmark/src/test/org/apache/lucene/benchmark/byTask/tasks/WriteLineDocTaskTest.java",0,0.637554585152838,1,2,3
"contrib/benchmark/src/test/org/apache/lucene/benchmark/quality/TestQualityRun.java",0,0.971428571428571,2,1,3
"contrib/collation/src/java/org/apache/lucene/collation/CollationKeyAnalyzer.java",0,0.910714285714286,1,2,3
"contrib/collation/src/java/org/apache/lucene/collation/CollationKeyFilter.java",0,0.792792792792793,2,3,5
"contrib/collation/src/java/org/apache/lucene/collation/ICUCollationKeyAnalyzer.java",0,0.89622641509434,1,2,3
"contrib/collation/src/java/org/apache/lucene/collation/ICUCollationKeyFilter.java",0,0.779816513761468,2,3,5
"contrib/collation/src/test/org/apache/lucene/collation/CollationTestBase.java",0,0.932659932659933,0,2,2
"contrib/collation/src/test/org/apache/lucene/collation/TestCollationKeyAnalyzer.java",0,0.975609756097561,1,1,2
"contrib/collation/src/test/org/apache/lucene/collation/TestCollationKeyFilter.java",0,0.97,2,1,3
"contrib/collation/src/test/org/apache/lucene/collation/TestICUCollationKeyAnalyzer.java",0,0.975903614457831,1,1,2
"contrib/collation/src/test/org/apache/lucene/collation/TestICUCollationKeyFilter.java",0,0.97029702970297,2,1,3
"contrib/db/bdb-je/src/java/org/apache/lucene/store/je/Block.java",0,0.710843373493976,1,3,4
"contrib/db/bdb-je/src/java/org/apache/lucene/store/je/File.java",0,0.666666666666667,2,2,4
"contrib/db/bdb-je/src/java/org/apache/lucene/store/je/JEDirectory.java",0,0.892857142857143,5,1,6
"contrib/db/bdb-je/src/java/org/apache/lucene/store/je/JEIndexInput.java",0,0.900709219858156,3,1,4
"contrib/db/bdb-je/src/java/org/apache/lucene/store/je/JEIndexOutput.java",0,0.54421768707483,4,2,6
"contrib/db/bdb-je/src/java/org/apache/lucene/store/je/JELock.java",0,0.735849056603774,1,4,5
"contrib/db/bdb-je/src/test/org/apache/lucene/store/je/JEStoreTest.java",0,0.955905511811024,5,1,6
"contrib/db/bdb/src/java/com/sleepycat/db/DbHandleExtractor.java",0,0.88,0,2,2
"contrib/db/bdb/src/java/org/apache/lucene/store/db/Block.java",0,0.861702127659574,1,3,4
"contrib/db/bdb/src/java/org/apache/lucene/store/db/DbDirectory.java",0,0.713740458015267,4,2,6
"contrib/db/bdb/src/java/org/apache/lucene/store/db/DbIndexInput.java",0,0.907894736842105,3,1,4
"contrib/db/bdb/src/java/org/apache/lucene/store/db/DbIndexOutput.java",0,0.615384615384615,4,2,6
"contrib/db/bdb/src/java/org/apache/lucene/store/db/DbLock.java",0,0.836363636363636,0,3,3
"contrib/db/bdb/src/java/org/apache/lucene/store/db/File.java",0,0.85171102661597,2,2,4
"contrib/db/bdb/src/test/org/apache/lucene/store/db/DbStoreTest.java",0,0.945107398568019,4,1,5
"contrib/db/bdb/src/test/org/apache/lucene/store/db/SanityLoadLibrary.java",0,1,0,1,1
"contrib/fast-vector-highlighter/src/java/org/apache/lucene/search/vectorhighlight/BaseFragmentsBuilder.java",0,0.984,1,1,2
"contrib/fast-vector-highlighter/src/java/org/apache/lucene/search/vectorhighlight/FastVectorHighlighter.java",0,0.985401459854015,1,1,2
"contrib/fast-vector-highlighter/src/java/org/apache/lucene/search/vectorhighlight/FieldFragList.java",0,0.980952380952381,1,1,2
"contrib/fast-vector-highlighter/src/java/org/apache/lucene/search/vectorhighlight/FieldPhraseList.java",0,0.989189189189189,1,1,2
"contrib/fast-vector-highlighter/src/java/org/apache/lucene/search/vectorhighlight/FieldQuery.java",0,0.989795918367347,1,1,2
"contrib/fast-vector-highlighter/src/java/org/apache/lucene/search/vectorhighlight/FieldTermStack.java",0,0.988439306358382,2,1,3
"contrib/fast-vector-highlighter/src/java/org/apache/lucene/search/vectorhighlight/FragListBuilder.java",0,1,0,1,1
"contrib/fast-vector-highlighter/src/java/org/apache/lucene/search/vectorhighlight/FragmentsBuilder.java",0,1,0,1,1
"contrib/fast-vector-highlighter/src/java/org/apache/lucene/search/vectorhighlight/ScoreOrderFragmentsBuilder.java",0,0.971428571428571,2,1,3
"contrib/fast-vector-highlighter/src/java/org/apache/lucene/search/vectorhighlight/SimpleFragListBuilder.java",0,0.976190476190476,1,1,2
"contrib/fast-vector-highlighter/src/java/org/apache/lucene/search/vectorhighlight/SimpleFragmentsBuilder.java",0,0.981481481481482,1,1,2
"contrib/fast-vector-highlighter/src/test/org/apache/lucene/search/vectorhighlight/AbstractTestCase.java",0,0.955678670360111,3,1,4
"contrib/fast-vector-highlighter/src/test/org/apache/lucene/search/vectorhighlight/FieldPhraseListTest.java",0,1,0,1,1
"contrib/fast-vector-highlighter/src/test/org/apache/lucene/search/vectorhighlight/FieldQueryTest.java",0,0.991556091676719,1,1,2
"contrib/fast-vector-highlighter/src/test/org/apache/lucene/search/vectorhighlight/FieldTermStackTest.java",0,1,0,1,1
"contrib/fast-vector-highlighter/src/test/org/apache/lucene/search/vectorhighlight/IndexTimeSynonymTest.java",0,0.952830188679245,3,1,4
"contrib/fast-vector-highlighter/src/test/org/apache/lucene/search/vectorhighlight/ScoreOrderFragmentsBuilderTest.java",0,1,0,1,1
"contrib/fast-vector-highlighter/src/test/org/apache/lucene/search/vectorhighlight/SimpleFragListBuilderTest.java",0,0.912790697674419,0,2,2
"contrib/fast-vector-highlighter/src/test/org/apache/lucene/search/vectorhighlight/SimpleFragmentsBuilderTest.java",0,0.761538461538461,1,2,3
"contrib/highlighter/src/java/org/apache/lucene/search/highlight/DefaultEncoder.java",0,0.96875,1,1,2
"contrib/highlighter/src/java/org/apache/lucene/search/highlight/Encoder.java",0,0.931034482758621,2,1,3
"contrib/highlighter/src/java/org/apache/lucene/search/highlight/Formatter.java",0,0.636363636363636,0,3,3
"contrib/highlighter/src/java/org/apache/lucene/search/highlight/Fragmenter.java",0,0.5,0,3,3
"contrib/highlighter/src/java/org/apache/lucene/search/highlight/GradientFormatter.java",0,0.938325991189427,5,1,6
"contrib/highlighter/src/java/org/apache/lucene/search/highlight/Highlighter.java",0,0.563197026022305,8,2,10
"contrib/highlighter/src/java/org/apache/lucene/search/highlight/InvalidTokenOffsetsException.java",0,1,0,1,1
"contrib/highlighter/src/java/org/apache/lucene/search/highlight/NullFragmenter.java",0,0.696969696969697,0,3,3
"contrib/highlighter/src/java/org/apache/lucene/search/highlight/QueryScorer.java",0,0.914179104477612,4,1,5
"contrib/highlighter/src/java/org/apache/lucene/search/highlight/QueryTermExtractor.java",0,0.581395348837209,3,3,6
"contrib/highlighter/src/java/org/apache/lucene/search/highlight/QueryTermScorer.java",0,0.95679012345679,1,1,2
"contrib/highlighter/src/java/org/apache/lucene/search/highlight/Scorer.java",0,0.656716417910448,0,3,3
"contrib/highlighter/src/java/org/apache/lucene/search/highlight/SimpleFragmenter.java",0,0.5875,1,3,4
"contrib/highlighter/src/java/org/apache/lucene/search/highlight/SimpleHTMLEncoder.java",0,0.975308641975309,2,1,3
"contrib/highlighter/src/java/org/apache/lucene/search/highlight/SimpleHTMLFormatter.java",0,0.423728813559322,1,4,5
"contrib/highlighter/src/java/org/apache/lucene/search/highlight/SimpleSpanFragmenter.java",0,0.648148148148148,0,3,3
"contrib/highlighter/src/java/org/apache/lucene/search/highlight/SpanGradientFormatter.java",0,0.871794871794872,3,2,5
"contrib/highlighter/src/java/org/apache/lucene/search/highlight/TextFragment.java",0,0.711111111111111,0,5,5
"contrib/highlighter/src/java/org/apache/lucene/search/highlight/TokenGroup.java",0,0.704545454545455,2,2,4
"contrib/highlighter/src/java/org/apache/lucene/search/highlight/TokenSources.java",0,0.619926199261993,5,4,9
"contrib/highlighter/src/java/org/apache/lucene/search/highlight/WeightedSpanTerm.java",0,0.942307692307692,0,2,2
"contrib/highlighter/src/java/org/apache/lucene/search/highlight/WeightedSpanTermExtractor.java",0,0.855172413793103,3,3,6
"contrib/highlighter/src/java/org/apache/lucene/search/highlight/WeightedTerm.java",0,0.890625,1,2,3
"contrib/highlighter/src/test/org/apache/lucene/search/highlight/HighlighterTest.java",0,0.573476702508961,9,2,11
"contrib/instantiated/src/java/org/apache/lucene/store/instantiated/FieldSetting.java",0,0.96875,1,1,2
"contrib/instantiated/src/java/org/apache/lucene/store/instantiated/FieldSettings.java",0,0.989247311827957,1,1,2
"contrib/instantiated/src/java/org/apache/lucene/store/instantiated/InstantiatedDocument.java",0,0.9875,1,1,2
"contrib/instantiated/src/java/org/apache/lucene/store/instantiated/InstantiatedIndex.java",0,0.706703910614525,2,2,4
"contrib/instantiated/src/java/org/apache/lucene/store/instantiated/InstantiatedIndexReader.java",0,0.634204275534442,2,3,5
"contrib/instantiated/src/java/org/apache/lucene/store/instantiated/InstantiatedIndexWriter.java",0,0.827389443651926,5,2,7
"contrib/instantiated/src/java/org/apache/lucene/store/instantiated/InstantiatedTerm.java",0,0.972111553784861,2,1,3
"contrib/instantiated/src/java/org/apache/lucene/store/instantiated/InstantiatedTermDocs.java",0,1,0,1,1
"contrib/instantiated/src/java/org/apache/lucene/store/instantiated/InstantiatedTermDocumentInformation.java",0,0.985611510791367,2,1,3
"contrib/instantiated/src/java/org/apache/lucene/store/instantiated/InstantiatedTermEnum.java",0,0.942528735632184,2,1,3
"contrib/instantiated/src/java/org/apache/lucene/store/instantiated/InstantiatedTermFreqVector.java",0,0.982300884955752,2,1,3
"contrib/instantiated/src/java/org/apache/lucene/store/instantiated/InstantiatedTermPositionVector.java",0,1,0,1,1
"contrib/instantiated/src/java/org/apache/lucene/store/instantiated/InstantiatedTermPositions.java",0,0.99,1,1,2
"contrib/instantiated/src/test/org/apache/lucene/store/instantiated/TestEmptyIndex.java",0,0.882882882882883,2,2,4
"contrib/instantiated/src/test/org/apache/lucene/store/instantiated/TestIndicesEquals.java",0,0.723628691983122,3,3,6
"contrib/instantiated/src/test/org/apache/lucene/store/instantiated/TestRealTime.java",0,0.860759493670886,0,3,3
"contrib/instantiated/src/test/org/apache/lucene/store/instantiated/TestSerialization.java",0,0.982758620689655,1,1,2
"contrib/instantiated/src/test/org/apache/lucene/store/instantiated/TestUnoptimizedReaderOnConstructor.java",0,0.986111111111111,1,1,2
"contrib/lucli/src/java/lucli/LuceneMethods.java",0,0.547557840616967,2,5,7
"contrib/lucli/src/java/lucli/Lucli.java",0,0.738317757009346,3,2,5
"contrib/memory/src/java/org/apache/lucene/index/memory/MemoryIndex.java",0,0.5723124516628,9,3,12
"contrib/memory/src/test/org/apache/lucene/index/memory/MemoryIndexTest.java",0,0.508833922261484,7,3,10
"contrib/misc/src/java/org/apache/lucene/index/BalancedSegmentMergePolicy.java",0,0.993243243243243,2,1,3
"contrib/misc/src/java/org/apache/lucene/index/FieldNormModifier.java",0,0.883870967741936,5,1,6
"contrib/misc/src/java/org/apache/lucene/index/IndexSplitter.java",0,0.975460122699387,1,1,2
"contrib/misc/src/java/org/apache/lucene/index/MultiPassIndexSplitter.java",0,0.995762711864407,1,1,2
"contrib/misc/src/java/org/apache/lucene/index/TermVectorAccessor.java",0,0.876470588235294,4,1,5
"contrib/misc/src/java/org/apache/lucene/misc/ChainedFilter.java",0,0.473880597014925,5,4,9
"contrib/misc/src/java/org/apache/lucene/misc/HighFreqTerms.java",0,0.828282828282828,3,2,5
"contrib/misc/src/java/org/apache/lucene/misc/IndexMergeTool.java",0,0.8,3,2,5
"contrib/misc/src/java/org/apache/lucene/misc/SweetSpotSimilarity.java",0,0.762081784386617,5,2,7
"contrib/misc/src/java/org/apache/lucene/queryParser/analyzing/AnalyzingQueryParser.java",0,0.795031055900621,5,2,7
"contrib/misc/src/java/org/apache/lucene/queryParser/complexPhrase/ComplexPhraseQueryParser.java",0,0.890547263681592,5,1,6
"contrib/misc/src/java/org/apache/lucene/queryParser/precedence/CharStream.java",0,0.839285714285714,0,3,3
"contrib/misc/src/java/org/apache/lucene/queryParser/precedence/FastCharStream.java",0,0.951219512195122,1,1,2
"contrib/misc/src/java/org/apache/lucene/queryParser/precedence/ParseException.java",0,0.929292929292929,0,2,2
"contrib/misc/src/java/org/apache/lucene/queryParser/precedence/PrecedenceQueryParser.java",0,0.899458623356535,2,2,4
"contrib/misc/src/java/org/apache/lucene/queryParser/precedence/PrecedenceQueryParserConstants.java",0,0.65546218487395,0,2,2
"contrib/misc/src/java/org/apache/lucene/queryParser/precedence/PrecedenceQueryParserTokenManager.java",0,0.867715078630897,1,2,3
"contrib/misc/src/java/org/apache/lucene/queryParser/precedence/Token.java",0,0.556451612903226,0,2,2
"contrib/misc/src/java/org/apache/lucene/queryParser/precedence/TokenMgrError.java",0,0.865248226950355,0,2,2
"contrib/misc/src/test/org/apache/lucene/index/TestFieldNormModifier.java",0,0.668032786885246,2,3,5
"contrib/misc/src/test/org/apache/lucene/index/TestIndexSplitter.java",0,1,0,1,1
"contrib/misc/src/test/org/apache/lucene/index/TestMultiPassIndexSplitter.java",0,0.9921875,1,1,2
"contrib/misc/src/test/org/apache/lucene/index/TestTermVectorAccessor.java",0,0.839285714285714,1,2,3
"contrib/misc/src/test/org/apache/lucene/misc/ChainedFilterTest.java",0,0.485849056603774,2,4,6
"contrib/misc/src/test/org/apache/lucene/misc/SweetSpotSimilarityTest.java",0,0.947368421052632,3,1,4
"contrib/misc/src/test/org/apache/lucene/misc/TestLengthNormModifier.java",0,0.599033816425121,3,3,6
"contrib/misc/src/test/org/apache/lucene/queryParser/analyzing/TestAnalyzingQueryParser.java",0,0.892561983471074,4,1,5
"contrib/misc/src/test/org/apache/lucene/queryParser/complexPhrase/TestComplexPhraseQuery.java",0,0.938775510204082,4,1,5
"contrib/misc/src/test/org/apache/lucene/queryParser/precedence/TestPrecedenceQueryParser.java",0,0.881188118811881,3,2,5
"contrib/queries/src/java/org/apache/lucene/search/BooleanFilter.java",0,0.868292682926829,2,2,4
"contrib/queries/src/java/org/apache/lucene/search/BoostingQuery.java",0,0.700787401574803,1,2,3
"contrib/queries/src/java/org/apache/lucene/search/DuplicateFilter.java",0,0.986842105263158,1,1,2
"contrib/queries/src/java/org/apache/lucene/search/FilterClause.java",0,1,0,1,1
"contrib/queries/src/java/org/apache/lucene/search/FuzzyLikeThisQuery.java",0,0.723716381418093,3,2,5
"contrib/queries/src/java/org/apache/lucene/search/TermsFilter.java",0,0.92156862745098,2,1,3
"contrib/queries/src/java/org/apache/lucene/search/similar/MoreLikeThis.java",0,0.845857418111753,4,2,6
"contrib/queries/src/java/org/apache/lucene/search/similar/MoreLikeThisQuery.java",0,0.969879518072289,2,1,3
"contrib/queries/src/java/org/apache/lucene/search/similar/SimilarityQueries.java",0,0.929824561403509,3,1,4
"contrib/queries/src/test/org/apache/lucene/search/BooleanFilterTest.java",0,0.94375,3,1,4
"contrib/queries/src/test/org/apache/lucene/search/BoostingQueryTest.java",0,1,0,1,1
"contrib/queries/src/test/org/apache/lucene/search/DuplicateFilterTest.java",0,0.958083832335329,3,1,4
"contrib/queries/src/test/org/apache/lucene/search/FuzzyLikeThisQueryTest.java",0,0.904,2,2,4
"contrib/queries/src/test/org/apache/lucene/search/TermsFilterTest.java",0,0.781609195402299,2,2,4
"contrib/queries/src/test/org/apache/lucene/search/similar/TestMoreLikeThis.java",0,0.96875,2,1,3
"contrib/queryparser/src/java/org/apache/lucene/queryParser/core/QueryNodeError.java",0,1,0,1,1
"contrib/queryparser/src/java/org/apache/lucene/queryParser/core/QueryNodeException.java",0,0.966666666666667,1,1,2
"contrib/queryparser/src/java/org/apache/lucene/queryParser/core/QueryNodeParseException.java",0,0.991735537190083,1,1,2
"contrib/queryparser/src/java/org/apache/lucene/queryParser/core/QueryParserHelper.java",0,1,0,1,1
"contrib/queryparser/src/java/org/apache/lucene/queryParser/core/builders/QueryBuilder.java",0,1,0,1,1
"contrib/queryparser/src/java/org/apache/lucene/queryParser/core/builders/QueryTreeBuilder.java",0,0.986486486486487,2,1,3
"contrib/queryparser/src/java/org/apache/lucene/queryParser/core/config/FieldConfig.java",0,0.984615384615385,1,1,2
"contrib/queryparser/src/java/org/apache/lucene/queryParser/core/config/FieldConfigListener.java",0,0.552631578947368,0,2,2
"contrib/queryparser/src/java/org/apache/lucene/queryParser/core/config/QueryConfigHandler.java",0,1,0,1,1
"contrib/queryparser/src/java/org/apache/lucene/queryParser/core/messages/QueryParserMessages.java",0,1,0,1,1
"contrib/queryparser/src/java/org/apache/lucene/queryParser/core/nodes/AndQueryNode.java",0,0.974683544303797,1,1,2
"contrib/queryparser/src/java/org/apache/lucene/queryParser/core/nodes/AnyQueryNode.java",0,0.979452054794521,1,1,2
"contrib/queryparser/src/java/org/apache/lucene/queryParser/core/nodes/BooleanQueryNode.java",0,0.976470588235294,1,1,2
"contrib/queryparser/src/java/org/apache/lucene/queryParser/core/nodes/BoostQueryNode.java",0,0.967741935483871,2,1,3
"contrib/queryparser/src/java/org/apache/lucene/queryParser/core/nodes/DeletedQueryNode.java",0,0.962264150943396,1,1,2
"contrib/queryparser/src/java/org/apache/lucene/queryParser/core/nodes/FieldQueryNode.java",0,0.994594594594595,1,1,2
"contrib/queryparser/src/java/org/apache/lucene/queryParser/core/nodes/FieldableNode.java",0,1,0,1,1
"contrib/queryparser/src/java/org/apache/lucene/queryParser/core/nodes/FuzzyQueryNode.java",0,0.97029702970297,1,1,2
"contrib/queryparser/src/java/org/apache/lucene/queryParser/core/nodes/GroupQueryNode.java",0,0.964705882352941,2,1,3
"contrib/queryparser/src/java/org/apache/lucene/queryParser/core/nodes/MatchAllDocsQueryNode.java",0,0.96078431372549,1,1,2
"contrib/queryparser/src/java/org/apache/lucene/queryParser/core/nodes/MatchNoDocsQueryNode.java",0,0.973684210526316,1,1,2
"contrib/queryparser/src/java/org/apache/lucene/queryParser/core/nodes/ModifierQueryNode.java",0,0.9375,3,1,4
"contrib/queryparser/src/java/org/apache/lucene/queryParser/core/nodes/NoTokenFoundQueryNode.java",0,0.942307692307692,0,2,2
"contrib/queryparser/src/java/org/apache/lucene/queryParser/core/nodes/OpaqueQueryNode.java",0,0.975609756097561,1,1,2
"contrib/queryparser/src/java/org/apache/lucene/queryParser/core/nodes/OrQueryNode.java",0,0.975,1,1,2
"contrib/queryparser/src/java/org/apache/lucene/queryParser/core/nodes/ParametricQueryNode.java",0,0.75,0,2,2
"contrib/queryparser/src/java/org/apache/lucene/queryParser/core/nodes/ParametricRangeQueryNode.java",0,0.991735537190083,1,1,2
"contrib/queryparser/src/java/org/apache/lucene/queryParser/core/nodes/PathQueryNode.java",0,0.922727272727273,2,2,4
"contrib/queryparser/src/java/org/apache/lucene/queryParser/core/nodes/PhraseSlopQueryNode.java",0,0.963963963963964,2,1,3
"contrib/queryparser/src/java/org/apache/lucene/queryParser/core/nodes/ProximityQueryNode.java",0,0.921161825726141,2,2,4
"contrib/queryparser/src/java/org/apache/lucene/queryParser/core/nodes/QueryNode.java",0,1,0,1,1
"contrib/queryparser/src/java/org/apache/lucene/queryParser/core/nodes/QueryNodeImpl.java",0,0.986784140969163,2,1,3
"contrib/queryparser/src/java/org/apache/lucene/queryParser/core/nodes/QuotedFieldQueryNode.java",0,0.955223880597015,1,1,2
"contrib/queryparser/src/java/org/apache/lucene/queryParser/core/nodes/SlopQueryNode.java",0,0.966101694915254,2,1,3
"contrib/queryparser/src/java/org/apache/lucene/queryParser/core/nodes/TextableQueryNode.java",0,0.896551724137931,0,2,2
"contrib/queryparser/src/java/org/apache/lucene/queryParser/core/nodes/TokenizedPhraseQueryNode.java",0,0.971698113207547,2,1,3
"contrib/queryparser/src/java/org/apache/lucene/queryParser/core/parser/EscapeQuerySyntax.java",0,1,0,1,1
"contrib/queryparser/src/java/org/apache/lucene/queryParser/core/parser/SyntaxParser.java",0,1,0,1,1
"contrib/queryparser/src/java/org/apache/lucene/queryParser/core/processors/NoChildOptimizationQueryNodeProcessor.java",0,0.967741935483871,1,1,2
"contrib/queryparser/src/java/org/apache/lucene/queryParser/core/processors/QueryNodeProcessor.java",0,1,0,1,1
"contrib/queryparser/src/java/org/apache/lucene/queryParser/core/processors/QueryNodeProcessorImpl.java",0,1,0,1,1
"contrib/queryparser/src/java/org/apache/lucene/queryParser/core/processors/QueryNodeProcessorPipeline.java",0,1,0,1,1
"contrib/queryparser/src/java/org/apache/lucene/queryParser/core/processors/RemoveDeletedQueryNodesProcessor.java",0,0.964601769911504,1,1,2
"contrib/queryparser/src/java/org/apache/lucene/queryParser/core/util/QueryNodeOperation.java",0,1,0,1,1
"contrib/queryparser/src/java/org/apache/lucene/queryParser/core/util/UnescapedCharSequence.java",0,0.980891719745223,2,1,3
"contrib/queryparser/src/java/org/apache/lucene/queryParser/standard/MultiFieldQueryParserWrapper.java",0,0.988847583643123,1,1,2
"contrib/queryparser/src/java/org/apache/lucene/queryParser/standard/QueryParserUtil.java",0,0.893203883495146,2,2,4
"contrib/queryparser/src/java/org/apache/lucene/queryParser/standard/QueryParserWrapper.java",0,0.832644628099174,0,3,3
"contrib/queryparser/src/java/org/apache/lucene/queryParser/standard/StandardQueryParser.java",0,0.844547563805104,1,3,4
"contrib/queryparser/src/java/org/apache/lucene/queryParser/standard/builders/AnyQueryNodeBuilder.java",0,0.974025974025974,1,1,2
"contrib/queryparser/src/java/org/apache/lucene/queryParser/standard/builders/BooleanQueryNodeBuilder.java",0,0.954545454545455,2,1,3
"contrib/queryparser/src/java/org/apache/lucene/queryParser/standard/builders/BoostQueryNodeBuilder.java",0,0.962962962962963,1,1,2
"contrib/queryparser/src/java/org/apache/lucene/queryParser/standard/builders/FieldQueryNodeBuilder.java",0,0.953488372093023,1,1,2
"contrib/queryparser/src/java/org/apache/lucene/queryParser/standard/builders/FuzzyQueryNodeBuilder.java",0,0.954545454545455,1,1,2
"contrib/queryparser/src/java/org/apache/lucene/queryParser/standard/builders/GroupQueryNodeBuilder.java",0,0.955555555555556,1,1,2
"contrib/queryparser/src/java/org/apache/lucene/queryParser/standard/builders/MatchAllDocsQueryNodeBuilder.java",0,0.903846153846154,1,2,3
"contrib/queryparser/src/java/org/apache/lucene/queryParser/standard/builders/MatchNoDocsQueryNodeBuilder.java",0,0.903846153846154,1,2,3
"contrib/queryparser/src/java/org/apache/lucene/queryParser/standard/builders/ModifierQueryNodeBuilder.java",0,0.955555555555556,1,1,2
"contrib/queryparser/src/java/org/apache/lucene/queryParser/standard/builders/MultiPhraseQueryNodeBuilder.java",0,0.964285714285714,1,1,2
"contrib/queryparser/src/java/org/apache/lucene/queryParser/standard/builders/PhraseQueryNodeBuilder.java",0,0.96875,1,1,2
"contrib/queryparser/src/java/org/apache/lucene/queryParser/standard/builders/PrefixWildcardQueryNodeBuilder.java",0,0.943396226415094,0,2,2
"contrib/queryparser/src/java/org/apache/lucene/queryParser/standard/builders/RangeQueryNodeBuilder.java",0,0.956521739130435,1,1,2
"contrib/queryparser/src/java/org/apache/lucene/queryParser/standard/builders/SlopQueryNodeBuilder.java",0,0.964912280701754,1,1,2
"contrib/queryparser/src/java/org/apache/lucene/queryParser/standard/builders/StandardBooleanQueryNodeBuilder.java",0,0.926605504587156,1,2,3
"contrib/queryparser/src/java/org/apache/lucene/queryParser/standard/builders/StandardQueryBuilder.java",0,0.945945945945946,0,2,2
"contrib/queryparser/src/java/org/apache/lucene/queryParser/standard/builders/StandardQueryTreeBuilder.java",0,0.848101265822785,1,2,3
"contrib/queryparser/src/java/org/apache/lucene/queryParser/standard/builders/WildcardQueryNodeBuilder.java",0,0.903846153846154,0,2,2
"contrib/queryparser/src/java/org/apache/lucene/queryParser/standard/config/AllowLeadingWildcardAttribute.java",0,0.939393939393939,0,2,2
"contrib/queryparser/src/java/org/apache/lucene/queryParser/standard/config/AllowLeadingWildcardAttributeImpl.java",0,0.888888888888889,1,2,3
"contrib/queryparser/src/java/org/apache/lucene/queryParser/standard/config/AnalyzerAttribute.java",0,0.942857142857143,0,2,2
"contrib/queryparser/src/java/org/apache/lucene/queryParser/standard/config/AnalyzerAttributeImpl.java",0,0.91304347826087,1,2,3
"contrib/queryparser/src/java/org/apache/lucene/queryParser/standard/config/BoostAttribute.java",0,0.942857142857143,0,2,2
"contrib/queryparser/src/java/org/apache/lucene/queryParser/standard/config/BoostAttributeImpl.java",0,0.906976744186046,1,2,3
"contrib/queryparser/src/java/org/apache/lucene/queryParser/standard/config/DateResolutionAttribute.java",0,0.930232558139535,0,2,2
"contrib/queryparser/src/java/org/apache/lucene/queryParser/standard/config/DateResolutionAttributeImpl.java",0,0.91304347826087,1,2,3
"contrib/queryparser/src/java/org/apache/lucene/queryParser/standard/config/DefaultOperatorAttribute.java",0,0.948717948717949,0,2,2
"contrib/queryparser/src/java/org/apache/lucene/queryParser/standard/config/DefaultOperatorAttributeImpl.java",0,0.914893617021277,1,2,3
"contrib/queryparser/src/java/org/apache/lucene/queryParser/standard/config/DefaultPhraseSlopAttribute.java",0,0.941176470588235,0,2,2
"contrib/queryparser/src/java/org/apache/lucene/queryParser/standard/config/DefaultPhraseSlopAttributeImpl.java",0,0.908045977011494,1,2,3
"contrib/queryparser/src/java/org/apache/lucene/queryParser/standard/config/FieldBoostMapAttribute.java",0,0.971428571428571,1,1,2
"contrib/queryparser/src/java/org/apache/lucene/queryParser/standard/config/FieldBoostMapAttributeImpl.java",0,0.914893617021277,1,2,3
"contrib/queryparser/src/java/org/apache/lucene/queryParser/standard/config/FieldBoostMapFCListener.java",0,0.949152542372881,2,1,3
"contrib/queryparser/src/java/org/apache/lucene/queryParser/standard/config/FieldDateResolutionFCListener.java",0,0.851351351351351,1,2,3
"contrib/queryparser/src/java/org/apache/lucene/queryParser/standard/config/FieldDateResolutionMapAttribute.java",0,0.971428571428571,1,1,2
"contrib/queryparser/src/java/org/apache/lucene/queryParser/standard/config/FieldDateResolutionMapAttributeImpl.java",0,0.934065934065934,1,2,3
"contrib/queryparser/src/java/org/apache/lucene/queryParser/standard/config/FuzzyAttribute.java",0,0.944444444444444,0,2,2
"contrib/queryparser/src/java/org/apache/lucene/queryParser/standard/config/FuzzyAttributeImpl.java",0,0.916666666666667,1,2,3
"contrib/queryparser/src/java/org/apache/lucene/queryParser/standard/config/LocaleAttribute.java",0,0.942857142857143,0,2,2
"contrib/queryparser/src/java/org/apache/lucene/queryParser/standard/config/LocaleAttributeImpl.java",0,0.91304347826087,1,2,3
"contrib/queryparser/src/java/org/apache/lucene/queryParser/standard/config/LowercaseExpandedTermsAttribute.java",0,0.942857142857143,0,2,2
"contrib/queryparser/src/java/org/apache/lucene/queryParser/standard/config/LowercaseExpandedTermsAttributeImpl.java",0,0.908045977011494,1,2,3
"contrib/queryparser/src/java/org/apache/lucene/queryParser/standard/config/MultiFieldAttribute.java",0,0.939393939393939,0,2,2
"contrib/queryparser/src/java/org/apache/lucene/queryParser/standard/config/MultiFieldAttributeImpl.java",0,0.906976744186046,1,2,3
"contrib/queryparser/src/java/org/apache/lucene/queryParser/standard/config/MultiTermRewriteMethodAttribute.java",0,0.95,0,2,2
"contrib/queryparser/src/java/org/apache/lucene/queryParser/standard/config/MultiTermRewriteMethodAttributeImpl.java",0,0.920454545454545,1,2,3
"contrib/queryparser/src/java/org/apache/lucene/queryParser/standard/config/PositionIncrementsAttribute.java",0,0.939393939393939,0,2,2
"contrib/queryparser/src/java/org/apache/lucene/queryParser/standard/config/PositionIncrementsAttributeImpl.java",0,0.906976744186046,1,2,3
"contrib/queryparser/src/java/org/apache/lucene/queryParser/standard/config/RangeCollatorAttribute.java",0,0.945945945945946,0,2,2
"contrib/queryparser/src/java/org/apache/lucene/queryParser/standard/config/RangeCollatorAttributeImpl.java",0,0.914893617021277,1,2,3
"contrib/queryparser/src/java/org/apache/lucene/queryParser/standard/config/StandardQueryConfigHandler.java",0,0.890909090909091,0,2,2
"contrib/queryparser/src/java/org/apache/lucene/queryParser/standard/nodes/BooleanModifierNode.java",0,0.948717948717949,0,2,2
"contrib/queryparser/src/java/org/apache/lucene/queryParser/standard/nodes/MultiPhraseQueryNode.java",0,0.972727272727273,2,1,3
"contrib/queryparser/src/java/org/apache/lucene/queryParser/standard/nodes/PrefixWildcardQueryNode.java",0,0.969230769230769,1,1,2
"contrib/queryparser/src/java/org/apache/lucene/queryParser/standard/nodes/RangeQueryNode.java",0,0.928571428571429,3,1,4
"contrib/queryparser/src/java/org/apache/lucene/queryParser/standard/nodes/StandardBooleanQueryNode.java",0,0.927272727272727,0,2,2
"contrib/queryparser/src/java/org/apache/lucene/queryParser/standard/nodes/WildcardQueryNode.java",0,0.958333333333333,1,1,2
"contrib/queryparser/src/java/org/apache/lucene/queryParser/standard/parser/EscapeQuerySyntaxImpl.java",0,0.986486486486487,3,1,4
"contrib/queryparser/src/java/org/apache/lucene/queryParser/standard/parser/JavaCharStream.java",0,0.99837925445705,1,1,2
"contrib/queryparser/src/java/org/apache/lucene/queryParser/standard/parser/ParseException.java",0,0.974619289340102,2,1,3
"contrib/queryparser/src/java/org/apache/lucene/queryParser/standard/parser/StandardSyntaxParser.java",0,0.985327313769752,2,1,3
"contrib/queryparser/src/java/org/apache/lucene/queryParser/standard/parser/StandardSyntaxParserConstants.java",0,0.974137931034483,1,1,2
"contrib/queryparser/src/java/org/apache/lucene/queryParser/standard/parser/StandardSyntaxParserTokenManager.java",0,0.994520547945206,1,1,2
"contrib/queryparser/src/java/org/apache/lucene/queryParser/standard/parser/Token.java",0,0.99236641221374,1,1,2
"contrib/queryparser/src/java/org/apache/lucene/queryParser/standard/parser/TokenMgrError.java",0,0.993197278911565,1,1,2
"contrib/queryparser/src/java/org/apache/lucene/queryParser/standard/processors/AllowLeadingWildcardProcessor.java",0,0.904761904761905,3,1,4
"contrib/queryparser/src/java/org/apache/lucene/queryParser/standard/processors/AnalyzerQueryNodeProcessor.java",0,0.935672514619883,3,1,4
"contrib/queryparser/src/java/org/apache/lucene/queryParser/standard/processors/BooleanSingleChildOptimizationQueryNodeProcessor.java",0,0.945054945054945,2,1,3
"contrib/queryparser/src/java/org/apache/lucene/queryParser/standard/processors/BoostQueryNodeProcessor.java",0,0.964285714285714,2,1,3
"contrib/queryparser/src/java/org/apache/lucene/queryParser/standard/processors/DefaultPhraseSlopQueryNodeProcessor.java",0,0.923728813559322,3,1,4
"contrib/queryparser/src/java/org/apache/lucene/queryParser/standard/processors/FuzzyQueryNodeProcessor.java",0,0.964705882352941,2,1,3
"contrib/queryparser/src/java/org/apache/lucene/queryParser/standard/processors/GroupQueryNodeProcessor.java",0,0.967741935483871,2,1,3
"contrib/queryparser/src/java/org/apache/lucene/queryParser/standard/processors/LowercaseExpandedTermsQueryNodeProcessor.java",0,0.887755102040816,2,2,4
"contrib/queryparser/src/java/org/apache/lucene/queryParser/standard/processors/MatchAllDocsQueryNodeProcessor.java",0,0.948051948051948,2,1,3
"contrib/queryparser/src/java/org/apache/lucene/queryParser/standard/processors/MultiFieldQueryNodeProcessor.java",0,0.940740740740741,3,1,4
"contrib/queryparser/src/java/org/apache/lucene/queryParser/standard/processors/MultiTermRewriteMethodProcessor.java",0,0.662162162162162,1,2,3
"contrib/queryparser/src/java/org/apache/lucene/queryParser/standard/processors/ParametricRangeQueryNodeProcessor.java",0,0.891304347826087,2,2,4
"contrib/queryparser/src/java/org/apache/lucene/queryParser/standard/processors/PhraseSlopQueryNodeProcessor.java",0,0.932432432432432,2,1,3
"contrib/queryparser/src/java/org/apache/lucene/queryParser/standard/processors/RemoveEmptyNonLeafQueryNodeProcessor.java",0,0.956896551724138,2,1,3
"contrib/queryparser/src/java/org/apache/lucene/queryParser/standard/processors/StandardQueryNodeProcessorPipeline.java",0,0.828571428571429,0,2,2
"contrib/queryparser/src/java/org/apache/lucene/queryParser/standard/processors/WildcardQueryNodeProcessor.java",0,0.97841726618705,1,1,2
"contrib/queryparser/src/test/org/apache/lucene/queryParser/spans/SpanOrQueryNodeBuilder.java",0,0.964285714285714,1,1,2
"contrib/queryparser/src/test/org/apache/lucene/queryParser/spans/SpanTermQueryNodeBuilder.java",0,0.951219512195122,1,1,2
"contrib/queryparser/src/test/org/apache/lucene/queryParser/spans/SpansQueryConfigHandler.java",0,1,0,1,1
"contrib/queryparser/src/test/org/apache/lucene/queryParser/spans/SpansQueryTreeBuilder.java",0,0.942307692307692,2,1,3
"contrib/queryparser/src/test/org/apache/lucene/queryParser/spans/SpansValidatorQueryNodeProcessor.java",0,1,0,1,1
"contrib/queryparser/src/test/org/apache/lucene/queryParser/spans/TestSpanQueryParser.java",0,0.948936170212766,2,1,3
"contrib/queryparser/src/test/org/apache/lucene/queryParser/spans/TestSpanQueryParserSimpleSample.java",0,0.961290322580645,2,1,3
"contrib/queryparser/src/test/org/apache/lucene/queryParser/spans/UniqueFieldAttribute.java",0,1,0,1,1
"contrib/queryparser/src/test/org/apache/lucene/queryParser/spans/UniqueFieldAttributeImpl.java",0,1,0,1,1
"contrib/queryparser/src/test/org/apache/lucene/queryParser/spans/UniqueFieldQueryNodeProcessor.java",0,0.976190476190476,1,1,2
"contrib/queryparser/src/test/org/apache/lucene/queryParser/standard/TestMultiAnalyzerQPHelper.java",0,0.932075471698113,3,1,4
"contrib/queryparser/src/test/org/apache/lucene/queryParser/standard/TestMultiAnalyzerWrapper.java",0,0.942084942084942,3,1,4
"contrib/queryparser/src/test/org/apache/lucene/queryParser/standard/TestMultiFieldQPHelper.java",0,0.902702702702703,2,2,4
"contrib/queryparser/src/test/org/apache/lucene/queryParser/standard/TestMultiFieldQueryParserWrapper.java",0,0.918478260869565,2,2,4
"contrib/queryparser/src/test/org/apache/lucene/queryParser/standard/TestQPHelper.java",0,0.881818181818182,2,2,4
"contrib/queryparser/src/test/org/apache/lucene/queryParser/standard/TestQueryParserWrapper.java",0,0.954946996466431,3,1,4
"contrib/regex/src/java/org/apache/lucene/search/regex/JakartaRegexpCapabilities.java",0,0.56043956043956,2,3,5
"contrib/regex/src/java/org/apache/lucene/search/regex/JavaUtilRegexCapabilities.java",0,0.505154639175258,3,3,6
"contrib/regex/src/java/org/apache/lucene/search/regex/RegexCapabilities.java",0,0.875,0,2,2
"contrib/regex/src/java/org/apache/lucene/search/regex/RegexQuery.java",0,0.731958762886598,1,3,4
"contrib/regex/src/java/org/apache/lucene/search/regex/RegexQueryCapable.java",0,0.777777777777778,0,2,2
"contrib/regex/src/java/org/apache/lucene/search/regex/RegexTermEnum.java",0,0.879518072289157,1,2,3
"contrib/regex/src/java/org/apache/lucene/search/regex/SpanRegexQuery.java",0,0.877862595419847,4,1,5
"contrib/regex/src/java/org/apache/regexp/RegexpTunnel.java",0,0.793103448275862,0,2,2
"contrib/regex/src/test/org/apache/lucene/search/regex/TestRegexQuery.java",0,0.644444444444444,4,2,6
"contrib/regex/src/test/org/apache/lucene/search/regex/TestSpanRegexQuery.java",0,0.6,2,3,5
"contrib/remote/src/java/org/apache/lucene/search/RMIRemoteSearchable.java",0,0.956521739130435,1,1,2
"contrib/remote/src/java/org/apache/lucene/search/RemoteCachingWrapperFilter.java",0,0.728813559322034,2,3,5
"contrib/remote/src/java/org/apache/lucene/search/RemoteSearchable.java",0,0.521008403361345,3,5,8
"contrib/remote/src/test/org/apache/lucene/search/RemoteCachingWrapperFilterHelper.java",0,0.95,2,1,3
"contrib/remote/src/test/org/apache/lucene/search/TestRemoteCachingWrapperFilter.java",0,0.796992481203007,1,3,4
"contrib/remote/src/test/org/apache/lucene/search/TestRemoteSearchable.java",0,0.439716312056738,2,6,8
"contrib/remote/src/test/org/apache/lucene/search/TestRemoteSort.java",0,0.893095768374165,2,2,4
"contrib/snowball/src/java/org/apache/lucene/analysis/snowball/SnowballAnalyzer.java",0,0.39047619047619,4,4,8
"contrib/snowball/src/java/org/apache/lucene/analysis/snowball/SnowballFilter.java",0,0.432098765432099,3,4,7
"contrib/snowball/src/java/org/tartarus/snowball/Among.java",0,0.484375,2,2,4
"contrib/snowball/src/java/org/tartarus/snowball/SnowballProgram.java",0,0.866812227074236,1,2,3
"contrib/snowball/src/java/org/tartarus/snowball/TestApp.java",0,0.981481481481482,1,1,2
"contrib/snowball/src/java/org/tartarus/snowball/ext/DanishStemmer.java",0,0.770685579196217,0,2,2
"contrib/snowball/src/java/org/tartarus/snowball/ext/DutchStemmer.java",0,0.996415770609319,1,1,2
"contrib/snowball/src/java/org/tartarus/snowball/ext/EnglishStemmer.java",0,0.700913242009132,0,2,2
"contrib/snowball/src/java/org/tartarus/snowball/ext/FinnishStemmer.java",0,0.981624758220503,1,1,2
"contrib/snowball/src/java/org/tartarus/snowball/ext/FrenchStemmer.java",0,0.784810126582278,0,2,2
"contrib/snowball/src/java/org/tartarus/snowball/ext/German2Stemmer.java",0,0.831955922865014,0,2,2
"contrib/snowball/src/java/org/tartarus/snowball/ext/GermanStemmer.java",0,0.822674418604651,0,2,2
"contrib/snowball/src/java/org/tartarus/snowball/ext/HungarianStemmer.java",0,1,0,1,1
"contrib/snowball/src/java/org/tartarus/snowball/ext/ItalianStemmer.java",0,0.898305084745763,0,2,2
"contrib/snowball/src/java/org/tartarus/snowball/ext/KpStemmer.java",0,0.998165978908757,1,1,2
"contrib/snowball/src/java/org/tartarus/snowball/ext/LovinsStemmer.java",0,0.935010482180293,1,2,3
"contrib/snowball/src/java/org/tartarus/snowball/ext/NorwegianStemmer.java",0,0.720670391061452,0,2,2
"contrib/snowball/src/java/org/tartarus/snowball/ext/PorterStemmer.java",0,0.996688741721854,1,1,2
"contrib/snowball/src/java/org/tartarus/snowball/ext/PortugueseStemmer.java",0,0.861111111111111,1,2,3
"contrib/snowball/src/java/org/tartarus/snowball/ext/RomanianStemmer.java",0,1,0,1,1
"contrib/snowball/src/java/org/tartarus/snowball/ext/RussianStemmer.java",0,0.635488308115543,0,2,2
"contrib/snowball/src/java/org/tartarus/snowball/ext/SpanishStemmer.java",0,0.879864636209814,0,2,2
"contrib/snowball/src/java/org/tartarus/snowball/ext/SwedishStemmer.java",0,0.925501432664756,0,2,2
"contrib/snowball/src/java/org/tartarus/snowball/ext/TurkishStemmer.java",0,1,0,1,1
"contrib/snowball/src/test/org/apache/lucene/analysis/snowball/TestSnowball.java",0,0.322314049586777,0,6,6
"contrib/spatial/src/java/org/apache/lucene/spatial/geohash/GeoHashDistanceFilter.java",0,0.638461538461538,2,2,4
"contrib/spatial/src/java/org/apache/lucene/spatial/geohash/GeoHashUtils.java",0,0.977011494252874,1,1,2
"contrib/spatial/src/java/org/apache/lucene/spatial/geometry/CartesianPoint.java",0,0.63855421686747,1,2,3
"contrib/spatial/src/java/org/apache/lucene/spatial/geometry/DistanceUnits.java",0,0.821428571428571,0,2,2
"contrib/spatial/src/java/org/apache/lucene/spatial/geometry/FixedLatLng.java",0,0.8125,1,2,3
"contrib/spatial/src/java/org/apache/lucene/spatial/geometry/FloatLatLng.java",0,0.762237762237762,2,2,4
"contrib/spatial/src/java/org/apache/lucene/spatial/geometry/LatLng.java",0,0.925,4,1,5
"contrib/spatial/src/java/org/apache/lucene/spatial/geometry/shape/DistanceApproximation.java",0,0.944,2,1,3
"contrib/spatial/src/java/org/apache/lucene/spatial/geometry/shape/Ellipse.java",0,0.978632478632479,2,1,3
"contrib/spatial/src/java/org/apache/lucene/spatial/geometry/shape/Geometry2D.java",0,0.929824561403509,0,2,2
"contrib/spatial/src/java/org/apache/lucene/spatial/geometry/shape/IntersectCase.java",0,0.806451612903226,0,2,2
"contrib/spatial/src/java/org/apache/lucene/spatial/geometry/shape/LLRect.java",0,0.429319371727749,0,3,3
"contrib/spatial/src/java/org/apache/lucene/spatial/geometry/shape/LineSegment.java",0,0.683760683760684,2,2,4
"contrib/spatial/src/java/org/apache/lucene/spatial/geometry/shape/Point2D.java",0,0.766423357664234,1,2,3
"contrib/spatial/src/java/org/apache/lucene/spatial/geometry/shape/Rectangle.java",0,0.7265625,1,2,3
"contrib/spatial/src/java/org/apache/lucene/spatial/geometry/shape/Vector2D.java",0,0.779310344827586,1,2,3
"contrib/spatial/src/java/org/apache/lucene/spatial/tier/CartesianPolyFilterBuilder.java",0,0.572327044025157,0,2,2
"contrib/spatial/src/java/org/apache/lucene/spatial/tier/CartesianShapeFilter.java",0,0.692307692307692,0,3,3
"contrib/spatial/src/java/org/apache/lucene/spatial/tier/DistanceFieldComparatorSource.java",0,0.930232558139535,0,2,2
"contrib/spatial/src/java/org/apache/lucene/spatial/tier/DistanceFilter.java",0,0.621621621621622,1,3,4
"contrib/spatial/src/java/org/apache/lucene/spatial/tier/DistanceHandler.java",0,0.894230769230769,2,2,4
"contrib/spatial/src/java/org/apache/lucene/spatial/tier/DistanceQueryBuilder.java",0,0.696551724137931,1,2,3
"contrib/spatial/src/java/org/apache/lucene/spatial/tier/DistanceUtils.java",0,0.925373134328358,0,2,2
"contrib/spatial/src/java/org/apache/lucene/spatial/tier/InvalidGeoException.java",0,0.857142857142857,0,2,2
"contrib/spatial/src/java/org/apache/lucene/spatial/tier/LatLongDistanceFilter.java",0,0.602941176470588,3,2,5
"contrib/spatial/src/java/org/apache/lucene/spatial/tier/Shape.java",0,0.905660377358491,1,2,3
"contrib/spatial/src/java/org/apache/lucene/spatial/tier/projections/CartesianTierPlotter.java",0,0.951219512195122,3,1,4
"contrib/spatial/src/java/org/apache/lucene/spatial/tier/projections/IProjector.java",0,0.821428571428571,0,2,2
"contrib/spatial/src/java/org/apache/lucene/spatial/tier/projections/SinusoidalProjector.java",0,0.886363636363636,1,2,3
"contrib/spatial/src/test/org/apache/lucene/spatial/tier/DistanceCheck.java",0,1,0,1,1
"contrib/spatial/src/test/org/apache/lucene/spatial/tier/PolyShape.java",0,1,0,1,1
"contrib/spatial/src/test/org/apache/lucene/spatial/tier/TestCartesian.java",0,0.580769230769231,3,3,6
"contrib/spatial/src/test/org/apache/lucene/spatial/tier/TestCartesianShapeFilter.java",0,1,0,1,1
"contrib/spatial/src/test/org/apache/lucene/spatial/tier/TestDistance.java",0,0.797202797202797,1,2,3
"contrib/spellchecker/src/java/org/apache/lucene/search/spell/Dictionary.java",0,0.571428571428571,2,4,6
"contrib/spellchecker/src/java/org/apache/lucene/search/spell/JaroWinklerDistance.java",0,0.991071428571429,1,1,2
"contrib/spellchecker/src/java/org/apache/lucene/search/spell/LevensteinDistance.java",0,0.532110091743119,1,4,5
"contrib/spellchecker/src/java/org/apache/lucene/search/spell/LuceneDictionary.java",0,0.263636363636364,3,5,8
"contrib/spellchecker/src/java/org/apache/lucene/search/spell/NGramDistance.java",0,1,0,1,1
"contrib/spellchecker/src/java/org/apache/lucene/search/spell/PlainTextDictionary.java",0,0.378048780487805,1,5,6
"contrib/spellchecker/src/java/org/apache/lucene/search/spell/SpellChecker.java",0,0.645631067961165,5,3,8
"contrib/spellchecker/src/java/org/apache/lucene/search/spell/StringDistance.java",0,0.971428571428571,1,1,2
"contrib/spellchecker/src/java/org/apache/lucene/search/spell/SuggestWord.java",0,0.540983606557377,2,3,5
"contrib/spellchecker/src/java/org/apache/lucene/search/spell/SuggestWordQueue.java",0,0.461538461538462,2,4,6
"contrib/spellchecker/src/test/org/apache/lucene/search/spell/TestJaroWinklerDistance.java",0,1,0,1,1
"contrib/spellchecker/src/test/org/apache/lucene/search/spell/TestLevenshteinDistance.java",0,0.740740740740741,0,3,3
"contrib/spellchecker/src/test/org/apache/lucene/search/spell/TestLuceneDictionary.java",0,0.935323383084577,3,1,4
"contrib/spellchecker/src/test/org/apache/lucene/search/spell/TestNGramDistance.java",0,1,0,1,1
"contrib/spellchecker/src/test/org/apache/lucene/search/spell/TestPlainTextDictionary.java",0,1,0,1,1
"contrib/spellchecker/src/test/org/apache/lucene/search/spell/TestSpellChecker.java",0,0.240196078431373,2,7,9
"contrib/surround/src/java/org/apache/lucene/queryParser/surround/parser/CharStream.java",0,0.839285714285714,0,2,2
"contrib/surround/src/java/org/apache/lucene/queryParser/surround/parser/FastCharStream.java",0,0.950413223140496,1,1,2
"contrib/surround/src/java/org/apache/lucene/queryParser/surround/parser/ParseException.java",0,0.929292929292929,0,2,2
"contrib/surround/src/java/org/apache/lucene/queryParser/surround/parser/QueryParser.java",0,0.949659863945578,0,2,2
"contrib/surround/src/java/org/apache/lucene/queryParser/surround/parser/QueryParserConstants.java",0,0.659340659340659,0,2,2
"contrib/surround/src/java/org/apache/lucene/queryParser/surround/parser/QueryParserTokenManager.java",0,0.875350140056022,0,2,2
"contrib/surround/src/java/org/apache/lucene/queryParser/surround/parser/Token.java",0,0.556451612903226,0,2,2
"contrib/surround/src/java/org/apache/lucene/queryParser/surround/parser/TokenMgrError.java",0,0.865248226950355,0,2,2
"contrib/surround/src/java/org/apache/lucene/queryParser/surround/query/AndQuery.java",0,0.764705882352941,2,2,4
"contrib/surround/src/java/org/apache/lucene/queryParser/surround/query/BasicQueryFactory.java",0,0.907692307692308,0,2,2
"contrib/surround/src/java/org/apache/lucene/queryParser/surround/query/ComposedQuery.java",0,0.87603305785124,2,2,4
"contrib/surround/src/java/org/apache/lucene/queryParser/surround/query/DistanceQuery.java",0,0.917355371900826,3,1,4
"contrib/surround/src/java/org/apache/lucene/queryParser/surround/query/DistanceSubQuery.java",0,0.806451612903226,0,2,2
"contrib/surround/src/java/org/apache/lucene/queryParser/surround/query/FieldsQuery.java",0,0.783505154639175,1,3,4
"contrib/surround/src/java/org/apache/lucene/queryParser/surround/query/NotQuery.java",0,0.743589743589744,1,3,4
"contrib/surround/src/java/org/apache/lucene/queryParser/surround/query/OrQuery.java",0,0.868852459016393,2,2,4
"contrib/surround/src/java/org/apache/lucene/queryParser/surround/query/SimpleTerm.java",0,0.817391304347826,2,3,5
"contrib/surround/src/java/org/apache/lucene/queryParser/surround/query/SpanNearClauseFactory.java",0,0.900709219858156,1,2,3
"contrib/surround/src/java/org/apache/lucene/queryParser/surround/query/SrndBooleanQuery.java",0,0.8,0,3,3
"contrib/surround/src/java/org/apache/lucene/queryParser/surround/query/SrndPrefixQuery.java",0,0.87012987012987,2,2,4
"contrib/surround/src/java/org/apache/lucene/queryParser/surround/query/SrndQuery.java",0,0.837209302325581,2,3,5
"contrib/surround/src/java/org/apache/lucene/queryParser/surround/query/SrndTermQuery.java",0,0.848484848484849,2,2,4
"contrib/surround/src/java/org/apache/lucene/queryParser/surround/query/SrndTruncQuery.java",0,0.912280701754386,2,2,4
"contrib/surround/src/java/org/apache/lucene/queryParser/surround/query/TooManyBasicQueries.java",0,0.777777777777778,0,2,2
"contrib/surround/src/test/org/apache/lucene/queryParser/surround/query/BooleanQueryTst.java",0,0.607407407407407,1,4,5
"contrib/surround/src/test/org/apache/lucene/queryParser/surround/query/ExceptionQueryTst.java",0,0.621212121212121,1,3,4
"contrib/surround/src/test/org/apache/lucene/queryParser/surround/query/SingleFieldTestDb.java",0,0.631578947368421,0,3,3
"contrib/surround/src/test/org/apache/lucene/queryParser/surround/query/Test01Exceptions.java",0,0.72463768115942,1,2,3
"contrib/surround/src/test/org/apache/lucene/queryParser/surround/query/Test02Boolean.java",0,0.852459016393443,1,2,3
"contrib/surround/src/test/org/apache/lucene/queryParser/surround/query/Test03Distance.java",0,0.772727272727273,1,3,4
"contrib/swing/src/java/org/apache/lucene/swing/models/ListSearcher.java",0,0.831715210355987,4,2,6
"contrib/swing/src/java/org/apache/lucene/swing/models/TableSearcher.java",0,0.905555555555556,4,2,6
"contrib/swing/src/test/org/apache/lucene/swing/models/BaseListModel.java",0,1,0,1,1
"contrib/swing/src/test/org/apache/lucene/swing/models/BaseTableModel.java",0,0.961538461538462,1,1,2
"contrib/swing/src/test/org/apache/lucene/swing/models/DataStore.java",0,1,0,1,1
"contrib/swing/src/test/org/apache/lucene/swing/models/ListSearcherSimulator.java",0,1,0,1,1
"contrib/swing/src/test/org/apache/lucene/swing/models/RestaurantInfo.java",0,0.99009900990099,1,1,2
"contrib/swing/src/test/org/apache/lucene/swing/models/TableSearcherSimulator.java",0,1,0,1,1
"contrib/swing/src/test/org/apache/lucene/swing/models/TestBasicList.java",0,0.981132075471698,1,1,2
"contrib/swing/src/test/org/apache/lucene/swing/models/TestBasicTable.java",0,0.983050847457627,1,1,2
"contrib/swing/src/test/org/apache/lucene/swing/models/TestSearchingList.java",0,0.978260869565217,1,1,2
"contrib/swing/src/test/org/apache/lucene/swing/models/TestSearchingTable.java",0,0.977777777777778,1,1,2
"contrib/swing/src/test/org/apache/lucene/swing/models/TestUpdatingList.java",0,0.987179487179487,1,1,2
"contrib/swing/src/test/org/apache/lucene/swing/models/TestUpdatingTable.java",0,0.987179487179487,1,1,2
"contrib/wikipedia/src/java/org/apache/lucene/wikipedia/analysis/WikipediaTokenizer.java",0,0.575851393188854,2,4,6
"contrib/wikipedia/src/java/org/apache/lucene/wikipedia/analysis/WikipediaTokenizerImpl.java",0,0.974332648870637,3,1,4
"contrib/wikipedia/src/test/org/apache/lucene/wikipedia/analysis/WikipediaTokenizerTest.java",0,0.651459854014598,1,2,3
"contrib/wordnet/src/java/org/apache/lucene/wordnet/AnalyzerUtil.java",0,0.668103448275862,3,3,6
"contrib/wordnet/src/java/org/apache/lucene/wordnet/SynExpand.java",0,0.461111111111111,2,4,6
"contrib/wordnet/src/java/org/apache/lucene/wordnet/SynLookup.java",0,0.454545454545455,2,4,6
"contrib/wordnet/src/java/org/apache/lucene/wordnet/SynonymMap.java",0,0.684343434343434,2,3,5
"contrib/wordnet/src/java/org/apache/lucene/wordnet/SynonymTokenFilter.java",0,0.539473684210526,3,4,7
"contrib/wordnet/src/java/org/apache/lucene/wordnet/Syns2Index.java",0,0.559748427672956,4,4,8
"contrib/wordnet/src/test/org/apache/lucene/wordnet/TestSynonymTokenFilter.java",0,0.984251968503937,1,1,2
"contrib/wordnet/src/test/org/apache/lucene/wordnet/TestWordnet.java",0,1,0,1,1
"contrib/xml-query-parser/src/demo/java/org/apache/lucene/xmlparser/webdemo/FormBasedXmlQueryDemo.java",0,0.861842105263158,2,2,4
"contrib/xml-query-parser/src/java/org/apache/lucene/xmlparser/CoreParser.java",0,0.964497041420118,1,1,2
"contrib/xml-query-parser/src/java/org/apache/lucene/xmlparser/CorePlusExtensionsParser.java",0,0.924242424242424,0,2,2
"contrib/xml-query-parser/src/java/org/apache/lucene/xmlparser/DOMUtils.java",0,0.978571428571429,2,1,3
"contrib/xml-query-parser/src/java/org/apache/lucene/xmlparser/FilterBuilder.java",0,0.9,0,2,2
"contrib/xml-query-parser/src/java/org/apache/lucene/xmlparser/FilterBuilderFactory.java",0,0.88,0,3,3
"contrib/xml-query-parser/src/java/org/apache/lucene/xmlparser/ParserException.java",0,0.942307692307692,0,2,2
"contrib/xml-query-parser/src/java/org/apache/lucene/xmlparser/QueryBuilder.java",0,1,0,1,1
"contrib/xml-query-parser/src/java/org/apache/lucene/xmlparser/QueryBuilderFactory.java",0,0.882352941176471,0,3,3
"contrib/xml-query-parser/src/java/org/apache/lucene/xmlparser/QueryTemplateManager.java",0,0.985781990521327,1,1,2
"contrib/xml-query-parser/src/java/org/apache/lucene/xmlparser/builders/BooleanFilterBuilder.java",0,0.955223880597015,1,1,2
"contrib/xml-query-parser/src/java/org/apache/lucene/xmlparser/builders/BooleanQueryBuilder.java",0,0.970588235294118,1,1,2
"contrib/xml-query-parser/src/java/org/apache/lucene/xmlparser/builders/BoostingQueryBuilder.java",0,0.95,0,2,2
"contrib/xml-query-parser/src/java/org/apache/lucene/xmlparser/builders/BoostingTermBuilder.java",0,0.847826086956522,0,3,3
"contrib/xml-query-parser/src/java/org/apache/lucene/xmlparser/builders/CachedFilterBuilder.java",0,0.953846153846154,2,1,3
"contrib/xml-query-parser/src/java/org/apache/lucene/xmlparser/builders/ConstantScoreQueryBuilder.java",0,0.92,0,2,2
"contrib/xml-query-parser/src/java/org/apache/lucene/xmlparser/builders/DuplicateFilterBuilder.java",0,0.960526315789474,1,1,2
"contrib/xml-query-parser/src/java/org/apache/lucene/xmlparser/builders/FilteredQueryBuilder.java",0,0.953125,1,1,2
"contrib/xml-query-parser/src/java/org/apache/lucene/xmlparser/builders/FuzzyLikeThisQueryBuilder.java",0,0.939393939393939,0,2,2
"contrib/xml-query-parser/src/java/org/apache/lucene/xmlparser/builders/LikeThisQueryBuilder.java",0,0.921052631578947,3,1,4
"contrib/xml-query-parser/src/java/org/apache/lucene/xmlparser/builders/MatchAllDocsQueryBuilder.java",0,0.882352941176471,0,2,2
"contrib/xml-query-parser/src/java/org/apache/lucene/xmlparser/builders/RangeFilterBuilder.java",0,0.893617021276596,1,2,3
"contrib/xml-query-parser/src/java/org/apache/lucene/xmlparser/builders/SpanBuilderBase.java",0,0.878787878787879,0,2,2
"contrib/xml-query-parser/src/java/org/apache/lucene/xmlparser/builders/SpanFirstBuilder.java",0,0.92,0,2,2
"contrib/xml-query-parser/src/java/org/apache/lucene/xmlparser/builders/SpanNearBuilder.java",0,0.894736842105263,1,2,3
"contrib/xml-query-parser/src/java/org/apache/lucene/xmlparser/builders/SpanNotBuilder.java",0,0.931034482758621,0,2,2
"contrib/xml-query-parser/src/java/org/apache/lucene/xmlparser/builders/SpanOrBuilder.java",0,0.898305084745763,1,2,3
"contrib/xml-query-parser/src/java/org/apache/lucene/xmlparser/builders/SpanOrTermsBuilder.java",0,0.853333333333333,1,3,4
"contrib/xml-query-parser/src/java/org/apache/lucene/xmlparser/builders/SpanQueryBuilder.java",0,1,0,1,1
"contrib/xml-query-parser/src/java/org/apache/lucene/xmlparser/builders/SpanQueryBuilderFactory.java",0,0.9,1,2,3
"contrib/xml-query-parser/src/java/org/apache/lucene/xmlparser/builders/SpanTermBuilder.java",0,0.906976744186046,0,2,2
"contrib/xml-query-parser/src/java/org/apache/lucene/xmlparser/builders/TermQueryBuilder.java",0,0.930232558139535,0,2,2
"contrib/xml-query-parser/src/java/org/apache/lucene/xmlparser/builders/TermsFilterBuilder.java",0,0.892857142857143,2,2,4
"contrib/xml-query-parser/src/java/org/apache/lucene/xmlparser/builders/TermsQueryBuilder.java",0,0.941176470588235,2,1,3
"contrib/xml-query-parser/src/java/org/apache/lucene/xmlparser/builders/UserInputQueryBuilder.java",0,0.968421052631579,2,1,3
"contrib/xml-query-parser/src/test/org/apache/lucene/xmlparser/TestParser.java",0,0.875555555555556,4,2,6
"contrib/xml-query-parser/src/test/org/apache/lucene/xmlparser/TestQueryTemplateManager.java",0,0.957317073170732,4,1,5
"src/demo/org/apache/lucene/demo/DeleteFiles.java",0,0.378787878787879,3,4,7
"src/demo/org/apache/lucene/demo/FileDocument.java",0,0.535211267605634,2,4,6
"src/demo/org/apache/lucene/demo/HTMLDocument.java",0,0.534883720930233,2,4,6
"src/demo/org/apache/lucene/demo/IndexFiles.java",0,0.39,2,6,8
"src/demo/org/apache/lucene/demo/IndexHTML.java",0,0.470238095238095,3,5,8
"src/demo/org/apache/lucene/demo/SearchFiles.java",0,0.453674121405751,8,3,11
"src/demo/org/apache/lucene/demo/html/Entities.java",0,0.945288753799392,6,1,7
"src/demo/org/apache/lucene/demo/html/HTMLParser.java",0,0.79973474801061,4,3,7
"src/demo/org/apache/lucene/demo/html/HTMLParserConstants.java",0,0.354838709677419,0,4,4
"src/demo/org/apache/lucene/demo/html/HTMLParserTokenManager.java",0,0.612723903644225,1,4,5
"src/demo/org/apache/lucene/demo/html/ParseException.java",0,0.924242424242424,1,2,3
"src/demo/org/apache/lucene/demo/html/ParserThread.java",0,0.48,2,4,6
"src/demo/org/apache/lucene/demo/html/SimpleCharStream.java",0,0.790254237288136,1,3,4
"src/demo/org/apache/lucene/demo/html/Tags.java",0,0.71875,1,4,5
"src/demo/org/apache/lucene/demo/html/Test.java",0,0.431372549019608,1,4,5
"src/demo/org/apache/lucene/demo/html/Token.java",0,0.556451612903226,0,2,2
"src/demo/org/apache/lucene/demo/html/TokenMgrError.java",0,0.858156028368794,1,2,3
"src/java/org/apache/lucene/LucenePackage.java",0,0.793103448275862,0,2,2
"src/java/org/apache/lucene/analysis/ASCIIFoldingFilter.java",0,0.993106843919252,2,1,3
"src/java/org/apache/lucene/analysis/Analyzer.java",0,0.458333333333333,3,6,9
"src/java/org/apache/lucene/analysis/BaseCharFilter.java",0,0.903225806451613,0,2,2
"src/java/org/apache/lucene/analysis/CachingTokenFilter.java",0,0.906976744186046,0,2,2
"src/java/org/apache/lucene/analysis/CharArraySet.java",0,0.453846153846154,0,4,4
"src/java/org/apache/lucene/analysis/CharFilter.java",0,0.74390243902439,0,2,2
"src/java/org/apache/lucene/analysis/CharReader.java",0,0.732394366197183,1,2,3
"src/java/org/apache/lucene/analysis/CharStream.java",0,0.878048780487805,0,2,2
"src/java/org/apache/lucene/analysis/CharTokenizer.java",0,0.484126984126984,4,4,8
"src/java/org/apache/lucene/analysis/ISOLatin1AccentFilter.java",0,0.623076923076923,4,4,8
"src/java/org/apache/lucene/analysis/KeywordAnalyzer.java",0,0.415094339622642,2,3,5
"src/java/org/apache/lucene/analysis/KeywordTokenizer.java",0,0.469387755102041,2,4,6
"src/java/org/apache/lucene/analysis/LengthFilter.java",0,0.5,4,3,7
"src/java/org/apache/lucene/analysis/LetterTokenizer.java",0,0.377358490566038,2,4,6
"src/java/org/apache/lucene/analysis/LowerCaseFilter.java",0,0.333333333333333,1,5,6
"src/java/org/apache/lucene/analysis/LowerCaseTokenizer.java",0,0.232142857142857,1,6,7
"src/java/org/apache/lucene/analysis/MappingCharFilter.java",0,0.868613138686131,0,2,2
"src/java/org/apache/lucene/analysis/NormalizeCharMap.java",0,0.934426229508197,0,2,2
"src/java/org/apache/lucene/analysis/NumericTokenStream.java",0,0.912698412698413,0,2,2
"src/java/org/apache/lucene/analysis/PerFieldAnalyzerWrapper.java",0,0.362204724409449,0,6,6
"src/java/org/apache/lucene/analysis/PorterStemFilter.java",0,0.327868852459016,1,5,6
"src/java/org/apache/lucene/analysis/PorterStemmer.java",0,0.771062271062271,4,2,6
"src/java/org/apache/lucene/analysis/SimpleAnalyzer.java",0,0.30952380952381,2,4,6
"src/java/org/apache/lucene/analysis/StopAnalyzer.java",0,0.470588235294118,1,7,8
"src/java/org/apache/lucene/analysis/StopFilter.java",0,0.298429319371728,2,8,10
"src/java/org/apache/lucene/analysis/TeeSinkTokenFilter.java",0,0.918367346938776,2,2,4
"src/java/org/apache/lucene/analysis/Token.java",0,0.612823674475956,4,5,9
"src/java/org/apache/lucene/analysis/TokenFilter.java",0,0.321428571428571,1,6,7
"src/java/org/apache/lucene/analysis/TokenStream.java",0,0.354037267080745,2,5,7
"src/java/org/apache/lucene/analysis/Tokenizer.java",0,0.293478260869565,2,6,8
"src/java/org/apache/lucene/analysis/WhitespaceAnalyzer.java",0,0.268292682926829,2,4,6
"src/java/org/apache/lucene/analysis/WhitespaceTokenizer.java",0,0.36734693877551,3,4,7
"src/java/org/apache/lucene/analysis/WordlistLoader.java",0,0.457627118644068,1,4,5
"src/java/org/apache/lucene/analysis/standard/StandardAnalyzer.java",0,0.559006211180124,6,5,11
"src/java/org/apache/lucene/analysis/standard/StandardFilter.java",0,0.5,1,5,6
"src/java/org/apache/lucene/analysis/standard/StandardTokenizer.java",0,0.385245901639344,3,4,7
"src/java/org/apache/lucene/analysis/standard/StandardTokenizerImpl.java",0,0.955739972337483,3,1,4
"src/java/org/apache/lucene/analysis/tokenattributes/FlagsAttribute.java",0,0.931818181818182,0,2,2
"src/java/org/apache/lucene/analysis/tokenattributes/FlagsAttributeImpl.java",0,0.9375,1,2,3
"src/java/org/apache/lucene/analysis/tokenattributes/OffsetAttribute.java",0,0.909090909090909,0,2,2
"src/java/org/apache/lucene/analysis/tokenattributes/OffsetAttributeImpl.java",0,0.955555555555556,1,1,2
"src/java/org/apache/lucene/analysis/tokenattributes/PayloadAttribute.java",0,1,0,1,1
"src/java/org/apache/lucene/analysis/tokenattributes/PayloadAttributeImpl.java",0,0.95049504950495,1,1,2
"src/java/org/apache/lucene/analysis/tokenattributes/PositionIncrementAttribute.java",0,1,0,1,1
"src/java/org/apache/lucene/analysis/tokenattributes/PositionIncrementAttributeImpl.java",0,0.95959595959596,1,1,2
"src/java/org/apache/lucene/analysis/tokenattributes/TermAttribute.java",0,1,0,1,1
"src/java/org/apache/lucene/analysis/tokenattributes/TermAttributeImpl.java",0,0.831858407079646,0,2,2
"src/java/org/apache/lucene/analysis/tokenattributes/TypeAttribute.java",0,1,0,1,1
"src/java/org/apache/lucene/analysis/tokenattributes/TypeAttributeImpl.java",0,0.935897435897436,0,2,2
"src/java/org/apache/lucene/document/AbstractField.java",0,0.680272108843537,3,2,5
"src/java/org/apache/lucene/document/CompressionTools.java",0,0.991935483870968,1,1,2
"src/java/org/apache/lucene/document/DateField.java",0,0.385245901639344,1,6,7
"src/java/org/apache/lucene/document/DateTools.java",0,0.68359375,4,3,7
"src/java/org/apache/lucene/document/Document.java",0,0.272131147540984,2,8,10
"src/java/org/apache/lucene/document/Field.java",0,0.280918727915194,4,6,10
"src/java/org/apache/lucene/document/FieldSelector.java",0,1,0,1,1
"src/java/org/apache/lucene/document/FieldSelectorResult.java",0,0.746268656716418,1,2,3
"src/java/org/apache/lucene/document/Fieldable.java",0,0.627358490566038,2,3,5
"src/java/org/apache/lucene/document/LoadFirstFieldSelector.java",0,0.96551724137931,1,1,2
"src/java/org/apache/lucene/document/MapFieldSelector.java",0,0.567164179104478,1,3,4
"src/java/org/apache/lucene/document/NumberTools.java",0,0.820143884892086,4,2,6
"src/java/org/apache/lucene/document/NumericField.java",0,0.740072202166065,1,2,3
"src/java/org/apache/lucene/document/SetBasedFieldSelector.java",0,0.931034482758621,1,2,3
"src/java/org/apache/lucene/index/AllTermDocs.java",0,1,0,1,1
"src/java/org/apache/lucene/index/BufferedDeletes.java",0,0.856209150326797,0,2,2
"src/java/org/apache/lucene/index/ByteBlockPool.java",0,1,0,1,1
"src/java/org/apache/lucene/index/ByteSliceReader.java",0,0.959731543624161,1,1,2
"src/java/org/apache/lucene/index/ByteSliceWriter.java",0,1,0,1,1
"src/java/org/apache/lucene/index/CharBlockPool.java",0,1,0,1,1
"src/java/org/apache/lucene/index/CheckIndex.java",0,0.878155872667398,3,2,5
"src/java/org/apache/lucene/index/CompoundFileReader.java",0,0.437722419928826,2,6,8
"src/java/org/apache/lucene/index/CompoundFileWriter.java",0,0.473684210526316,2,5,7
"src/java/org/apache/lucene/index/ConcurrentMergeScheduler.java",0,0.968215158924205,1,1,2
"src/java/org/apache/lucene/index/CorruptIndexException.java",0,1,0,1,1
"src/java/org/apache/lucene/index/DefaultSkipListReader.java",0,0.974358974358974,1,1,2
"src/java/org/apache/lucene/index/DefaultSkipListWriter.java",0,0.897058823529412,1,2,3
"src/java/org/apache/lucene/index/DirectoryReader.java",0,0.427192276749799,0,5,5
"src/java/org/apache/lucene/index/DocConsumer.java",0,0.96551724137931,1,1,2
"src/java/org/apache/lucene/index/DocConsumerPerThread.java",0,1,0,1,1
"src/java/org/apache/lucene/index/DocFieldConsumer.java",0,0.96,1,1,2
"src/java/org/apache/lucene/index/DocFieldConsumerPerField.java",0,1,0,1,1
"src/java/org/apache/lucene/index/DocFieldConsumerPerThread.java",0,1,0,1,1
"src/java/org/apache/lucene/index/DocFieldConsumers.java",0,0.892857142857143,0,2,2
"src/java/org/apache/lucene/index/DocFieldConsumersPerField.java",0,0.959183673469388,1,1,2
"src/java/org/apache/lucene/index/DocFieldConsumersPerThread.java",0,0.946666666666667,0,2,2
"src/java/org/apache/lucene/index/DocFieldProcessor.java",0,0.888888888888889,0,2,2
"src/java/org/apache/lucene/index/DocFieldProcessorPerField.java",0,1,0,1,1
"src/java/org/apache/lucene/index/DocFieldProcessorPerThread.java",0,0.969151670951157,2,1,3
"src/java/org/apache/lucene/index/DocInverter.java",0,0.804123711340206,1,2,3
"src/java/org/apache/lucene/index/DocInverterPerField.java",0,0.808612440191388,1,2,3
"src/java/org/apache/lucene/index/DocInverterPerThread.java",0,0.75,0,3,3
"src/java/org/apache/lucene/index/DocumentsWriter.java",0,0.939735099337748,3,1,4
"src/java/org/apache/lucene/index/DocumentsWriterThreadState.java",0,1,0,1,1
"src/java/org/apache/lucene/index/FieldInfo.java",0,0.555555555555556,3,4,7
"src/java/org/apache/lucene/index/FieldInfos.java",0,0.293800539083558,6,6,12
"src/java/org/apache/lucene/index/FieldInvertState.java",0,0.933962264150943,0,2,2
"src/java/org/apache/lucene/index/FieldReaderException.java",0,1,0,1,1
"src/java/org/apache/lucene/index/FieldSortedTermVectorMapper.java",0,0.861111111111111,0,2,2
"src/java/org/apache/lucene/index/FieldsReader.java",0,0.414035087719298,6,3,9
"src/java/org/apache/lucene/index/FieldsWriter.java",0,0.689075630252101,3,4,7
"src/java/org/apache/lucene/index/FilterIndexReader.java",0,0.367272727272727,4,5,9
"src/java/org/apache/lucene/index/FormatPostingsDocsConsumer.java",0,1,0,1,1
"src/java/org/apache/lucene/index/FormatPostingsDocsWriter.java",0,0.984496124031008,1,1,2
"src/java/org/apache/lucene/index/FormatPostingsFieldsConsumer.java",0,1,0,1,1
"src/java/org/apache/lucene/index/FormatPostingsFieldsWriter.java",0,0.973333333333333,1,1,2
"src/java/org/apache/lucene/index/FormatPostingsPositionsConsumer.java",0,1,0,1,1
"src/java/org/apache/lucene/index/FormatPostingsPositionsWriter.java",0,0.966292134831461,1,1,2
"src/java/org/apache/lucene/index/FormatPostingsTermsConsumer.java",0,1,0,1,1
"src/java/org/apache/lucene/index/FormatPostingsTermsWriter.java",0,0.972602739726027,1,1,2
"src/java/org/apache/lucene/index/FreqProxFieldMergeState.java",0,1,0,1,1
"src/java/org/apache/lucene/index/FreqProxTermsWriter.java",0,0.940766550522648,1,2,3
"src/java/org/apache/lucene/index/FreqProxTermsWriterPerField.java",0,0.796407185628742,0,3,3
"src/java/org/apache/lucene/index/FreqProxTermsWriterPerThread.java",0,0.911111111111111,0,2,2
"src/java/org/apache/lucene/index/IndexCommit.java",0,0.962406015037594,2,1,3
"src/java/org/apache/lucene/index/IndexDeletionPolicy.java",0,0.744897959183674,1,2,3
"src/java/org/apache/lucene/index/IndexFileDeleter.java",0,0.858461538461538,2,2,4
"src/java/org/apache/lucene/index/IndexFileNameFilter.java",0,0.554347826086957,1,3,4
"src/java/org/apache/lucene/index/IndexFileNames.java",0,0.765,2,2,4
"src/java/org/apache/lucene/index/IndexReader.java",0,0.504280821917808,10,5,15
"src/java/org/apache/lucene/index/IndexWriter.java",0,0.892203250360008,14,1,15
"src/java/org/apache/lucene/index/IntBlockPool.java",0,1,0,1,1
"src/java/org/apache/lucene/index/InvertedDocConsumer.java",0,0.957446808510638,1,1,2
"src/java/org/apache/lucene/index/InvertedDocConsumerPerField.java",0,0.863636363636364,0,2,2
"src/java/org/apache/lucene/index/InvertedDocConsumerPerThread.java",0,1,0,1,1
"src/java/org/apache/lucene/index/InvertedDocEndConsumer.java",0,0.933333333333333,0,2,2
"src/java/org/apache/lucene/index/InvertedDocEndConsumerPerField.java",0,1,0,1,1
"src/java/org/apache/lucene/index/InvertedDocEndConsumerPerThread.java",0,1,0,1,1
"src/java/org/apache/lucene/index/KeepOnlyLastCommitDeletionPolicy.java",0,0.94,0,2,2
"src/java/org/apache/lucene/index/LogByteSizeMergePolicy.java",0,0.976470588235294,2,1,3
"src/java/org/apache/lucene/index/LogDocMergePolicy.java",0,0.984126984126984,1,1,2
"src/java/org/apache/lucene/index/LogMergePolicy.java",0,0.983402489626556,1,1,2
"src/java/org/apache/lucene/index/MergeDocIDRemapper.java",0,1,0,1,1
"src/java/org/apache/lucene/index/MergePolicy.java",0,0.966165413533835,2,1,3
"src/java/org/apache/lucene/index/MergeScheduler.java",0,1,0,1,1
"src/java/org/apache/lucene/index/MultiLevelSkipListReader.java",0,0.978494623655914,1,1,2
"src/java/org/apache/lucene/index/MultiLevelSkipListWriter.java",0,0.986754966887417,1,1,2
"src/java/org/apache/lucene/index/MultiReader.java",0,0.62085308056872,6,3,9
"src/java/org/apache/lucene/index/MultipleTermPositions.java",0,0.577981651376147,5,3,8
"src/java/org/apache/lucene/index/NormsWriter.java",0,0.903954802259887,0,2,2
"src/java/org/apache/lucene/index/NormsWriterPerField.java",0,0.936708860759494,0,2,2
"src/java/org/apache/lucene/index/NormsWriterPerThread.java",0,0.911111111111111,0,2,2
"src/java/org/apache/lucene/index/ParallelReader.java",0,0.325652841781874,2,6,8
"src/java/org/apache/lucene/index/Payload.java",0,0.766169154228856,1,2,3
"src/java/org/apache/lucene/index/PositionBasedTermVectorMapper.java",0,0.882352941176471,1,2,3
"src/java/org/apache/lucene/index/RawPostingList.java",0,0.888888888888889,0,2,2
"src/java/org/apache/lucene/index/ReadOnlyDirectoryReader.java",0,0.953488372093023,1,1,2
"src/java/org/apache/lucene/index/ReadOnlySegmentReader.java",0,0.944444444444444,0,2,2
"src/java/org/apache/lucene/index/ReusableStringReader.java",0,0.948275862068966,0,2,2
"src/java/org/apache/lucene/index/SegmentInfo.java",0,0.802197802197802,5,2,7
"src/java/org/apache/lucene/index/SegmentInfos.java",0,0.821857923497268,9,2,11
"src/java/org/apache/lucene/index/SegmentMergeInfo.java",0,0.435294117647059,0,4,4
"src/java/org/apache/lucene/index/SegmentMergeQueue.java",0,0.595238095238095,2,3,5
"src/java/org/apache/lucene/index/SegmentMerger.java",0,0.611111111111111,7,4,11
"src/java/org/apache/lucene/index/SegmentReader.java",0,0.651702786377709,9,3,12
"src/java/org/apache/lucene/index/SegmentTermDocs.java",0,0.268867924528302,3,4,7
"src/java/org/apache/lucene/index/SegmentTermEnum.java",0,0.398148148148148,2,5,7
"src/java/org/apache/lucene/index/SegmentTermPositionVector.java",0,0.892307692307692,1,2,3
"src/java/org/apache/lucene/index/SegmentTermPositions.java",0,0.438423645320197,6,4,10
"src/java/org/apache/lucene/index/SegmentTermVector.java",0,0.666666666666667,2,3,5
"src/java/org/apache/lucene/index/SegmentWriteState.java",0,0.96,1,1,2
"src/java/org/apache/lucene/index/SerialMergeScheduler.java",0,0.953488372093023,1,1,2
"src/java/org/apache/lucene/index/SnapshotDeletionPolicy.java",0,0.872340425531915,1,2,3
"src/java/org/apache/lucene/index/SortedTermVectorMapper.java",0,0.931297709923664,0,2,2
"src/java/org/apache/lucene/index/StaleReaderException.java",0,1,0,1,1
"src/java/org/apache/lucene/index/StoredFieldsWriter.java",0,0.98469387755102,1,1,2
"src/java/org/apache/lucene/index/StoredFieldsWriterPerThread.java",0,1,0,1,1
"src/java/org/apache/lucene/index/Term.java",0,0.37037037037037,5,6,11
"src/java/org/apache/lucene/index/TermBuffer.java",0,0.55,2,2,4
"src/java/org/apache/lucene/index/TermDocs.java",0,0.506024096385542,2,4,6
"src/java/org/apache/lucene/index/TermEnum.java",0,0.475,0,5,5
"src/java/org/apache/lucene/index/TermFreqVector.java",0,0.690140845070423,1,4,5
"src/java/org/apache/lucene/index/TermInfo.java",0,0.627118644067797,0,3,3
"src/java/org/apache/lucene/index/TermInfosReader.java",0,0.28476821192053,5,4,9
"src/java/org/apache/lucene/index/TermInfosWriter.java",0,0.464912280701754,4,4,8
"src/java/org/apache/lucene/index/TermPositionVector.java",0,0.627906976744186,0,3,3
"src/java/org/apache/lucene/index/TermPositions.java",0,0.392405063291139,1,7,8
"src/java/org/apache/lucene/index/TermVectorEntry.java",0,0.97029702970297,1,1,2
"src/java/org/apache/lucene/index/TermVectorEntryFreqSortedComparator.java",0,0.95,0,2,2
"src/java/org/apache/lucene/index/TermVectorMapper.java",0,1,0,1,1
"src/java/org/apache/lucene/index/TermVectorOffsetInfo.java",0,0.612903225806452,1,3,4
"src/java/org/apache/lucene/index/TermVectorsReader.java",0,0.467445742904841,5,4,9
"src/java/org/apache/lucene/index/TermVectorsTermsWriter.java",0,0.952861952861953,1,1,2
"src/java/org/apache/lucene/index/TermVectorsTermsWriterPerField.java",0,0.883720930232558,2,2,4
"src/java/org/apache/lucene/index/TermVectorsTermsWriterPerThread.java",0,0.956043956043956,1,1,2
"src/java/org/apache/lucene/index/TermVectorsWriter.java",0,0.720183486238532,1,4,5
"src/java/org/apache/lucene/index/TermsHash.java",0,0.927038626609442,0,2,2
"src/java/org/apache/lucene/index/TermsHashConsumer.java",0,0.945945945945946,0,2,2
"src/java/org/apache/lucene/index/TermsHashConsumerPerField.java",0,0.864864864864865,0,2,2
"src/java/org/apache/lucene/index/TermsHashConsumerPerThread.java",0,1,0,1,1
"src/java/org/apache/lucene/index/TermsHashPerField.java",0,0.951957295373665,2,1,3
"src/java/org/apache/lucene/index/TermsHashPerThread.java",0,0.968,1,1,2
"src/java/org/apache/lucene/messages/Message.java",0,1,0,1,1
"src/java/org/apache/lucene/messages/MessageImpl.java",0,0.930555555555556,0,2,2
"src/java/org/apache/lucene/messages/NLS.java",0,0.942307692307692,0,2,2
"src/java/org/apache/lucene/messages/NLSException.java",0,1,0,1,1
"src/java/org/apache/lucene/queryParser/CharStream.java",0,0.839285714285714,2,2,4
"src/java/org/apache/lucene/queryParser/FastCharStream.java",0,0.854838709677419,3,2,5
"src/java/org/apache/lucene/queryParser/MultiFieldQueryParser.java",0,0.578947368421053,4,4,8
"src/java/org/apache/lucene/queryParser/ParseException.java",0,0.924242424242424,3,1,4
"src/java/org/apache/lucene/queryParser/QueryParser.java",0,0.453739612188366,8,5,13
"src/java/org/apache/lucene/queryParser/QueryParserConstants.java",0,0.408,2,3,5
"src/java/org/apache/lucene/queryParser/QueryParserTokenManager.java",0,0.519047619047619,4,5,9
"src/java/org/apache/lucene/queryParser/Token.java",0,0.556451612903226,1,2,3
"src/java/org/apache/lucene/queryParser/TokenMgrError.java",0,0.858156028368794,2,2,4
"src/java/org/apache/lucene/search/BooleanClause.java",0,0.345794392523364,3,5,8
"src/java/org/apache/lucene/search/BooleanQuery.java",0,0.294605809128631,4,7,11
"src/java/org/apache/lucene/search/BooleanScorer.java",0,0.553623188405797,3,5,8
"src/java/org/apache/lucene/search/BooleanScorer2.java",0,0.36741214057508,4,4,8
"src/java/org/apache/lucene/search/CachingSpanFilter.java",0,0.65979381443299,0,3,3
"src/java/org/apache/lucene/search/CachingWrapperFilter.java",0,0.348623853211009,1,6,7
"src/java/org/apache/lucene/search/Collector.java",0,0.95906432748538,1,1,2
"src/java/org/apache/lucene/search/ComplexExplanation.java",0,0.830985915492958,1,3,4
"src/java/org/apache/lucene/search/ConjunctionScorer.java",0,0.503649635036496,1,4,5
"src/java/org/apache/lucene/search/ConstantScoreQuery.java",0,0.706521739130435,3,3,6
"src/java/org/apache/lucene/search/DefaultSimilarity.java",0,0.445544554455446,0,4,4
"src/java/org/apache/lucene/search/DisjunctionMaxQuery.java",0,0.727272727272727,2,3,5
"src/java/org/apache/lucene/search/DisjunctionMaxScorer.java",0,0.766304347826087,2,2,4
"src/java/org/apache/lucene/search/DisjunctionSumScorer.java",0,0.576271186440678,2,3,5
"src/java/org/apache/lucene/search/DocIdSet.java",0,0.358208955223881,0,3,3
"src/java/org/apache/lucene/search/DocIdSetIterator.java",0,0.696969696969697,2,2,4
"src/java/org/apache/lucene/search/ExactPhraseScorer.java",0,0.517857142857143,3,5,8
"src/java/org/apache/lucene/search/Explanation.java",0,0.586666666666667,4,3,7
"src/java/org/apache/lucene/search/FieldCache.java",0,0.360330578512397,2,6,8
"src/java/org/apache/lucene/search/FieldCacheImpl.java",0,0.273809523809524,4,7,11
"src/java/org/apache/lucene/search/FieldCacheRangeFilter.java",0,0.890365448504983,0,2,2
"src/java/org/apache/lucene/search/FieldCacheTermsFilter.java",0,0.930635838150289,0,2,2
"src/java/org/apache/lucene/search/FieldComparator.java",0,0.905117270788913,1,2,3
"src/java/org/apache/lucene/search/FieldComparatorSource.java",0,0.953488372093023,1,1,2
"src/java/org/apache/lucene/search/FieldDoc.java",0,0.386666666666667,0,5,5
"src/java/org/apache/lucene/search/FieldDocSortedHitQueue.java",0,0.686567164179104,2,3,5
"src/java/org/apache/lucene/search/FieldValueHitQueue.java",0,0.927601809954751,1,2,3
"src/java/org/apache/lucene/search/Filter.java",0,0.263157894736842,1,5,6
"src/java/org/apache/lucene/search/FilterManager.java",0,0.886699507389163,2,2,4
"src/java/org/apache/lucene/search/FilteredDocIdSet.java",0,0.89873417721519,0,2,2
"src/java/org/apache/lucene/search/FilteredDocIdSetIterator.java",0,0.964705882352941,1,1,2
"src/java/org/apache/lucene/search/FilteredQuery.java",0,0.330357142857143,4,7,11
"src/java/org/apache/lucene/search/FilteredTermEnum.java",0,0.663461538461538,5,4,9
"src/java/org/apache/lucene/search/FuzzyQuery.java",0,0.206611570247934,3,7,10
"src/java/org/apache/lucene/search/FuzzyTermEnum.java",0,0.690140845070423,7,2,9
"src/java/org/apache/lucene/search/HitQueue.java",0,0.593023255813954,2,4,6
"src/java/org/apache/lucene/search/IndexSearcher.java",0,0.548172757475083,9,3,12
"src/java/org/apache/lucene/search/MatchAllDocsQuery.java",0,0.473053892215569,5,4,9
"src/java/org/apache/lucene/search/MultiPhraseQuery.java",0,0.602150537634409,7,3,10
"src/java/org/apache/lucene/search/MultiSearcher.java",0,0.385300668151448,6,5,11
"src/java/org/apache/lucene/search/MultiTermQuery.java",0,0.822115384615385,7,2,9
"src/java/org/apache/lucene/search/MultiTermQueryWrapperFilter.java",0,0.833333333333333,1,2,3
"src/java/org/apache/lucene/search/NumericRangeFilter.java",0,0.936507936507937,0,2,2
"src/java/org/apache/lucene/search/NumericRangeQuery.java",0,0.908602150537634,2,2,4
"src/java/org/apache/lucene/search/ParallelMultiSearcher.java",0,0.530434782608696,1,3,4
"src/java/org/apache/lucene/search/PhrasePositions.java",0,0.518518518518518,1,4,5
"src/java/org/apache/lucene/search/PhraseQuery.java",0,0.379411764705882,7,5,12
"src/java/org/apache/lucene/search/PhraseQueue.java",0,0.435897435897436,1,5,6
"src/java/org/apache/lucene/search/PhraseScorer.java",0,0.47027027027027,5,6,11
"src/java/org/apache/lucene/search/PositiveScoresOnlyCollector.java",0,0.936507936507937,0,2,2
"src/java/org/apache/lucene/search/PrefixFilter.java",0,0.404255319148936,0,4,4
"src/java/org/apache/lucene/search/PrefixQuery.java",0,0.333333333333333,3,6,9
"src/java/org/apache/lucene/search/PrefixTermEnum.java",0,0.954545454545455,1,1,2
"src/java/org/apache/lucene/search/Query.java",0,0.298319327731092,3,7,10
"src/java/org/apache/lucene/search/QueryTermVector.java",0,0.736486486486487,1,4,5
"src/java/org/apache/lucene/search/QueryWrapperFilter.java",0,0.763157894736842,2,3,5
"src/java/org/apache/lucene/search/ReqExclScorer.java",0,0.591666666666667,1,3,4
"src/java/org/apache/lucene/search/ReqOptSumScorer.java",0,0.630952380952381,1,3,4
"src/java/org/apache/lucene/search/ScoreCachingWrappingScorer.java",0,0.918604651162791,0,2,2
"src/java/org/apache/lucene/search/ScoreDoc.java",0,0.488372093023256,1,4,5
"src/java/org/apache/lucene/search/Scorer.java",0,0.391752577319588,3,6,9
"src/java/org/apache/lucene/search/Searchable.java",0,0.363636363636364,6,3,9
"src/java/org/apache/lucene/search/Searcher.java",0,0.341176470588235,5,5,10
"src/java/org/apache/lucene/search/Similarity.java",0,0.346428571428571,8,4,12
"src/java/org/apache/lucene/search/SimilarityDelegator.java",0,0.657894736842105,3,4,7
"src/java/org/apache/lucene/search/SingleTermEnum.java",0,1,0,1,1
"src/java/org/apache/lucene/search/SloppyPhraseScorer.java",0,0.714285714285714,7,3,10
"src/java/org/apache/lucene/search/Sort.java",0,0.392265193370166,2,5,7
"src/java/org/apache/lucene/search/SortField.java",0,0.531914893617021,5,4,9
"src/java/org/apache/lucene/search/SpanFilter.java",0,0.973684210526316,1,1,2
"src/java/org/apache/lucene/search/SpanFilterResult.java",0,0.786324786324786,1,3,4
"src/java/org/apache/lucene/search/SpanQueryFilter.java",0,0.895238095238095,2,2,4
"src/java/org/apache/lucene/search/TermQuery.java",0,0.447115384615385,6,5,11
"src/java/org/apache/lucene/search/TermRangeFilter.java",0,0.953703703703704,1,1,2
"src/java/org/apache/lucene/search/TermRangeQuery.java",0,0.526829268292683,5,3,8
"src/java/org/apache/lucene/search/TermRangeTermEnum.java",0,0.805194805194805,1,3,4
"src/java/org/apache/lucene/search/TermScorer.java",0,0.383233532934132,6,3,9
"src/java/org/apache/lucene/search/TimeLimitingCollector.java",0,0.973684210526316,2,1,3
"src/java/org/apache/lucene/search/TopDocs.java",0,0.327272727272727,1,4,5
"src/java/org/apache/lucene/search/TopDocsCollector.java",0,0.959459459459459,2,1,3
"src/java/org/apache/lucene/search/TopFieldCollector.java",0,0.942828485456369,1,2,3
"src/java/org/apache/lucene/search/TopFieldDocs.java",0,0.755555555555556,2,2,4
"src/java/org/apache/lucene/search/TopScoreDocCollector.java",0,0.92156862745098,0,2,2
"src/java/org/apache/lucene/search/Weight.java",0,0.669491525423729,4,3,7
"src/java/org/apache/lucene/search/WildcardQuery.java",0,0.378151260504202,3,6,9
"src/java/org/apache/lucene/search/WildcardTermEnum.java",0,0.647368421052632,4,4,8
"src/java/org/apache/lucene/search/function/ByteFieldSource.java",0,0.84297520661157,0,3,3
"src/java/org/apache/lucene/search/function/CustomScoreQuery.java",0,0.759414225941423,3,4,7
"src/java/org/apache/lucene/search/function/DocValues.java",0,0.784210526315789,2,2,4
"src/java/org/apache/lucene/search/function/FieldCacheSource.java",0,0.891891891891892,4,1,5
"src/java/org/apache/lucene/search/function/FieldScoreQuery.java",0,0.96875,3,1,4
"src/java/org/apache/lucene/search/function/FloatFieldSource.java",0,0.843478260869565,1,3,4
"src/java/org/apache/lucene/search/function/IntFieldSource.java",0,0.851239669421488,0,3,3
"src/java/org/apache/lucene/search/function/OrdFieldSource.java",0,0.862068965517241,3,2,5
"src/java/org/apache/lucene/search/function/ReverseOrdFieldSource.java",0,0.873015873015873,2,2,4
"src/java/org/apache/lucene/search/function/ShortFieldSource.java",0,0.84297520661157,0,3,3
"src/java/org/apache/lucene/search/function/ValueSource.java",0,0.947368421052632,2,1,3
"src/java/org/apache/lucene/search/function/ValueSourceQuery.java",0,0.739795918367347,4,3,7
"src/java/org/apache/lucene/search/payloads/AveragePayloadFunction.java",0,0.649122807017544,0,3,3
"src/java/org/apache/lucene/search/payloads/MaxPayloadFunction.java",0,0.607142857142857,0,3,3
"src/java/org/apache/lucene/search/payloads/MinPayloadFunction.java",0,0.618181818181818,0,3,3
"src/java/org/apache/lucene/search/payloads/PayloadFunction.java",0,0.876923076923077,1,2,3
"src/java/org/apache/lucene/search/payloads/PayloadNearQuery.java",0,0.5,2,3,5
"src/java/org/apache/lucene/search/payloads/PayloadSpanUtil.java",0,0.888297872340426,2,2,4
"src/java/org/apache/lucene/search/payloads/PayloadTermQuery.java",0,0.618181818181818,3,2,5
"src/java/org/apache/lucene/search/spans/FieldMaskingSpanQuery.java",0,0.90625,2,2,4
"src/java/org/apache/lucene/search/spans/NearSpansOrdered.java",0,0.714285714285714,1,4,5
"src/java/org/apache/lucene/search/spans/NearSpansUnordered.java",0,0.512578616352201,4,5,9
"src/java/org/apache/lucene/search/spans/SpanFirstQuery.java",0,0.37125748502994,2,7,9
"src/java/org/apache/lucene/search/spans/SpanNearQuery.java",0,0.385026737967914,4,6,10
"src/java/org/apache/lucene/search/spans/SpanNotQuery.java",0,0.462264150943396,3,6,9
"src/java/org/apache/lucene/search/spans/SpanOrQuery.java",0,0.389105058365759,3,6,9
"src/java/org/apache/lucene/search/spans/SpanQuery.java",0,0.439024390243902,4,3,7
"src/java/org/apache/lucene/search/spans/SpanScorer.java",0,0.330434782608696,1,6,7
"src/java/org/apache/lucene/search/spans/SpanTermQuery.java",0,0.290697674418605,2,7,9
"src/java/org/apache/lucene/search/spans/SpanWeight.java",0,0.507042253521127,5,4,9
"src/java/org/apache/lucene/search/spans/Spans.java",0,0.455555555555556,1,4,5
"src/java/org/apache/lucene/search/spans/TermSpans.java",0,0.906779661016949,1,2,3
"src/java/org/apache/lucene/store/AlreadyClosedException.java",0,1,0,1,1
"src/java/org/apache/lucene/store/BufferedIndexInput.java",0,0.370192307692308,2,3,5
"src/java/org/apache/lucene/store/BufferedIndexOutput.java",0,0.776978417266187,2,3,5
"src/java/org/apache/lucene/store/ChecksumIndexInput.java",0,0.917808219178082,0,2,2
"src/java/org/apache/lucene/store/ChecksumIndexOutput.java",0,0.929292929292929,0,2,2
"src/java/org/apache/lucene/store/Directory.java",0,0.467248908296943,1,5,6
"src/java/org/apache/lucene/store/FSDirectory.java",0,0.503416856492027,6,4,10
"src/java/org/apache/lucene/store/FSLockFactory.java",0,1,0,1,1
"src/java/org/apache/lucene/store/FileSwitchDirectory.java",0,0.900709219858156,1,2,3
"src/java/org/apache/lucene/store/IndexInput.java",0,0.602459016393443,3,3,6
"src/java/org/apache/lucene/store/IndexOutput.java",0,0.558035714285714,3,2,5
"src/java/org/apache/lucene/store/Lock.java",0,0.370629370629371,0,5,5
"src/java/org/apache/lucene/store/LockFactory.java",0,0.77027027027027,1,2,3
"src/java/org/apache/lucene/store/LockObtainFailedException.java",0,1,0,1,1
"src/java/org/apache/lucene/store/LockReleaseFailedException.java",0,1,0,1,1
"src/java/org/apache/lucene/store/LockStressTest.java",0,0.954545454545455,1,1,2
"src/java/org/apache/lucene/store/LockVerifyServer.java",0,1,0,1,1
"src/java/org/apache/lucene/store/MMapDirectory.java",0,0.508313539192399,4,2,6
"src/java/org/apache/lucene/store/NIOFSDirectory.java",0,0.847457627118644,0,3,3
"src/java/org/apache/lucene/store/NativeFSLockFactory.java",0,0.657575757575758,1,3,4
"src/java/org/apache/lucene/store/NoLockFactory.java",0,0.897058823529412,1,2,3
"src/java/org/apache/lucene/store/NoSuchDirectoryException.java",0,1,0,1,1
"src/java/org/apache/lucene/store/RAMDirectory.java",0,0.397129186602871,4,5,9
"src/java/org/apache/lucene/store/RAMFile.java",0,0.571428571428571,1,5,6
"src/java/org/apache/lucene/store/RAMInputStream.java",0,0.433333333333333,0,6,6
"src/java/org/apache/lucene/store/RAMOutputStream.java",0,0.441717791411043,3,3,6
"src/java/org/apache/lucene/store/SimpleFSDirectory.java",0,0.86283185840708,1,2,3
"src/java/org/apache/lucene/store/SimpleFSLockFactory.java",0,0.579310344827586,2,3,5
"src/java/org/apache/lucene/store/SingleInstanceLockFactory.java",0,0.824175824175824,0,3,3
"src/java/org/apache/lucene/store/VerifyingLockFactory.java",0,0.952,1,1,2
"src/java/org/apache/lucene/util/ArrayUtil.java",0,0.504201680672269,1,2,3
"src/java/org/apache/lucene/util/Attribute.java",0,1,0,1,1
"src/java/org/apache/lucene/util/AttributeImpl.java",0,0.873015873015873,0,2,2
"src/java/org/apache/lucene/util/AttributeSource.java",0,0.683297180043384,2,2,4
"src/java/org/apache/lucene/util/AverageGuessMemoryModel.java",0,0.82051282051282,0,2,2
"src/java/org/apache/lucene/util/BitUtil.java",0,0.97671568627451,2,1,3
"src/java/org/apache/lucene/util/BitVector.java",0,0.369811320754717,3,3,6
"src/java/org/apache/lucene/util/CloseableThreadLocal.java",0,0.885714285714286,1,2,3
"src/java/org/apache/lucene/util/Constants.java",0,0.430232558139535,1,4,5
"src/java/org/apache/lucene/util/DocIdBitSet.java",0,0.686746987951807,0,3,3
"src/java/org/apache/lucene/util/DummyConcurrentLock.java",0,1,0,1,1
"src/java/org/apache/lucene/util/FieldCacheSanityChecker.java",0,0.880841121495327,0,2,2
"src/java/org/apache/lucene/util/IndexableBinaryStringTools.java",0,0.996825396825397,1,1,2
"src/java/org/apache/lucene/util/MapOfSets.java",0,0.851851851851852,0,2,2
"src/java/org/apache/lucene/util/MemoryModel.java",0,1,0,1,1
"src/java/org/apache/lucene/util/NamedThreadFactory.java",0,1,0,1,1
"src/java/org/apache/lucene/util/NumericUtils.java",0,0.929336188436831,1,2,3
"src/java/org/apache/lucene/util/OpenBitSet.java",0,0.935128518971848,2,2,4
"src/java/org/apache/lucene/util/OpenBitSetDISI.java",0,0.862745098039216,0,2,2
"src/java/org/apache/lucene/util/OpenBitSetIterator.java",0,0.738461538461539,1,2,3
"src/java/org/apache/lucene/util/Parameter.java",0,0.844155844155844,1,3,4
"src/java/org/apache/lucene/util/PriorityQueue.java",0,0.508620689655172,5,3,8
"src/java/org/apache/lucene/util/RamUsageEstimator.java",0,0.989847715736041,1,1,2
"src/java/org/apache/lucene/util/ReaderUtil.java",0,0.900900900900901,1,2,3
"src/java/org/apache/lucene/util/ScorerDocQueue.java",0,0.963133640552995,1,1,2
"src/java/org/apache/lucene/util/SimpleStringInterner.java",0,0.98780487804878,1,1,2
"src/java/org/apache/lucene/util/SmallFloat.java",0,1,0,1,1
"src/java/org/apache/lucene/util/SortedVIntList.java",0,0.841004184100418,1,2,3
"src/java/org/apache/lucene/util/SorterTemplate.java",0,1,0,1,1
"src/java/org/apache/lucene/util/StringHelper.java",0,0.32,0,4,4
"src/java/org/apache/lucene/util/StringInterner.java",0,1,0,1,1
"src/java/org/apache/lucene/util/ThreadInterruptedException.java",0,1,0,1,1
"src/java/org/apache/lucene/util/ToStringUtils.java",0,0.645161290322581,0,4,4
"src/java/org/apache/lucene/util/UnicodeUtil.java",0,0.995525727069351,1,1,2
"src/java/org/apache/lucene/util/Version.java",0,0.492753623188406,0,3,3
"src/java/org/apache/lucene/util/cache/Cache.java",0,0.81981981981982,0,2,2
"src/java/org/apache/lucene/util/cache/SimpleLRUCache.java",0,0.840909090909091,0,2,2
"src/java/org/apache/lucene/util/cache/SimpleMapCache.java",0,0.747747747747748,0,2,2
"src/test/org/apache/lucene/TestDemo.java",0,0.675,1,5,6
"src/test/org/apache/lucene/TestMergeSchedulerExternal.java",0,0.965217391304348,1,1,2
"src/test/org/apache/lucene/TestSearch.java",0,0.721428571428571,3,4,7
"src/test/org/apache/lucene/TestSearchForDuplicates.java",0,0.66,3,4,7
"src/test/org/apache/lucene/TestSnapshotDeletionPolicy.java",0,0.97489539748954,1,1,2
"src/test/org/apache/lucene/analysis/BaseTokenStreamTestCase.java",0,1,0,1,1
"src/test/org/apache/lucene/analysis/TestASCIIFoldingFilter.java",0,0.952256033578174,2,1,3
"src/test/org/apache/lucene/analysis/TestAnalyzers.java",0,0.364197530864198,1,5,6
"src/test/org/apache/lucene/analysis/TestCachingTokenFilter.java",0,0.936363636363636,1,2,3
"src/test/org/apache/lucene/analysis/TestCharArraySet.java",0,0.730337078651685,1,3,4
"src/test/org/apache/lucene/analysis/TestCharFilter.java",0,0.942028985507246,2,1,3
"src/test/org/apache/lucene/analysis/TestISOLatin1AccentFilter.java",0,1,0,1,1
"src/test/org/apache/lucene/analysis/TestKeywordAnalyzer.java",0,0.397959183673469,1,5,6
"src/test/org/apache/lucene/analysis/TestLengthFilter.java",0,0.585365853658537,1,3,4
"src/test/org/apache/lucene/analysis/TestMappingCharFilter.java",0,0.716049382716049,0,2,2
"src/test/org/apache/lucene/analysis/TestNumericTokenStream.java",0,0.972602739726027,1,1,2
"src/test/org/apache/lucene/analysis/TestPerFieldAnalzyerWrapper.java",0,0.520833333333333,0,5,5
"src/test/org/apache/lucene/analysis/TestStandardAnalyzer.java",0,0.692640692640693,2,3,5
"src/test/org/apache/lucene/analysis/TestStopAnalyzer.java",0,0.326732673267327,2,7,9
"src/test/org/apache/lucene/analysis/TestStopFilter.java",0,0.863309352517986,2,2,4
"src/test/org/apache/lucene/analysis/TestTeeSinkTokenFilter.java",0,0.878676470588235,1,2,3
"src/test/org/apache/lucene/analysis/TestToken.java",0,0.6328125,0,2,2
"src/test/org/apache/lucene/analysis/tokenattributes/TestSimpleAttributeImpls.java",0,1,0,1,1
"src/test/org/apache/lucene/analysis/tokenattributes/TestTermAttributeImpl.java",0,1,0,1,1
"src/test/org/apache/lucene/document/TestBinaryDocument.java",0,0.564102564102564,3,3,6
"src/test/org/apache/lucene/document/TestDateTools.java",0,1,0,1,1
"src/test/org/apache/lucene/document/TestDocument.java",0,0.279569892473118,4,5,9
"src/test/org/apache/lucene/document/TestNumberTools.java",0,1,0,1,1
"src/test/org/apache/lucene/index/DocHelper.java",0,0.252,3,5,8
"src/test/org/apache/lucene/index/MockIndexInput.java",0,0.546875,1,4,5
"src/test/org/apache/lucene/index/TestAddIndexesNoOptimize.java",0,0.585714285714286,1,3,4
"src/test/org/apache/lucene/index/TestAtomicUpdate.java",0,0.970588235294118,1,1,2
"src/test/org/apache/lucene/index/TestBackwardsCompatibility.java",0,0.87962962962963,0,2,2
"src/test/org/apache/lucene/index/TestByteSlices.java",0,0.981981981981982,1,1,2
"src/test/org/apache/lucene/index/TestCheckIndex.java",0,0.97029702970297,2,1,3
"src/test/org/apache/lucene/index/TestCompoundFile.java",0,0.602760736196319,5,4,9
"src/test/org/apache/lucene/index/TestConcurrentMergeScheduler.java",0,0.965367965367965,2,1,3
"src/test/org/apache/lucene/index/TestCrash.java",0,0.94475138121547,2,1,3
"src/test/org/apache/lucene/index/TestDeletionPolicy.java",0,0.951153324287653,2,1,3
"src/test/org/apache/lucene/index/TestDirectoryReader.java",0,0.660098522167488,1,3,4
"src/test/org/apache/lucene/index/TestDoc.java",0,0.5,4,4,8
"src/test/org/apache/lucene/index/TestDocumentWriter.java",0,0.230283911671924,2,6,8
"src/test/org/apache/lucene/index/TestFieldInfos.java",0,0.584269662921348,1,4,5
"src/test/org/apache/lucene/index/TestFieldsReader.java",0,0.411214953271028,5,3,8
"src/test/org/apache/lucene/index/TestFilterIndexReader.java",0,0.756944444444444,5,2,7
"src/test/org/apache/lucene/index/TestIndexFileDeleter.java",0,0.92,1,2,3
"src/test/org/apache/lucene/index/TestIndexInput.java",0,0.459016393442623,1,4,5
"src/test/org/apache/lucene/index/TestIndexReader.java",0,0.618545252637424,9,4,13
"src/test/org/apache/lucene/index/TestIndexReaderClone.java",0,0.96031746031746,1,1,2
"src/test/org/apache/lucene/index/TestIndexReaderCloneNorms.java",0,0.944117647058824,1,2,3
"src/test/org/apache/lucene/index/TestIndexReaderReopen.java",0,0.608,1,4,5
"src/test/org/apache/lucene/index/TestIndexWriter.java",0,0.866681118577932,5,2,7
"src/test/org/apache/lucene/index/TestIndexWriterDelete.java",0,0.964329643296433,2,1,3
"src/test/org/apache/lucene/index/TestIndexWriterExceptions.java",0,0.981566820276498,1,1,2
"src/test/org/apache/lucene/index/TestIndexWriterLockRelease.java",0,0.722222222222222,0,3,3
"src/test/org/apache/lucene/index/TestIndexWriterMergePolicy.java",0,0.787313432835821,1,3,4
"src/test/org/apache/lucene/index/TestIndexWriterMerging.java",0,0.963302752293578,2,1,3
"src/test/org/apache/lucene/index/TestIndexWriterReader.java",0,0.986191024165708,2,1,3
"src/test/org/apache/lucene/index/TestLazyBug.java",0,0.9296875,1,2,3
"src/test/org/apache/lucene/index/TestLazyProxSkipping.java",0,0.682051282051282,1,3,4
"src/test/org/apache/lucene/index/TestMultiLevelSkipList.java",0,0.928994082840237,1,2,3
"src/test/org/apache/lucene/index/TestMultiReader.java",0,0.458333333333333,1,5,6
"src/test/org/apache/lucene/index/TestNRTReaderWithThreads.java",0,0.991071428571429,1,1,2
"src/test/org/apache/lucene/index/TestNorms.java",0,0.827160493827161,3,2,5
"src/test/org/apache/lucene/index/TestOmitTf.java",0,0.905569007263923,0,2,2
"src/test/org/apache/lucene/index/TestParallelReader.java",0,0.258503401360544,1,6,7
"src/test/org/apache/lucene/index/TestParallelReaderEmptyIndex.java",0,1,0,1,1
"src/test/org/apache/lucene/index/TestParallelTermEnum.java",0,0.830601092896175,1,3,4
"src/test/org/apache/lucene/index/TestPayloads.java",0,0.933447098976109,2,1,3
"src/test/org/apache/lucene/index/TestPositionBasedTermVectorMapper.java",0,0.942857142857143,2,1,3
"src/test/org/apache/lucene/index/TestSegmentMerger.java",0,0.464912280701754,3,4,7
"src/test/org/apache/lucene/index/TestSegmentReader.java",0,0.376884422110553,6,3,9
"src/test/org/apache/lucene/index/TestSegmentTermDocs.java",0,0.542857142857143,3,3,6
"src/test/org/apache/lucene/index/TestSegmentTermEnum.java",0,0.390243902439024,1,5,6
"src/test/org/apache/lucene/index/TestStressIndexing.java",0,0.978378378378378,1,1,2
"src/test/org/apache/lucene/index/TestStressIndexing2.java",0,0.980182926829268,2,1,3
"src/test/org/apache/lucene/index/TestTerm.java",0,0.472222222222222,0,3,3
"src/test/org/apache/lucene/index/TestTermVectorsReader.java",0,0.44671201814059,3,5,8
"src/test/org/apache/lucene/index/TestTermdocPerf.java",0,0.951219512195122,2,1,3
"src/test/org/apache/lucene/index/TestThreadedOptimize.java",0,0.980392156862745,2,1,3
"src/test/org/apache/lucene/index/TestTransactionRollback.java",0,0.97196261682243,2,1,3
"src/test/org/apache/lucene/index/TestTransactions.java",0,0.972972972972973,1,1,2
"src/test/org/apache/lucene/index/TestWordlistLoader.java",0,0.678571428571429,1,3,4
"src/test/org/apache/lucene/messages/MessagesTestBundle.java",0,1,0,1,1
"src/test/org/apache/lucene/messages/TestNLS.java",0,0.938271604938272,0,2,2
"src/test/org/apache/lucene/queryParser/TestMultiAnalyzer.java",0,0.530465949820789,2,4,6
"src/test/org/apache/lucene/queryParser/TestMultiFieldQueryParser.java",0,0.627272727272727,3,4,7
"src/test/org/apache/lucene/queryParser/TestQueryParser.java",0,0.27689429373246,7,7,14
"src/test/org/apache/lucene/search/BaseTestRangeFilter.java",0,0.579310344827586,2,4,6
"src/test/org/apache/lucene/search/CachingWrapperFilterHelper.java",0,0.875,1,2,3
"src/test/org/apache/lucene/search/CheckHits.java",0,0.361867704280156,5,5,10
"src/test/org/apache/lucene/search/JustCompileSearch.java",0,0.829218106995885,2,2,4
"src/test/org/apache/lucene/search/MockFilter.java",0,0.575,1,4,5
"src/test/org/apache/lucene/search/QueryUtils.java",0,0.436194895591647,2,5,7
"src/test/org/apache/lucene/search/SingleDocTestFilter.java",0,0.743589743589744,1,3,4
"src/test/org/apache/lucene/search/TestBoolean2.java",0,0.359060402684564,1,4,5
"src/test/org/apache/lucene/search/TestBooleanMinShouldMatch.java",0,0.90537084398977,3,1,4
"src/test/org/apache/lucene/search/TestBooleanOr.java",0,0.74375,3,2,5
"src/test/org/apache/lucene/search/TestBooleanPrefixQuery.java",0,0.707547169811321,3,3,6
"src/test/org/apache/lucene/search/TestBooleanQuery.java",0,0.463157894736842,0,4,4
"src/test/org/apache/lucene/search/TestBooleanScorer.java",0,0.603960396039604,2,3,5
"src/test/org/apache/lucene/search/TestCachingWrapperFilter.java",0,0.442105263157895,1,5,6
"src/test/org/apache/lucene/search/TestComplexExplanations.java",0,0.943820224719101,3,1,4
"src/test/org/apache/lucene/search/TestComplexExplanationsOfNonMatches.java",0,0.875,1,2,3
"src/test/org/apache/lucene/search/TestCustomSearcherSort.java",0,0.564575645756458,0,3,3
"src/test/org/apache/lucene/search/TestDateFilter.java",0,0.590361445783133,4,3,7
"src/test/org/apache/lucene/search/TestDateSort.java",0,0.873949579831933,3,2,5
"src/test/org/apache/lucene/search/TestDisjunctionMaxQuery.java",0,0.731160896130346,3,3,6
"src/test/org/apache/lucene/search/TestDocBoost.java",0,0.525252525252525,1,5,6
"src/test/org/apache/lucene/search/TestDocIdSet.java",0,0.938461538461538,0,2,2
"src/test/org/apache/lucene/search/TestElevationComparator.java",0,0.927777777777778,0,2,2
"src/test/org/apache/lucene/search/TestExplanations.java",0,0.914634146341463,4,1,5
"src/test/org/apache/lucene/search/TestFieldCache.java",0,0.894736842105263,0,2,2
"src/test/org/apache/lucene/search/TestFieldCacheRangeFilter.java",0,0.733102253032929,0,2,2
"src/test/org/apache/lucene/search/TestFieldCacheTermsFilter.java",0,0.947368421052632,2,1,3
"src/test/org/apache/lucene/search/TestFilteredQuery.java",0,0.34841628959276,5,5,10
"src/test/org/apache/lucene/search/TestFilteredSearch.java",0,0.946236559139785,3,1,4
"src/test/org/apache/lucene/search/TestFuzzyQuery.java",0,0.280453257790368,1,6,7
"src/test/org/apache/lucene/search/TestMatchAllDocsQuery.java",0,0.414814814814815,2,5,7
"src/test/org/apache/lucene/search/TestMultiPhraseQuery.java",0,0.727272727272727,4,3,7
"src/test/org/apache/lucene/search/TestMultiSearcher.java",0,0.282608695652174,2,7,9
"src/test/org/apache/lucene/search/TestMultiSearcherRanking.java",0,0.797619047619048,1,4,5
"src/test/org/apache/lucene/search/TestMultiTermConstantScore.java",0,0.971098265895954,2,1,3
"src/test/org/apache/lucene/search/TestMultiThreadTermVectors.java",0,0.724867724867725,4,2,6
"src/test/org/apache/lucene/search/TestMultiValuedNumericRangeQuery.java",0,1,0,1,1
"src/test/org/apache/lucene/search/TestNot.java",0,0.655172413793103,3,4,7
"src/test/org/apache/lucene/search/TestNumericRangeQuery32.java",0,0.99789029535865,1,1,2
"src/test/org/apache/lucene/search/TestNumericRangeQuery64.java",0,0.997863247863248,1,1,2
"src/test/org/apache/lucene/search/TestParallelMultiSearcher.java",0,0.621621621621622,0,3,3
"src/test/org/apache/lucene/search/TestPhrasePrefixQuery.java",0,0.637254901960784,2,4,6
"src/test/org/apache/lucene/search/TestPhraseQuery.java",0,0.266666666666667,4,7,11
"src/test/org/apache/lucene/search/TestPositionIncrement.java",0,0.322493224932249,3,5,8
"src/test/org/apache/lucene/search/TestPositiveScoresOnlyCollector.java",0,0.951807228915663,1,1,2
"src/test/org/apache/lucene/search/TestPrefixFilter.java",0,0.776699029126214,2,2,4
"src/test/org/apache/lucene/search/TestPrefixInBooleanQuery.java",0,0.991228070175439,1,1,2
"src/test/org/apache/lucene/search/TestPrefixQuery.java",0,0.607142857142857,1,5,6
"src/test/org/apache/lucene/search/TestQueryTermVector.java",0,0.866666666666667,1,2,3
"src/test/org/apache/lucene/search/TestQueryWrapperFilter.java",0,0.831325301204819,0,2,2
"src/test/org/apache/lucene/search/TestScoreCachingWrappingScorer.java",0,0.930434782608696,0,2,2
"src/test/org/apache/lucene/search/TestScorerPerf.java",0,0.88433734939759,3,2,5
"src/test/org/apache/lucene/search/TestSetNorm.java",0,0.578947368421053,0,5,5
"src/test/org/apache/lucene/search/TestSimilarity.java",0,0.382022471910112,4,3,7
"src/test/org/apache/lucene/search/TestSimpleExplanations.java",0,0.776280323450135,3,2,5
"src/test/org/apache/lucene/search/TestSimpleExplanationsOfNonMatches.java",0,0.875,1,2,3
"src/test/org/apache/lucene/search/TestSloppyPhraseQuery.java",0,0.974193548387097,3,1,4
"src/test/org/apache/lucene/search/TestSort.java",0,0.672601384767557,4,4,8
"src/test/org/apache/lucene/search/TestSpanQueryFilter.java",0,0.655555555555556,1,3,4
"src/test/org/apache/lucene/search/TestTermRangeFilter.java",0,0.296650717703349,2,5,7
"src/test/org/apache/lucene/search/TestTermRangeQuery.java",0,0.320547945205479,2,5,7
"src/test/org/apache/lucene/search/TestTermScorer.java",0,0.640883977900553,3,3,6
"src/test/org/apache/lucene/search/TestTermVectors.java",0,0.375291375291375,3,5,8
"src/test/org/apache/lucene/search/TestThreadSafe.java",0,0.923076923076923,1,2,3
"src/test/org/apache/lucene/search/TestTimeLimitingCollector.java",0,0.971590909090909,2,1,3
"src/test/org/apache/lucene/search/TestTopDocsCollector.java",0,0.961904761904762,1,1,2
"src/test/org/apache/lucene/search/TestTopScoreDocCollector.java",0,0.866666666666667,0,2,2
"src/test/org/apache/lucene/search/TestWildcard.java",0,0.285714285714286,5,5,10
"src/test/org/apache/lucene/search/function/FunctionTestSetup.java",0,0.924528301886792,1,2,3
"src/test/org/apache/lucene/search/function/JustCompileSearchSpans.java",0,0.908163265306122,0,2,2
"src/test/org/apache/lucene/search/function/TestCustomScoreQuery.java",0,0.961389961389961,2,1,3
"src/test/org/apache/lucene/search/function/TestDocValues.java",0,0.974576271186441,2,1,3
"src/test/org/apache/lucene/search/function/TestFieldScoreQuery.java",0,0.768558951965066,2,2,4
"src/test/org/apache/lucene/search/function/TestOrdValues.java",0,0.742738589211618,1,3,4
"src/test/org/apache/lucene/search/payloads/PayloadHelper.java",0,0.72,2,3,5
"src/test/org/apache/lucene/search/payloads/TestPayloadNearQuery.java",0,0.660516605166052,1,3,4
"src/test/org/apache/lucene/search/payloads/TestPayloadTermQuery.java",0,0.891566265060241,1,2,3
"src/test/org/apache/lucene/search/spans/JustCompileSearchSpans.java",0,0.802721088435374,0,3,3
"src/test/org/apache/lucene/search/spans/TestBasics.java",0,0.625,5,3,8
"src/test/org/apache/lucene/search/spans/TestFieldMaskingSpanQuery.java",0,0.942363112391931,2,1,3
"src/test/org/apache/lucene/search/spans/TestNearSpansOrdered.java",0,0.838888888888889,3,2,5
"src/test/org/apache/lucene/search/spans/TestPayloadSpans.java",0,0.620560747663551,4,2,6
"src/test/org/apache/lucene/search/spans/TestSpanExplanations.java",0,0.969072164948454,1,1,2
"src/test/org/apache/lucene/search/spans/TestSpanExplanationsOfNonMatches.java",0,0.829268292682927,1,2,3
"src/test/org/apache/lucene/search/spans/TestSpans.java",0,0.371369294605809,5,4,9
"src/test/org/apache/lucene/search/spans/TestSpansAdvanced.java",0,0.678571428571429,2,2,4
"src/test/org/apache/lucene/search/spans/TestSpansAdvanced2.java",0,0.796296296296296,1,2,3
"src/test/org/apache/lucene/store/MockRAMDirectory.java",0,0.932551319648094,1,2,3
"src/test/org/apache/lucene/store/MockRAMInputStream.java",0,0.890243902439024,1,2,3
"src/test/org/apache/lucene/store/MockRAMOutputStream.java",0,0.878504672897196,1,2,3
"src/test/org/apache/lucene/store/TestBufferedIndexInput.java",0,0.669291338582677,0,4,4
"src/test/org/apache/lucene/store/TestDirectory.java",0,0.571428571428571,1,2,3
"src/test/org/apache/lucene/store/TestFileSwitchDirectory.java",0,1,0,1,1
"src/test/org/apache/lucene/store/TestHugeRamFile.java",0,0.950980392156863,2,1,3
"src/test/org/apache/lucene/store/TestLock.java",0,0.618181818181818,2,3,5
"src/test/org/apache/lucene/store/TestLockFactory.java",0,0.760309278350515,2,3,5
"src/test/org/apache/lucene/store/TestRAMDirectory.java",0,0.454545454545455,1,4,5
"src/test/org/apache/lucene/store/TestWindowsMMap.java",0,0.541666666666667,0,2,2
"src/test/org/apache/lucene/store/_TestHelper.java",0,0.461538461538462,2,3,5
"src/test/org/apache/lucene/util/ArrayUtilTest.java",0,0.743243243243243,1,2,3
"src/test/org/apache/lucene/util/English.java",0,0.922330097087379,1,2,3
"src/test/org/apache/lucene/util/LocalizedTestCase.java",0,0.972222222222222,1,1,2
"src/test/org/apache/lucene/util/LuceneTestCase.java",0,0.59009009009009,2,2,4
"src/test/org/apache/lucene/util/TestAttributeSource.java",0,0.644578313253012,0,2,2
"src/test/org/apache/lucene/util/TestBitVector.java",0,0.563380281690141,1,3,4
"src/test/org/apache/lucene/util/TestCloseableThreadLocal.java",0,0.980392156862745,1,1,2
"src/test/org/apache/lucene/util/TestFieldCacheSanityChecker.java",0,0.978142076502732,1,1,2
"src/test/org/apache/lucene/util/TestIndexableBinaryStringTools.java",0,0.989304812834225,1,1,2
"src/test/org/apache/lucene/util/TestNumericUtils.java",0,1,0,1,1
"src/test/org/apache/lucene/util/TestOpenBitSet.java",0,0.95,0,2,2
"src/test/org/apache/lucene/util/TestPriorityQueue.java",0,0.546218487394958,2,6,8
"src/test/org/apache/lucene/util/TestRamUsageEstimator.java",0,1,0,1,1
"src/test/org/apache/lucene/util/TestSmallFloat.java",0,0.991071428571429,1,1,2
"src/test/org/apache/lucene/util/TestSortedVIntList.java",0,0.969387755102041,2,1,3
"src/test/org/apache/lucene/util/TestStringHelper.java",0,0.8,0,3,3
"src/test/org/apache/lucene/util/TestStringIntern.java",0,0.98936170212766,1,1,2
"src/test/org/apache/lucene/util/TestVersion.java",0,1,0,1,1
"src/test/org/apache/lucene/util/_TestUtil.java",0,0.816666666666667,2,2,4
"src/test/org/apache/lucene/util/cache/TestSimpleLRUCache.java",0,0.873015873015873,1,2,3
