"Filename","X","LineOWN","LineMinor","LineMajor","LineNumDev"
"lucene/analysis/common/src/java/org/apache/lucene/analysis/ar/ArabicAnalyzer.java",0,0.372549019607843,3,4,7
"lucene/analysis/common/src/java/org/apache/lucene/analysis/ar/ArabicLetterTokenizer.java",0,0.552083333333333,2,3,5
"lucene/analysis/common/src/java/org/apache/lucene/analysis/ar/ArabicNormalizationFilter.java",0,0.708333333333333,2,3,5
"lucene/analysis/common/src/java/org/apache/lucene/analysis/ar/ArabicNormalizer.java",0,0.752475247524752,2,2,4
"lucene/analysis/common/src/java/org/apache/lucene/analysis/ar/ArabicStemFilter.java",0,0.568965517241379,1,4,5
"lucene/analysis/common/src/java/org/apache/lucene/analysis/ar/ArabicStemmer.java",0,0.926666666666667,1,2,3
"lucene/analysis/common/src/java/org/apache/lucene/analysis/bg/BulgarianAnalyzer.java",0,0.83969465648855,3,2,5
"lucene/analysis/common/src/java/org/apache/lucene/analysis/bg/BulgarianStemFilter.java",0,0.862068965517241,1,2,3
"lucene/analysis/common/src/java/org/apache/lucene/analysis/bg/BulgarianStemmer.java",0,0.993006993006993,1,1,2
"lucene/analysis/common/src/java/org/apache/lucene/analysis/br/BrazilianAnalyzer.java",0,0.333333333333333,5,5,10
"lucene/analysis/common/src/java/org/apache/lucene/analysis/br/BrazilianStemFilter.java",0,0.236842105263158,1,6,7
"lucene/analysis/common/src/java/org/apache/lucene/analysis/br/BrazilianStemmer.java",0,0.941234084231146,5,1,6
"lucene/analysis/common/src/java/org/apache/lucene/analysis/ca/CatalanAnalyzer.java",0,0.97972972972973,2,1,3
"lucene/analysis/common/src/java/org/apache/lucene/analysis/charfilter/BaseCharFilter.java",0,0.403669724770642,1,3,4
"lucene/analysis/common/src/java/org/apache/lucene/analysis/charfilter/CharFilter.java",0,0.682926829268293,2,2,4
"lucene/analysis/common/src/java/org/apache/lucene/analysis/charfilter/HTMLStripCharFilter.java",0,0.995200656752234,3,1,4
"lucene/analysis/common/src/java/org/apache/lucene/analysis/charfilter/MappingCharFilter.java",0,0.65989847715736,2,2,4
"lucene/analysis/common/src/java/org/apache/lucene/analysis/charfilter/NormalizeCharMap.java",0,0.734375,2,2,4
"lucene/analysis/common/src/java/org/apache/lucene/analysis/cjk/CJKAnalyzer.java",0,0.471153846153846,2,5,7
"lucene/analysis/common/src/java/org/apache/lucene/analysis/cjk/CJKBigramFilter.java",0,0.996742671009772,1,1,2
"lucene/analysis/common/src/java/org/apache/lucene/analysis/cjk/CJKTokenizer.java",0,0.586750788643533,4,4,8
"lucene/analysis/common/src/java/org/apache/lucene/analysis/cjk/CJKWidthFilter.java",0,0.830357142857143,1,2,3
"lucene/analysis/common/src/java/org/apache/lucene/analysis/cn/ChineseAnalyzer.java",0,0.32,2,6,8
"lucene/analysis/common/src/java/org/apache/lucene/analysis/cn/ChineseFilter.java",0,0.442307692307692,4,6,10
"lucene/analysis/common/src/java/org/apache/lucene/analysis/cn/ChineseTokenizer.java",0,0.428571428571429,5,4,9
"lucene/analysis/common/src/java/org/apache/lucene/analysis/commongrams/CommonGramsFilter.java",0,0.460227272727273,1,3,4
"lucene/analysis/common/src/java/org/apache/lucene/analysis/commongrams/CommonGramsQueryFilter.java",0,0.484126984126984,1,3,4
"lucene/analysis/common/src/java/org/apache/lucene/analysis/compound/CompoundWordTokenFilterBase.java",0,0.377906976744186,3,3,6
"lucene/analysis/common/src/java/org/apache/lucene/analysis/compound/DictionaryCompoundWordTokenFilter.java",0,0.491379310344828,2,3,5
"lucene/analysis/common/src/java/org/apache/lucene/analysis/compound/HyphenationCompoundWordTokenFilter.java",0,0.472340425531915,2,3,5
"lucene/analysis/common/src/java/org/apache/lucene/analysis/compound/hyphenation/ByteVector.java",0,0.991935483870968,1,1,2
"lucene/analysis/common/src/java/org/apache/lucene/analysis/compound/hyphenation/CharVector.java",0,0.97037037037037,3,1,4
"lucene/analysis/common/src/java/org/apache/lucene/analysis/compound/hyphenation/Hyphen.java",0,0.955882352941177,2,1,3
"lucene/analysis/common/src/java/org/apache/lucene/analysis/compound/hyphenation/Hyphenation.java",0,1,0,1,1
"lucene/analysis/common/src/java/org/apache/lucene/analysis/compound/hyphenation/HyphenationException.java",0,1,0,1,1
"lucene/analysis/common/src/java/org/apache/lucene/analysis/compound/hyphenation/HyphenationTree.java",0,0.978813559322034,3,1,4
"lucene/analysis/common/src/java/org/apache/lucene/analysis/compound/hyphenation/PatternConsumer.java",0,0.981818181818182,1,1,2
"lucene/analysis/common/src/java/org/apache/lucene/analysis/compound/hyphenation/PatternParser.java",0,0.927230046948357,2,2,4
"lucene/analysis/common/src/java/org/apache/lucene/analysis/compound/hyphenation/TernaryTree.java",0,0.957831325301205,4,1,5
"lucene/analysis/common/src/java/org/apache/lucene/analysis/core/KeywordAnalyzer.java",0,0.416666666666667,1,7,8
"lucene/analysis/common/src/java/org/apache/lucene/analysis/core/KeywordTokenizer.java",0,0.861386138613861,1,2,3
"lucene/analysis/common/src/java/org/apache/lucene/analysis/core/LetterTokenizer.java",0,0.677083333333333,3,4,7
"lucene/analysis/common/src/java/org/apache/lucene/analysis/core/LowerCaseFilter.java",0,0.409090909090909,1,7,8
"lucene/analysis/common/src/java/org/apache/lucene/analysis/core/LowerCaseTokenizer.java",0,0.602040816326531,3,5,8
"lucene/analysis/common/src/java/org/apache/lucene/analysis/core/SimpleAnalyzer.java",0,0.454545454545455,3,5,8
"lucene/analysis/common/src/java/org/apache/lucene/analysis/core/StopAnalyzer.java",0,0.279279279279279,3,8,11
"lucene/analysis/common/src/java/org/apache/lucene/analysis/core/StopFilter.java",0,0.511627906976744,8,4,12
"lucene/analysis/common/src/java/org/apache/lucene/analysis/core/TypeTokenFilter.java",0,0.814814814814815,0,2,2
"lucene/analysis/common/src/java/org/apache/lucene/analysis/core/WhitespaceAnalyzer.java",0,0.472727272727273,3,5,8
"lucene/analysis/common/src/java/org/apache/lucene/analysis/core/WhitespaceTokenizer.java",0,0.674157303370786,3,4,7
"lucene/analysis/common/src/java/org/apache/lucene/analysis/cz/CzechAnalyzer.java",0,0.513333333333333,7,3,10
"lucene/analysis/common/src/java/org/apache/lucene/analysis/cz/CzechStemFilter.java",0,0.866666666666667,1,2,3
"lucene/analysis/common/src/java/org/apache/lucene/analysis/cz/CzechStemmer.java",0,0.994219653179191,1,1,2
"lucene/analysis/common/src/java/org/apache/lucene/analysis/da/DanishAnalyzer.java",0,0.900763358778626,5,1,6
"lucene/analysis/common/src/java/org/apache/lucene/analysis/de/GermanAnalyzer.java",0,0.412698412698413,7,3,10
"lucene/analysis/common/src/java/org/apache/lucene/analysis/de/GermanLightStemFilter.java",0,0.982758620689655,1,1,2
"lucene/analysis/common/src/java/org/apache/lucene/analysis/de/GermanLightStemmer.java",0,0.992753623188406,1,1,2
"lucene/analysis/common/src/java/org/apache/lucene/analysis/de/GermanMinimalStemFilter.java",0,0.982758620689655,1,1,2
"lucene/analysis/common/src/java/org/apache/lucene/analysis/de/GermanMinimalStemmer.java",0,0.989473684210526,1,1,2
"lucene/analysis/common/src/java/org/apache/lucene/analysis/de/GermanNormalizationFilter.java",0,0.991071428571429,1,1,2
"lucene/analysis/common/src/java/org/apache/lucene/analysis/de/GermanStemFilter.java",0,0.466666666666667,1,5,6
"lucene/analysis/common/src/java/org/apache/lucene/analysis/de/GermanStemmer.java",0,0.925373134328358,4,1,5
"lucene/analysis/common/src/java/org/apache/lucene/analysis/el/GreekAnalyzer.java",0,0.661290322580645,3,3,6
"lucene/analysis/common/src/java/org/apache/lucene/analysis/el/GreekLowerCaseFilter.java",0,0.78125,1,2,3
"lucene/analysis/common/src/java/org/apache/lucene/analysis/el/GreekStemFilter.java",0,0.984126984126984,1,1,2
"lucene/analysis/common/src/java/org/apache/lucene/analysis/el/GreekStemmer.java",0,0.998778998778999,1,1,2
"lucene/analysis/common/src/java/org/apache/lucene/analysis/en/EnglishAnalyzer.java",0,0.914529914529915,4,1,5
"lucene/analysis/common/src/java/org/apache/lucene/analysis/en/EnglishMinimalStemFilter.java",0,0.982758620689655,1,1,2
"lucene/analysis/common/src/java/org/apache/lucene/analysis/en/EnglishMinimalStemmer.java",0,0.978260869565217,1,1,2
"lucene/analysis/common/src/java/org/apache/lucene/analysis/en/EnglishPossessiveFilter.java",0,0.657534246575342,1,2,3
"lucene/analysis/common/src/java/org/apache/lucene/analysis/en/KStemData1.java",0,1,0,1,1
"lucene/analysis/common/src/java/org/apache/lucene/analysis/en/KStemData2.java",0,1,0,1,1
"lucene/analysis/common/src/java/org/apache/lucene/analysis/en/KStemData3.java",0,1,0,1,1
"lucene/analysis/common/src/java/org/apache/lucene/analysis/en/KStemData4.java",0,1,0,1,1
"lucene/analysis/common/src/java/org/apache/lucene/analysis/en/KStemData5.java",0,1,0,1,1
"lucene/analysis/common/src/java/org/apache/lucene/analysis/en/KStemData6.java",0,1,0,1,1
"lucene/analysis/common/src/java/org/apache/lucene/analysis/en/KStemData7.java",0,1,0,1,1
"lucene/analysis/common/src/java/org/apache/lucene/analysis/en/KStemData8.java",0,1,0,1,1
"lucene/analysis/common/src/java/org/apache/lucene/analysis/en/KStemFilter.java",0,0.984126984126984,1,1,2
"lucene/analysis/common/src/java/org/apache/lucene/analysis/en/KStemmer.java",0,0.999344262295082,1,1,2
"lucene/analysis/common/src/java/org/apache/lucene/analysis/en/PorterStemFilter.java",0,0.27536231884058,2,6,8
"lucene/analysis/common/src/java/org/apache/lucene/analysis/en/PorterStemmer.java",0,0.742230347349177,6,2,8
"lucene/analysis/common/src/java/org/apache/lucene/analysis/es/SpanishAnalyzer.java",0,0.915492957746479,5,1,6
"lucene/analysis/common/src/java/org/apache/lucene/analysis/es/SpanishLightStemFilter.java",0,0.982758620689655,1,1,2
"lucene/analysis/common/src/java/org/apache/lucene/analysis/es/SpanishLightStemmer.java",0,0.990825688073395,1,1,2
"lucene/analysis/common/src/java/org/apache/lucene/analysis/eu/BasqueAnalyzer.java",0,0.976744186046512,2,1,3
"lucene/analysis/common/src/java/org/apache/lucene/analysis/fa/PersianAnalyzer.java",0,0.707482993197279,3,3,6
"lucene/analysis/common/src/java/org/apache/lucene/analysis/fa/PersianCharFilter.java",0,0.979166666666667,1,1,2
"lucene/analysis/common/src/java/org/apache/lucene/analysis/fa/PersianNormalizationFilter.java",0,0.94,2,1,3
"lucene/analysis/common/src/java/org/apache/lucene/analysis/fa/PersianNormalizer.java",0,0.839080459770115,1,2,3
"lucene/analysis/common/src/java/org/apache/lucene/analysis/fi/FinnishAnalyzer.java",0,0.900763358778626,5,1,6
"lucene/analysis/common/src/java/org/apache/lucene/analysis/fi/FinnishLightStemFilter.java",0,0.982758620689655,1,1,2
"lucene/analysis/common/src/java/org/apache/lucene/analysis/fi/FinnishLightStemmer.java",0,0.996138996138996,1,1,2
"lucene/analysis/common/src/java/org/apache/lucene/analysis/fr/ElisionFilter.java",0,0.368421052631579,1,5,6
"lucene/analysis/common/src/java/org/apache/lucene/analysis/fr/FrenchAnalyzer.java",0,0.360189573459716,5,5,10
"lucene/analysis/common/src/java/org/apache/lucene/analysis/fr/FrenchLightStemFilter.java",0,0.982758620689655,1,1,2
"lucene/analysis/common/src/java/org/apache/lucene/analysis/fr/FrenchLightStemmer.java",0,0.98876404494382,2,1,3
"lucene/analysis/common/src/java/org/apache/lucene/analysis/fr/FrenchMinimalStemFilter.java",0,0.982758620689655,1,1,2
"lucene/analysis/common/src/java/org/apache/lucene/analysis/fr/FrenchMinimalStemmer.java",0,0.9875,1,1,2
"lucene/analysis/common/src/java/org/apache/lucene/analysis/fr/FrenchStemFilter.java",0,0.444444444444444,2,5,7
"lucene/analysis/common/src/java/org/apache/lucene/analysis/fr/FrenchStemmer.java",0,0.917134831460674,5,1,6
"lucene/analysis/common/src/java/org/apache/lucene/analysis/ga/IrishAnalyzer.java",0,0.993377483443709,1,1,2
"lucene/analysis/common/src/java/org/apache/lucene/analysis/ga/IrishLowerCaseFilter.java",0,0.988235294117647,1,1,2
"lucene/analysis/common/src/java/org/apache/lucene/analysis/gl/GalicianAnalyzer.java",0,0.945736434108527,3,1,4
"lucene/analysis/common/src/java/org/apache/lucene/analysis/gl/GalicianMinimalStemFilter.java",0,0.982758620689655,1,1,2
"lucene/analysis/common/src/java/org/apache/lucene/analysis/gl/GalicianMinimalStemmer.java",0,0.973684210526316,1,1,2
"lucene/analysis/common/src/java/org/apache/lucene/analysis/gl/GalicianStemFilter.java",0,0.983333333333333,1,1,2
"lucene/analysis/common/src/java/org/apache/lucene/analysis/gl/GalicianStemmer.java",0,0.987951807228916,1,1,2
"lucene/analysis/common/src/java/org/apache/lucene/analysis/hi/HindiAnalyzer.java",0,0.944444444444444,3,1,4
"lucene/analysis/common/src/java/org/apache/lucene/analysis/hi/HindiNormalizationFilter.java",0,0.983050847457627,1,1,2
"lucene/analysis/common/src/java/org/apache/lucene/analysis/hi/HindiNormalizer.java",0,0.994475138121547,1,1,2
"lucene/analysis/common/src/java/org/apache/lucene/analysis/hi/HindiStemFilter.java",0,0.979591836734694,1,1,2
"lucene/analysis/common/src/java/org/apache/lucene/analysis/hi/HindiStemmer.java",0,0.991735537190083,1,1,2
"lucene/analysis/common/src/java/org/apache/lucene/analysis/hu/HungarianAnalyzer.java",0,0.900763358778626,5,1,6
"lucene/analysis/common/src/java/org/apache/lucene/analysis/hu/HungarianLightStemFilter.java",0,0.982758620689655,1,1,2
"lucene/analysis/common/src/java/org/apache/lucene/analysis/hu/HungarianLightStemmer.java",0,0.99581589958159,1,1,2
"lucene/analysis/common/src/java/org/apache/lucene/analysis/hunspell/HunspellAffix.java",0,0.993630573248408,1,1,2
"lucene/analysis/common/src/java/org/apache/lucene/analysis/hunspell/HunspellDictionary.java",0,0.912698412698413,2,2,4
"lucene/analysis/common/src/java/org/apache/lucene/analysis/hunspell/HunspellStemFilter.java",0,0.940677966101695,1,2,3
"lucene/analysis/common/src/java/org/apache/lucene/analysis/hunspell/HunspellStemmer.java",0,0.923664122137405,1,2,3
"lucene/analysis/common/src/java/org/apache/lucene/analysis/hunspell/HunspellWord.java",0,0.920634920634921,1,2,3
"lucene/analysis/common/src/java/org/apache/lucene/analysis/hy/ArmenianAnalyzer.java",0,0.976744186046512,2,1,3
"lucene/analysis/common/src/java/org/apache/lucene/analysis/id/IndonesianAnalyzer.java",0,0.968992248062015,3,1,4
"lucene/analysis/common/src/java/org/apache/lucene/analysis/id/IndonesianStemFilter.java",0,0.985074626865672,1,1,2
"lucene/analysis/common/src/java/org/apache/lucene/analysis/id/IndonesianStemmer.java",0,0.996323529411765,1,1,2
"lucene/analysis/common/src/java/org/apache/lucene/analysis/in/IndicNormalizationFilter.java",0,0.978723404255319,1,1,2
"lucene/analysis/common/src/java/org/apache/lucene/analysis/in/IndicNormalizer.java",0,0.996598639455782,1,1,2
"lucene/analysis/common/src/java/org/apache/lucene/analysis/in/IndicTokenizer.java",0,0.981132075471698,1,1,2
"lucene/analysis/common/src/java/org/apache/lucene/analysis/it/ItalianAnalyzer.java",0,0.92948717948718,5,1,6
"lucene/analysis/common/src/java/org/apache/lucene/analysis/it/ItalianLightStemFilter.java",0,0.982758620689655,1,1,2
"lucene/analysis/common/src/java/org/apache/lucene/analysis/it/ItalianLightStemmer.java",0,0.991452991452991,1,1,2
"lucene/analysis/common/src/java/org/apache/lucene/analysis/lv/LatvianAnalyzer.java",0,0.953488372093023,3,1,4
"lucene/analysis/common/src/java/org/apache/lucene/analysis/lv/LatvianStemFilter.java",0,0.982758620689655,1,1,2
"lucene/analysis/common/src/java/org/apache/lucene/analysis/lv/LatvianStemmer.java",0,0.994252873563218,1,1,2
"lucene/analysis/common/src/java/org/apache/lucene/analysis/miscellaneous/ASCIIFoldingFilter.java",0,0.980449657869013,5,1,6
"lucene/analysis/common/src/java/org/apache/lucene/analysis/miscellaneous/CapitalizationFilter.java",0,0.994475138121547,1,1,2
"lucene/analysis/common/src/java/org/apache/lucene/analysis/miscellaneous/EmptyTokenStream.java",0,0.794117647058823,3,2,5
"lucene/analysis/common/src/java/org/apache/lucene/analysis/miscellaneous/HyphenatedWordsFilter.java",0,0.476190476190476,1,4,5
"lucene/analysis/common/src/java/org/apache/lucene/analysis/miscellaneous/KeepWordFilter.java",0,0.63265306122449,2,4,6
"lucene/analysis/common/src/java/org/apache/lucene/analysis/miscellaneous/KeywordMarkerFilter.java",0,0.805970149253731,1,2,3
"lucene/analysis/common/src/java/org/apache/lucene/analysis/miscellaneous/LengthFilter.java",0,0.927272727272727,1,2,3
"lucene/analysis/common/src/java/org/apache/lucene/analysis/miscellaneous/LimitTokenCountAnalyzer.java",0,0.833333333333333,1,2,3
"lucene/analysis/common/src/java/org/apache/lucene/analysis/miscellaneous/LimitTokenCountFilter.java",0,0.982142857142857,1,1,2
"lucene/analysis/common/src/java/org/apache/lucene/analysis/miscellaneous/PatternAnalyzer.java",0,0.561776061776062,6,5,11
"lucene/analysis/common/src/java/org/apache/lucene/analysis/miscellaneous/PerFieldAnalyzerWrapper.java",0,0.236559139784946,1,7,8
"lucene/analysis/common/src/java/org/apache/lucene/analysis/miscellaneous/PrefixAndSuffixAwareTokenFilter.java",0,0.726190476190476,1,3,4
"lucene/analysis/common/src/java/org/apache/lucene/analysis/miscellaneous/PrefixAwareTokenFilter.java",0,0.49009900990099,4,4,8
"lucene/analysis/common/src/java/org/apache/lucene/analysis/miscellaneous/RemoveDuplicatesTokenFilter.java",0,0.517647058823529,1,4,5
"lucene/analysis/common/src/java/org/apache/lucene/analysis/miscellaneous/SingleTokenTokenStream.java",0,0.583333333333333,3,4,7
"lucene/analysis/common/src/java/org/apache/lucene/analysis/miscellaneous/StemmerOverrideFilter.java",0,0.985294117647059,1,1,2
"lucene/analysis/common/src/java/org/apache/lucene/analysis/miscellaneous/TrimFilter.java",0,0.425,0,5,5
"lucene/analysis/common/src/java/org/apache/lucene/analysis/miscellaneous/WordDelimiterFilter.java",0,0.575862068965517,2,4,6
"lucene/analysis/common/src/java/org/apache/lucene/analysis/miscellaneous/WordDelimiterIterator.java",0,0.950920245398773,3,1,4
"lucene/analysis/common/src/java/org/apache/lucene/analysis/ngram/EdgeNGramTokenFilter.java",0,0.570552147239264,2,3,5
"lucene/analysis/common/src/java/org/apache/lucene/analysis/ngram/EdgeNGramTokenizer.java",0,0.4,4,4,8
"lucene/analysis/common/src/java/org/apache/lucene/analysis/ngram/NGramTokenFilter.java",0,0.491379310344828,2,3,5
"lucene/analysis/common/src/java/org/apache/lucene/analysis/ngram/NGramTokenizer.java",0,0.401197604790419,3,4,7
"lucene/analysis/common/src/java/org/apache/lucene/analysis/nl/DutchAnalyzer.java",0,0.570652173913043,7,4,11
"lucene/analysis/common/src/java/org/apache/lucene/analysis/nl/DutchStemFilter.java",0,0.25,3,6,9
"lucene/analysis/common/src/java/org/apache/lucene/analysis/nl/DutchStemmer.java",0,0.843520782396088,6,1,7
"lucene/analysis/common/src/java/org/apache/lucene/analysis/no/NorwegianAnalyzer.java",0,0.901515151515151,5,1,6
"lucene/analysis/common/src/java/org/apache/lucene/analysis/no/NorwegianLightStemFilter.java",0,0.982758620689655,1,1,2
"lucene/analysis/common/src/java/org/apache/lucene/analysis/no/NorwegianLightStemmer.java",0,0.991596638655462,1,1,2
"lucene/analysis/common/src/java/org/apache/lucene/analysis/no/NorwegianMinimalStemFilter.java",0,0.982758620689655,1,1,2
"lucene/analysis/common/src/java/org/apache/lucene/analysis/no/NorwegianMinimalStemmer.java",0,0.988888888888889,1,1,2
"lucene/analysis/common/src/java/org/apache/lucene/analysis/path/PathHierarchyTokenizer.java",0,0.525,1,3,4
"lucene/analysis/common/src/java/org/apache/lucene/analysis/path/ReversePathHierarchyTokenizer.java",0,0.908108108108108,1,2,3
"lucene/analysis/common/src/java/org/apache/lucene/analysis/pattern/PatternReplaceCharFilter.java",0,0.5,2,2,4
"lucene/analysis/common/src/java/org/apache/lucene/analysis/pattern/PatternReplaceFilter.java",0,0.759036144578313,0,3,3
"lucene/analysis/common/src/java/org/apache/lucene/analysis/pattern/PatternTokenizer.java",0,0.769230769230769,3,2,5
"lucene/analysis/common/src/java/org/apache/lucene/analysis/payloads/AbstractEncoder.java",0,0.5,2,3,5
"lucene/analysis/common/src/java/org/apache/lucene/analysis/payloads/DelimitedPayloadTokenFilter.java",0,0.742857142857143,2,3,5
"lucene/analysis/common/src/java/org/apache/lucene/analysis/payloads/FloatEncoder.java",0,0.777777777777778,2,2,4
"lucene/analysis/common/src/java/org/apache/lucene/analysis/payloads/IdentityEncoder.java",0,0.705882352941177,1,3,4
"lucene/analysis/common/src/java/org/apache/lucene/analysis/payloads/IntegerEncoder.java",0,0.864864864864865,1,2,3
"lucene/analysis/common/src/java/org/apache/lucene/analysis/payloads/NumericPayloadTokenFilter.java",0,0.689655172413793,1,4,5
"lucene/analysis/common/src/java/org/apache/lucene/analysis/payloads/PayloadEncoder.java",0,0.761904761904762,1,2,3
"lucene/analysis/common/src/java/org/apache/lucene/analysis/payloads/PayloadHelper.java",0,0.959459459459459,2,1,3
"lucene/analysis/common/src/java/org/apache/lucene/analysis/payloads/TokenOffsetPayloadTokenFilter.java",0,0.625,2,3,5
"lucene/analysis/common/src/java/org/apache/lucene/analysis/payloads/TypeAsPayloadTokenFilter.java",0,0.696428571428571,2,3,5
"lucene/analysis/common/src/java/org/apache/lucene/analysis/position/PositionFilter.java",0,0.752941176470588,2,3,5
"lucene/analysis/common/src/java/org/apache/lucene/analysis/pt/PortugueseAnalyzer.java",0,0.915492957746479,5,1,6
"lucene/analysis/common/src/java/org/apache/lucene/analysis/pt/PortugueseLightStemFilter.java",0,0.982758620689655,1,1,2
"lucene/analysis/common/src/java/org/apache/lucene/analysis/pt/PortugueseLightStemmer.java",0,0.995145631067961,1,1,2
"lucene/analysis/common/src/java/org/apache/lucene/analysis/pt/PortugueseMinimalStemFilter.java",0,0.982758620689655,1,1,2
"lucene/analysis/common/src/java/org/apache/lucene/analysis/pt/PortugueseMinimalStemmer.java",0,0.974358974358974,1,1,2
"lucene/analysis/common/src/java/org/apache/lucene/analysis/pt/PortugueseStemFilter.java",0,0.983333333333333,1,1,2
"lucene/analysis/common/src/java/org/apache/lucene/analysis/pt/PortugueseStemmer.java",0,0.990196078431373,1,1,2
"lucene/analysis/common/src/java/org/apache/lucene/analysis/pt/RSLPStemmerBase.java",0,0.997101449275362,1,1,2
"lucene/analysis/common/src/java/org/apache/lucene/analysis/query/QueryAutoStopWordAnalyzer.java",0,0.462962962962963,3,4,7
"lucene/analysis/common/src/java/org/apache/lucene/analysis/reverse/ReverseStringFilter.java",0,0.604166666666667,2,3,5
"lucene/analysis/common/src/java/org/apache/lucene/analysis/ro/RomanianAnalyzer.java",0,0.925373134328358,4,1,5
"lucene/analysis/common/src/java/org/apache/lucene/analysis/ru/RussianAnalyzer.java",0,0.497109826589595,7,3,10
"lucene/analysis/common/src/java/org/apache/lucene/analysis/ru/RussianLetterTokenizer.java",0,0.515463917525773,1,5,6
"lucene/analysis/common/src/java/org/apache/lucene/analysis/ru/RussianLightStemFilter.java",0,0.982758620689655,1,1,2
"lucene/analysis/common/src/java/org/apache/lucene/analysis/ru/RussianLightStemmer.java",0,0.993464052287582,1,1,2
"lucene/analysis/common/src/java/org/apache/lucene/analysis/shingle/ShingleAnalyzerWrapper.java",0,0.409090909090909,3,4,7
"lucene/analysis/common/src/java/org/apache/lucene/analysis/shingle/ShingleFilter.java",0,0.373626373626374,4,4,8
"lucene/analysis/common/src/java/org/apache/lucene/analysis/sinks/DateRecognizerSinkFilter.java",0,0.791044776119403,1,3,4
"lucene/analysis/common/src/java/org/apache/lucene/analysis/sinks/TeeSinkTokenFilter.java",0,0.888,3,2,5
"lucene/analysis/common/src/java/org/apache/lucene/analysis/sinks/TokenRangeSinkFilter.java",0,0.945454545454545,0,2,2
"lucene/analysis/common/src/java/org/apache/lucene/analysis/sinks/TokenTypeSinkFilter.java",0,0.818181818181818,2,2,4
"lucene/analysis/common/src/java/org/apache/lucene/analysis/snowball/SnowballAnalyzer.java",0,0.363636363636364,6,6,12
"lucene/analysis/common/src/java/org/apache/lucene/analysis/snowball/SnowballFilter.java",0,0.336842105263158,3,6,9
"lucene/analysis/common/src/java/org/apache/lucene/analysis/standard/ClassicAnalyzer.java",0,0.926829268292683,4,1,5
"lucene/analysis/common/src/java/org/apache/lucene/analysis/standard/ClassicFilter.java",0,0.986301369863014,1,1,2
"lucene/analysis/common/src/java/org/apache/lucene/analysis/standard/ClassicTokenizer.java",0,0.934065934065934,1,2,3
"lucene/analysis/common/src/java/org/apache/lucene/analysis/standard/ClassicTokenizerImpl.java",0,0.888888888888889,4,2,6
"lucene/analysis/common/src/java/org/apache/lucene/analysis/standard/StandardAnalyzer.java",0,0.290322580645161,9,5,14
"lucene/analysis/common/src/java/org/apache/lucene/analysis/standard/StandardFilter.java",0,0.716049382716049,1,2,3
"lucene/analysis/common/src/java/org/apache/lucene/analysis/standard/StandardTokenizer.java",0,0.305555555555556,4,5,9
"lucene/analysis/common/src/java/org/apache/lucene/analysis/standard/StandardTokenizerImpl.java",0,0.595667870036101,2,2,4
"lucene/analysis/common/src/java/org/apache/lucene/analysis/standard/StandardTokenizerInterface.java",0,0.842857142857143,1,2,3
"lucene/analysis/common/src/java/org/apache/lucene/analysis/standard/UAX29URLEmailAnalyzer.java",0,0.991150442477876,1,1,2
"lucene/analysis/common/src/java/org/apache/lucene/analysis/standard/UAX29URLEmailTokenizer.java",0,0.513513513513513,1,2,3
"lucene/analysis/common/src/java/org/apache/lucene/analysis/standard/UAX29URLEmailTokenizerImpl.java",0,0.777989065842643,2,2,4
"lucene/analysis/common/src/java/org/apache/lucene/analysis/standard/std31/StandardTokenizerImpl31.java",0,0.990817263544536,2,1,3
"lucene/analysis/common/src/java/org/apache/lucene/analysis/standard/std31/UAX29URLEmailTokenizerImpl31.java",0,0.997004357298475,2,1,3
"lucene/analysis/common/src/java/org/apache/lucene/analysis/standard/std34/UAX29URLEmailTokenizerImpl34.java",0,0.981412639405205,2,1,3
"lucene/analysis/common/src/java/org/apache/lucene/analysis/sv/SwedishAnalyzer.java",0,0.900763358778626,5,1,6
"lucene/analysis/common/src/java/org/apache/lucene/analysis/sv/SwedishLightStemFilter.java",0,0.982758620689655,1,1,2
"lucene/analysis/common/src/java/org/apache/lucene/analysis/sv/SwedishLightStemmer.java",0,0.990990990990991,1,1,2
"lucene/analysis/common/src/java/org/apache/lucene/analysis/synonym/SolrSynonymParser.java",0,0.994413407821229,1,1,2
"lucene/analysis/common/src/java/org/apache/lucene/analysis/synonym/SynonymFilter.java",0,0.760802469135803,3,3,6
"lucene/analysis/common/src/java/org/apache/lucene/analysis/synonym/SynonymMap.java",0,0.838006230529595,3,2,5
"lucene/analysis/common/src/java/org/apache/lucene/analysis/synonym/WordnetSynonymParser.java",0,0.991071428571429,1,1,2
"lucene/analysis/common/src/java/org/apache/lucene/analysis/th/ThaiAnalyzer.java",0,0.661157024793388,3,3,6
"lucene/analysis/common/src/java/org/apache/lucene/analysis/th/ThaiWordFilter.java",0,0.335570469798658,0,4,4
"lucene/analysis/common/src/java/org/apache/lucene/analysis/tr/TurkishAnalyzer.java",0,0.932330827067669,4,1,5
"lucene/analysis/common/src/java/org/apache/lucene/analysis/tr/TurkishLowerCaseFilter.java",0,0.951612903225806,2,1,3
"lucene/analysis/common/src/java/org/apache/lucene/analysis/util/AbstractAnalysisFactory.java",0,0.324468085106383,0,4,4
"lucene/analysis/common/src/java/org/apache/lucene/analysis/util/CharArrayIterator.java",0,0.984375,2,1,3
"lucene/analysis/common/src/java/org/apache/lucene/analysis/util/CharArrayMap.java",0,0.988636363636364,3,1,4
"lucene/analysis/common/src/java/org/apache/lucene/analysis/util/CharArraySet.java",0,0.586666666666667,2,4,6
"lucene/analysis/common/src/java/org/apache/lucene/analysis/util/CharFilterFactory.java",0,0.620689655172414,0,2,2
"lucene/analysis/common/src/java/org/apache/lucene/analysis/util/CharTokenizer.java",0,0.695652173913043,7,3,10
"lucene/analysis/common/src/java/org/apache/lucene/analysis/util/CharacterUtils.java",0,0.517133956386293,1,3,4
"lucene/analysis/common/src/java/org/apache/lucene/analysis/util/FilteringTokenFilter.java",0,0.853211009174312,2,2,4
"lucene/analysis/common/src/java/org/apache/lucene/analysis/util/InitializationException.java",0,0.96875,1,1,2
"lucene/analysis/common/src/java/org/apache/lucene/analysis/util/MultiTermAwareComponent.java",0,0.903225806451613,0,2,2
"lucene/analysis/common/src/java/org/apache/lucene/analysis/util/OpenStringBuilder.java",0,0.993103448275862,1,1,2
"lucene/analysis/common/src/java/org/apache/lucene/analysis/util/ResourceLoader.java",0,0.808510638297872,0,3,3
"lucene/analysis/common/src/java/org/apache/lucene/analysis/util/ResourceLoaderAware.java",0,0.655172413793103,1,3,4
"lucene/analysis/common/src/java/org/apache/lucene/analysis/util/StemmerUtil.java",0,0.990740740740741,1,1,2
"lucene/analysis/common/src/java/org/apache/lucene/analysis/util/StopwordAnalyzerBase.java",0,0.601307189542484,2,2,4
"lucene/analysis/common/src/java/org/apache/lucene/analysis/util/TokenFilterFactory.java",0,0.6,0,2,2
"lucene/analysis/common/src/java/org/apache/lucene/analysis/util/TokenizerFactory.java",0,0.5625,0,2,2
"lucene/analysis/common/src/java/org/apache/lucene/analysis/util/WordlistLoader.java",0,0.366336633663366,3,4,7
"lucene/analysis/common/src/java/org/apache/lucene/analysis/wikipedia/WikipediaTokenizer.java",0,0.525073746312684,2,4,6
"lucene/analysis/common/src/java/org/apache/lucene/analysis/wikipedia/WikipediaTokenizerImpl.java",0,0.682711198428291,3,2,5
"lucene/analysis/common/src/java/org/apache/lucene/collation/CollationAttributeFactory.java",0,0.990291262135922,1,1,2
"lucene/analysis/common/src/java/org/apache/lucene/collation/CollationKeyAnalyzer.java",0,0.557377049180328,2,3,5
"lucene/analysis/common/src/java/org/apache/lucene/collation/CollationKeyFilter.java",0,0.685185185185185,1,5,6
"lucene/analysis/common/src/java/org/apache/lucene/collation/tokenattributes/CollatedTermAttributeImpl.java",0,0.529411764705882,1,2,3
"lucene/analysis/common/src/java/org/tartarus/snowball/Among.java",0,0.410958904109589,2,3,5
"lucene/analysis/common/src/java/org/tartarus/snowball/SnowballProgram.java",0,0.699604743083004,2,3,5
"lucene/analysis/common/src/java/org/tartarus/snowball/ext/ArmenianStemmer.java",0,1,0,1,1
"lucene/analysis/common/src/java/org/tartarus/snowball/ext/BasqueStemmer.java",0,1,0,1,1
"lucene/analysis/common/src/java/org/tartarus/snowball/ext/CatalanStemmer.java",0,1,0,1,1
"lucene/analysis/common/src/java/org/tartarus/snowball/ext/DanishStemmer.java",0,0.770685579196217,0,2,2
"lucene/analysis/common/src/java/org/tartarus/snowball/ext/DutchStemmer.java",0,0.996415770609319,1,1,2
"lucene/analysis/common/src/java/org/tartarus/snowball/ext/EnglishStemmer.java",0,0.700913242009132,0,2,2
"lucene/analysis/common/src/java/org/tartarus/snowball/ext/FinnishStemmer.java",0,0.981624758220503,1,1,2
"lucene/analysis/common/src/java/org/tartarus/snowball/ext/FrenchStemmer.java",0,0.784810126582278,0,2,2
"lucene/analysis/common/src/java/org/tartarus/snowball/ext/German2Stemmer.java",0,0.831955922865014,0,2,2
"lucene/analysis/common/src/java/org/tartarus/snowball/ext/GermanStemmer.java",0,0.822674418604651,0,2,2
"lucene/analysis/common/src/java/org/tartarus/snowball/ext/HungarianStemmer.java",0,1,0,1,1
"lucene/analysis/common/src/java/org/tartarus/snowball/ext/IrishStemmer.java",0,1,0,1,1
"lucene/analysis/common/src/java/org/tartarus/snowball/ext/ItalianStemmer.java",0,0.898305084745763,0,2,2
"lucene/analysis/common/src/java/org/tartarus/snowball/ext/KpStemmer.java",0,0.998165978908757,1,1,2
"lucene/analysis/common/src/java/org/tartarus/snowball/ext/LovinsStemmer.java",0,0.935010482180293,1,2,3
"lucene/analysis/common/src/java/org/tartarus/snowball/ext/NorwegianStemmer.java",0,0.720670391061452,0,2,2
"lucene/analysis/common/src/java/org/tartarus/snowball/ext/PorterStemmer.java",0,0.996688741721854,1,1,2
"lucene/analysis/common/src/java/org/tartarus/snowball/ext/PortugueseStemmer.java",0,0.861111111111111,1,2,3
"lucene/analysis/common/src/java/org/tartarus/snowball/ext/RomanianStemmer.java",0,1,0,1,1
"lucene/analysis/common/src/java/org/tartarus/snowball/ext/RussianStemmer.java",0,0.635488308115543,0,2,2
"lucene/analysis/common/src/java/org/tartarus/snowball/ext/SpanishStemmer.java",0,0.879864636209814,0,2,2
"lucene/analysis/common/src/java/org/tartarus/snowball/ext/SwedishStemmer.java",0,0.925501432664756,0,2,2
"lucene/analysis/common/src/java/org/tartarus/snowball/ext/TurkishStemmer.java",0,1,0,1,1
"lucene/analysis/common/src/test/org/apache/lucene/analysis/ar/TestArabicAnalyzer.java",0,0.495049504950495,2,3,5
"lucene/analysis/common/src/test/org/apache/lucene/analysis/ar/TestArabicLetterTokenizer.java",0,0.936170212765957,2,1,3
"lucene/analysis/common/src/test/org/apache/lucene/analysis/ar/TestArabicNormalizationFilter.java",0,0.813084112149533,2,2,4
"lucene/analysis/common/src/test/org/apache/lucene/analysis/ar/TestArabicStemFilter.java",0,0.76027397260274,1,3,4
"lucene/analysis/common/src/test/org/apache/lucene/analysis/bg/TestBulgarianAnalyzer.java",0,0.851851851851852,2,2,4
"lucene/analysis/common/src/test/org/apache/lucene/analysis/bg/TestBulgarianStemmer.java",0,0.941422594142259,1,2,3
"lucene/analysis/common/src/test/org/apache/lucene/analysis/br/TestBrazilianStemmer.java",0,0.634831460674157,2,3,5
"lucene/analysis/common/src/test/org/apache/lucene/analysis/ca/TestCatalanAnalyzer.java",0,0.968253968253968,2,1,3
"lucene/analysis/common/src/test/org/apache/lucene/analysis/charfilter/HTMLStripCharFilterTest.java",0,0.724418604651163,4,3,7
"lucene/analysis/common/src/test/org/apache/lucene/analysis/charfilter/TestCharFilter.java",0,0.930555555555556,1,2,3
"lucene/analysis/common/src/test/org/apache/lucene/analysis/charfilter/TestMappingCharFilter.java",0,0.648648648648649,2,3,5
"lucene/analysis/common/src/test/org/apache/lucene/analysis/cjk/TestCJKAnalyzer.java",0,0.972789115646258,3,1,4
"lucene/analysis/common/src/test/org/apache/lucene/analysis/cjk/TestCJKTokenizer.java",0,0.505338078291815,3,3,6
"lucene/analysis/common/src/test/org/apache/lucene/analysis/cjk/TestCJKWidthFilter.java",0,0.974683544303797,2,1,3
"lucene/analysis/common/src/test/org/apache/lucene/analysis/cn/TestChineseTokenizer.java",0,0.563492063492063,7,4,11
"lucene/analysis/common/src/test/org/apache/lucene/analysis/commongrams/CommonGramsFilterTest.java",0,0.526785714285714,3,3,6
"lucene/analysis/common/src/test/org/apache/lucene/analysis/compound/TestCompoundWordTokenFilter.java",0,0.469387755102041,3,3,6
"lucene/analysis/common/src/test/org/apache/lucene/analysis/core/TestAnalyzers.java",0,0.390243902439024,6,5,11
"lucene/analysis/common/src/test/org/apache/lucene/analysis/core/TestBugInSomething.java",0,0.96969696969697,2,1,3
"lucene/analysis/common/src/test/org/apache/lucene/analysis/core/TestClassicAnalyzer.java",0,0.908256880733945,3,2,5
"lucene/analysis/common/src/test/org/apache/lucene/analysis/core/TestDuelingAnalyzers.java",0,0.953488372093023,2,1,3
"lucene/analysis/common/src/test/org/apache/lucene/analysis/core/TestKeywordAnalyzer.java",0,0.325757575757576,5,5,10
"lucene/analysis/common/src/test/org/apache/lucene/analysis/core/TestRandomChains.java",0,0.751152073732719,2,3,5
"lucene/analysis/common/src/test/org/apache/lucene/analysis/core/TestStandardAnalyzer.java",0,0.572490706319703,5,4,9
"lucene/analysis/common/src/test/org/apache/lucene/analysis/core/TestStopAnalyzer.java",0,0.247311827956989,4,8,12
"lucene/analysis/common/src/test/org/apache/lucene/analysis/core/TestStopFilter.java",0,0.458100558659218,3,2,5
"lucene/analysis/common/src/test/org/apache/lucene/analysis/core/TestTypeTokenFilter.java",0,0.92,0,2,2
"lucene/analysis/common/src/test/org/apache/lucene/analysis/core/TestUAX29URLEmailAnalyzer.java",0,0.99625468164794,1,1,2
"lucene/analysis/common/src/test/org/apache/lucene/analysis/core/TestUAX29URLEmailTokenizer.java",0,0.847695390781563,3,2,5
"lucene/analysis/common/src/test/org/apache/lucene/analysis/core/WordBreakTestUnicode_6_0_0.java",0,0.999747474747475,1,1,2
"lucene/analysis/common/src/test/org/apache/lucene/analysis/cz/TestCzechAnalyzer.java",0,0.44,2,3,5
"lucene/analysis/common/src/test/org/apache/lucene/analysis/cz/TestCzechStemmer.java",0,0.946666666666667,1,2,3
"lucene/analysis/common/src/test/org/apache/lucene/analysis/da/TestDanishAnalyzer.java",0,0.910714285714286,2,2,4
"lucene/analysis/common/src/test/org/apache/lucene/analysis/de/TestGermanAnalyzer.java",0,0.929577464788732,3,1,4
"lucene/analysis/common/src/test/org/apache/lucene/analysis/de/TestGermanLightStemFilter.java",0,0.953125,3,1,4
"lucene/analysis/common/src/test/org/apache/lucene/analysis/de/TestGermanMinimalStemFilter.java",0,0.960526315789474,3,1,4
"lucene/analysis/common/src/test/org/apache/lucene/analysis/de/TestGermanNormalizationFilter.java",0,0.975,2,1,3
"lucene/analysis/common/src/test/org/apache/lucene/analysis/de/TestGermanStemFilter.java",0,0.552631578947368,5,3,8
"lucene/analysis/common/src/test/org/apache/lucene/analysis/el/GreekAnalyzerTest.java",0,0.6,3,2,5
"lucene/analysis/common/src/test/org/apache/lucene/analysis/el/TestGreekStemmer.java",0,0.99815157116451,1,1,2
"lucene/analysis/common/src/test/org/apache/lucene/analysis/en/TestEnglishAnalyzer.java",0,0.883333333333333,3,2,5
"lucene/analysis/common/src/test/org/apache/lucene/analysis/en/TestEnglishMinimalStemFilter.java",0,0.957142857142857,3,1,4
"lucene/analysis/common/src/test/org/apache/lucene/analysis/en/TestKStemmer.java",0,0.96875,3,1,4
"lucene/analysis/common/src/test/org/apache/lucene/analysis/en/TestPorterStemFilter.java",0,0.873417721518987,3,2,5
"lucene/analysis/common/src/test/org/apache/lucene/analysis/es/TestSpanishAnalyzer.java",0,0.910714285714286,2,2,4
"lucene/analysis/common/src/test/org/apache/lucene/analysis/es/TestSpanishLightStemFilter.java",0,0.953125,3,1,4
"lucene/analysis/common/src/test/org/apache/lucene/analysis/eu/TestBasqueAnalyzer.java",0,0.964285714285714,2,1,3
"lucene/analysis/common/src/test/org/apache/lucene/analysis/fa/TestPersianAnalyzer.java",0,0.956331877729258,4,1,5
"lucene/analysis/common/src/test/org/apache/lucene/analysis/fa/TestPersianNormalizationFilter.java",0,0.924050632911392,1,2,3
"lucene/analysis/common/src/test/org/apache/lucene/analysis/fi/TestFinnishAnalyzer.java",0,0.910714285714286,2,2,4
"lucene/analysis/common/src/test/org/apache/lucene/analysis/fi/TestFinnishLightStemFilter.java",0,0.953125,3,1,4
"lucene/analysis/common/src/test/org/apache/lucene/analysis/fr/TestElision.java",0,0.591549295774648,1,3,4
"lucene/analysis/common/src/test/org/apache/lucene/analysis/fr/TestFrenchAnalyzer.java",0,0.563636363636364,4,4,8
"lucene/analysis/common/src/test/org/apache/lucene/analysis/fr/TestFrenchLightStemFilter.java",0,0.902061855670103,3,2,5
"lucene/analysis/common/src/test/org/apache/lucene/analysis/fr/TestFrenchMinimalStemFilter.java",0,0.961538461538462,3,1,4
"lucene/analysis/common/src/test/org/apache/lucene/analysis/ga/TestIrishAnalyzer.java",0,0.971830985915493,2,1,3
"lucene/analysis/common/src/test/org/apache/lucene/analysis/ga/TestIrishLowerCaseFilter.java",0,0.982456140350877,1,1,2
"lucene/analysis/common/src/test/org/apache/lucene/analysis/gl/TestGalicianAnalyzer.java",0,0.964285714285714,2,1,3
"lucene/analysis/common/src/test/org/apache/lucene/analysis/gl/TestGalicianMinimalStemFilter.java",0,0.970588235294118,2,1,3
"lucene/analysis/common/src/test/org/apache/lucene/analysis/gl/TestGalicianStemFilter.java",0,0.968253968253968,2,1,3
"lucene/analysis/common/src/test/org/apache/lucene/analysis/hi/TestHindiAnalyzer.java",0,0.903846153846154,2,2,4
"lucene/analysis/common/src/test/org/apache/lucene/analysis/hi/TestHindiNormalizer.java",0,0.9875,1,1,2
"lucene/analysis/common/src/test/org/apache/lucene/analysis/hi/TestHindiStemmer.java",0,0.990196078431373,1,1,2
"lucene/analysis/common/src/test/org/apache/lucene/analysis/hu/TestHungarianAnalyzer.java",0,0.910714285714286,2,2,4
"lucene/analysis/common/src/test/org/apache/lucene/analysis/hu/TestHungarianLightStemFilter.java",0,0.966101694915254,2,1,3
"lucene/analysis/common/src/test/org/apache/lucene/analysis/hunspell/HunspellDictionaryTest.java",0,0.943181818181818,3,1,4
"lucene/analysis/common/src/test/org/apache/lucene/analysis/hunspell/HunspellStemFilterTest.java",0,0.670454545454545,2,2,4
"lucene/analysis/common/src/test/org/apache/lucene/analysis/hunspell/HunspellStemmerTest.java",0,0.519685039370079,2,2,4
"lucene/analysis/common/src/test/org/apache/lucene/analysis/hy/TestArmenianAnalyzer.java",0,0.964285714285714,2,1,3
"lucene/analysis/common/src/test/org/apache/lucene/analysis/id/TestIndonesianAnalyzer.java",0,0.964285714285714,2,1,3
"lucene/analysis/common/src/test/org/apache/lucene/analysis/id/TestIndonesianStemmer.java",0,0.979452054794521,2,1,3
"lucene/analysis/common/src/test/org/apache/lucene/analysis/in/TestIndicNormalizer.java",0,0.984615384615385,1,1,2
"lucene/analysis/common/src/test/org/apache/lucene/analysis/it/TestItalianAnalyzer.java",0,0.931506849315068,3,1,4
"lucene/analysis/common/src/test/org/apache/lucene/analysis/it/TestItalianLightStemFilter.java",0,0.953125,3,1,4
"lucene/analysis/common/src/test/org/apache/lucene/analysis/lv/TestLatvianAnalyzer.java",0,0.964285714285714,2,1,3
"lucene/analysis/common/src/test/org/apache/lucene/analysis/lv/TestLatvianStemmer.java",0,0.992932862190813,2,1,3
"lucene/analysis/common/src/test/org/apache/lucene/analysis/miscellaneous/PatternAnalyzerTest.java",0,0.74585635359116,7,2,9
"lucene/analysis/common/src/test/org/apache/lucene/analysis/miscellaneous/TestASCIIFoldingFilter.java",0,0.931923671995874,6,1,7
"lucene/analysis/common/src/test/org/apache/lucene/analysis/miscellaneous/TestCapitalizationFilter.java",0,0.986486486486487,2,1,3
"lucene/analysis/common/src/test/org/apache/lucene/analysis/miscellaneous/TestEmptyTokenStream.java",0,0.852941176470588,1,3,4
"lucene/analysis/common/src/test/org/apache/lucene/analysis/miscellaneous/TestHyphenatedWordsFilter.java",0,0.533333333333333,3,3,6
"lucene/analysis/common/src/test/org/apache/lucene/analysis/miscellaneous/TestKeepWordFilter.java",0,0.817073170731707,2,2,4
"lucene/analysis/common/src/test/org/apache/lucene/analysis/miscellaneous/TestKeywordMarkerFilter.java",0,0.659340659340659,1,2,3
"lucene/analysis/common/src/test/org/apache/lucene/analysis/miscellaneous/TestLengthFilter.java",0,0.316666666666667,2,4,6
"lucene/analysis/common/src/test/org/apache/lucene/analysis/miscellaneous/TestLimitTokenCountAnalyzer.java",0,0.513888888888889,5,2,7
"lucene/analysis/common/src/test/org/apache/lucene/analysis/miscellaneous/TestPerFieldAnalzyerWrapper.java",0,0.366666666666667,2,6,8
"lucene/analysis/common/src/test/org/apache/lucene/analysis/miscellaneous/TestPrefixAndSuffixAwareTokenFilter.java",0,0.652173913043478,1,4,5
"lucene/analysis/common/src/test/org/apache/lucene/analysis/miscellaneous/TestPrefixAwareTokenFilter.java",0,0.631578947368421,2,4,6
"lucene/analysis/common/src/test/org/apache/lucene/analysis/miscellaneous/TestRemoveDuplicatesTokenFilter.java",0,0.49171270718232,2,3,5
"lucene/analysis/common/src/test/org/apache/lucene/analysis/miscellaneous/TestSingleTokenTokenFilter.java",0,0.604166666666667,2,2,4
"lucene/analysis/common/src/test/org/apache/lucene/analysis/miscellaneous/TestStemmerOverrideFilter.java",0,0.952380952380952,2,1,3
"lucene/analysis/common/src/test/org/apache/lucene/analysis/miscellaneous/TestTrimFilter.java",0,0.38255033557047,3,4,7
"lucene/analysis/common/src/test/org/apache/lucene/analysis/miscellaneous/TestWordDelimiterFilter.java",0,0.4,2,5,7
"lucene/analysis/common/src/test/org/apache/lucene/analysis/ngram/EdgeNGramTokenFilterTest.java",0,0.441489361702128,3,3,6
"lucene/analysis/common/src/test/org/apache/lucene/analysis/ngram/EdgeNGramTokenizerTest.java",0,0.64,4,2,6
"lucene/analysis/common/src/test/org/apache/lucene/analysis/ngram/NGramTokenFilterTest.java",0,0.746666666666667,4,2,6
"lucene/analysis/common/src/test/org/apache/lucene/analysis/ngram/NGramTokenizerTest.java",0,0.638888888888889,5,2,7
"lucene/analysis/common/src/test/org/apache/lucene/analysis/nl/TestDutchStemmer.java",0,0.545,2,3,5
"lucene/analysis/common/src/test/org/apache/lucene/analysis/no/TestNorwegianAnalyzer.java",0,0.910714285714286,2,2,4
"lucene/analysis/common/src/test/org/apache/lucene/analysis/no/TestNorwegianLightStemFilter.java",0,0.776119402985075,2,2,4
"lucene/analysis/common/src/test/org/apache/lucene/analysis/no/TestNorwegianMinimalStemFilter.java",0,0.776119402985075,2,2,4
"lucene/analysis/common/src/test/org/apache/lucene/analysis/path/TestPathHierarchyTokenizer.java",0,0.561946902654867,3,3,6
"lucene/analysis/common/src/test/org/apache/lucene/analysis/path/TestReversePathHierarchyTokenizer.java",0,0.834224598930481,2,2,4
"lucene/analysis/common/src/test/org/apache/lucene/analysis/pattern/TestPatternReplaceCharFilter.java",0,0.466666666666667,1,4,5
"lucene/analysis/common/src/test/org/apache/lucene/analysis/pattern/TestPatternReplaceFilter.java",0,0.383333333333333,1,4,5
"lucene/analysis/common/src/test/org/apache/lucene/analysis/pattern/TestPatternTokenizer.java",0,0.961783439490446,3,1,4
"lucene/analysis/common/src/test/org/apache/lucene/analysis/payloads/DelimitedPayloadTokenFilterTest.java",0,0.764285714285714,3,3,6
"lucene/analysis/common/src/test/org/apache/lucene/analysis/payloads/NumericPayloadTokenFilterTest.java",0,0.58974358974359,1,4,5
"lucene/analysis/common/src/test/org/apache/lucene/analysis/payloads/TokenOffsetPayloadTokenFilterTest.java",0,0.716981132075472,0,5,5
"lucene/analysis/common/src/test/org/apache/lucene/analysis/payloads/TypeAsPayloadTokenFilterTest.java",0,0.605633802816901,1,4,5
"lucene/analysis/common/src/test/org/apache/lucene/analysis/position/PositionFilterTest.java",0,0.631205673758865,2,3,5
"lucene/analysis/common/src/test/org/apache/lucene/analysis/pt/TestPortugueseAnalyzer.java",0,0.910714285714286,2,2,4
"lucene/analysis/common/src/test/org/apache/lucene/analysis/pt/TestPortugueseLightStemFilter.java",0,0.972972972972973,3,1,4
"lucene/analysis/common/src/test/org/apache/lucene/analysis/pt/TestPortugueseMinimalStemFilter.java",0,0.964705882352941,3,1,4
"lucene/analysis/common/src/test/org/apache/lucene/analysis/pt/TestPortugueseStemFilter.java",0,0.964705882352941,3,1,4
"lucene/analysis/common/src/test/org/apache/lucene/analysis/query/QueryAutoStopWordAnalyzerTest.java",0,0.457142857142857,4,3,7
"lucene/analysis/common/src/test/org/apache/lucene/analysis/reverse/TestReverseStringFilter.java",0,0.330708661417323,2,4,6
"lucene/analysis/common/src/test/org/apache/lucene/analysis/ro/TestRomanianAnalyzer.java",0,0.910714285714286,2,2,4
"lucene/analysis/common/src/test/org/apache/lucene/analysis/ru/TestRussianAnalyzer.java",0,0.388888888888889,4,4,8
"lucene/analysis/common/src/test/org/apache/lucene/analysis/ru/TestRussianLetterTokenizer.java",0,0.914893617021277,3,1,4
"lucene/analysis/common/src/test/org/apache/lucene/analysis/ru/TestRussianLightStemFilter.java",0,0.953125,3,1,4
"lucene/analysis/common/src/test/org/apache/lucene/analysis/shingle/ShingleAnalyzerWrapperTest.java",0,0.453074433656958,6,3,9
"lucene/analysis/common/src/test/org/apache/lucene/analysis/shingle/ShingleFilterTest.java",0,0.456095481670929,6,4,10
"lucene/analysis/common/src/test/org/apache/lucene/analysis/sinks/DateRecognizerSinkTokenizerTest.java",0,0.62,0,4,4
"lucene/analysis/common/src/test/org/apache/lucene/analysis/sinks/TestTeeSinkTokenFilter.java",0,0.602112676056338,3,3,6
"lucene/analysis/common/src/test/org/apache/lucene/analysis/sinks/TokenRangeSinkTokenizerTest.java",0,0.583333333333333,1,3,4
"lucene/analysis/common/src/test/org/apache/lucene/analysis/sinks/TokenTypeSinkTokenizerTest.java",0,0.525,2,3,5
"lucene/analysis/common/src/test/org/apache/lucene/analysis/snowball/TestSnowball.java",0,0.321212121212121,3,6,9
"lucene/analysis/common/src/test/org/apache/lucene/analysis/snowball/TestSnowballVocab.java",0,0.963855421686747,3,1,4
"lucene/analysis/common/src/test/org/apache/lucene/analysis/sv/TestSwedishAnalyzer.java",0,0.910714285714286,2,2,4
"lucene/analysis/common/src/test/org/apache/lucene/analysis/sv/TestSwedishLightStemFilter.java",0,0.953125,3,1,4
"lucene/analysis/common/src/test/org/apache/lucene/analysis/synonym/TestSolrSynonymParser.java",0,0.944055944055944,3,1,4
"lucene/analysis/common/src/test/org/apache/lucene/analysis/synonym/TestSynonymMapFilter.java",0,0.790137614678899,3,2,5
"lucene/analysis/common/src/test/org/apache/lucene/analysis/synonym/TestWordnetSynonymParser.java",0,0.957746478873239,3,1,4
"lucene/analysis/common/src/test/org/apache/lucene/analysis/th/TestThaiAnalyzer.java",0,0.5,6,3,9
"lucene/analysis/common/src/test/org/apache/lucene/analysis/tr/TestTurkishAnalyzer.java",0,0.910714285714286,2,2,4
"lucene/analysis/common/src/test/org/apache/lucene/analysis/tr/TestTurkishLowerCaseFilter.java",0,0.703703703703704,1,2,3
"lucene/analysis/common/src/test/org/apache/lucene/analysis/util/TestCharArrayIterator.java",0,0.975308641975309,3,1,4
"lucene/analysis/common/src/test/org/apache/lucene/analysis/util/TestCharArrayMap.java",0,0.955102040816327,4,1,5
"lucene/analysis/common/src/test/org/apache/lucene/analysis/util/TestCharArraySet.java",0,0.594488188976378,4,3,7
"lucene/analysis/common/src/test/org/apache/lucene/analysis/util/TestCharTokenizers.java",0,0.486033519553073,3,2,5
"lucene/analysis/common/src/test/org/apache/lucene/analysis/util/TestCharacterUtils.java",0,0.948453608247423,2,1,3
"lucene/analysis/common/src/test/org/apache/lucene/analysis/util/TestWordlistLoader.java",0,0.392405063291139,2,5,7
"lucene/analysis/common/src/test/org/apache/lucene/analysis/wikipedia/WikipediaTokenizerTest.java",0,0.605911330049261,4,2,6
"lucene/analysis/common/src/test/org/apache/lucene/collation/TestCollationKeyAnalyzer.java",0,0.622222222222222,2,2,4
"lucene/analysis/common/src/test/org/apache/lucene/collation/TestCollationKeyFilter.java",0,0.676470588235294,3,2,5
"lucene/analysis/common/src/tools/java/org/apache/lucene/analysis/standard/GenerateJflexTLDMacros.java",0,1,0,1,1
"lucene/analysis/icu/src/java/org/apache/lucene/analysis/icu/ICUFoldingFilter.java",0,0.986486486486487,1,1,2
"lucene/analysis/icu/src/java/org/apache/lucene/analysis/icu/ICUNormalizer2Filter.java",0,0.989010989010989,1,1,2
"lucene/analysis/icu/src/java/org/apache/lucene/analysis/icu/ICUTransformFilter.java",0,0.994565217391304,1,1,2
"lucene/analysis/icu/src/java/org/apache/lucene/analysis/icu/segmentation/BreakIteratorWrapper.java",0,0.994152046783626,1,1,2
"lucene/analysis/icu/src/java/org/apache/lucene/analysis/icu/segmentation/CharArrayIterator.java",0,0.983050847457627,2,1,3
"lucene/analysis/icu/src/java/org/apache/lucene/analysis/icu/segmentation/CompositeBreakIterator.java",0,0.992063492063492,1,1,2
"lucene/analysis/icu/src/java/org/apache/lucene/analysis/icu/segmentation/DefaultICUTokenizerConfig.java",0,0.991525423728814,1,1,2
"lucene/analysis/icu/src/java/org/apache/lucene/analysis/icu/segmentation/ICUTokenizer.java",0,0.901869158878505,1,2,3
"lucene/analysis/icu/src/java/org/apache/lucene/analysis/icu/segmentation/ICUTokenizerConfig.java",0,0.96969696969697,1,1,2
"lucene/analysis/icu/src/java/org/apache/lucene/analysis/icu/segmentation/LaoBreakIterator.java",0,0.97787610619469,2,1,3
"lucene/analysis/icu/src/java/org/apache/lucene/analysis/icu/segmentation/ScriptIterator.java",0,0.988304093567251,1,1,2
"lucene/analysis/icu/src/java/org/apache/lucene/analysis/icu/tokenattributes/ScriptAttribute.java",0,0.980392156862745,1,1,2
"lucene/analysis/icu/src/java/org/apache/lucene/analysis/icu/tokenattributes/ScriptAttributeImpl.java",0,0.951219512195122,2,1,3
"lucene/analysis/icu/src/java/org/apache/lucene/collation/ICUCollationAttributeFactory.java",0,0.989690721649485,1,1,2
"lucene/analysis/icu/src/java/org/apache/lucene/collation/ICUCollationKeyAnalyzer.java",0,0.526315789473684,2,3,5
"lucene/analysis/icu/src/java/org/apache/lucene/collation/ICUCollationKeyFilter.java",0,0.666666666666667,1,4,5
"lucene/analysis/icu/src/java/org/apache/lucene/collation/tokenattributes/ICUCollatedTermAttributeImpl.java",0,0.982142857142857,1,1,2
"lucene/analysis/icu/src/test/org/apache/lucene/analysis/icu/TestICUFoldingFilter.java",0,0.934782608695652,3,1,4
"lucene/analysis/icu/src/test/org/apache/lucene/analysis/icu/TestICUNormalizer2Filter.java",0,0.880434782608696,2,2,4
"lucene/analysis/icu/src/test/org/apache/lucene/analysis/icu/TestICUTransformFilter.java",0,0.973684210526316,3,1,4
"lucene/analysis/icu/src/test/org/apache/lucene/analysis/icu/segmentation/TestCharArrayIterator.java",0,0.981651376146789,2,1,3
"lucene/analysis/icu/src/test/org/apache/lucene/analysis/icu/segmentation/TestICUTokenizer.java",0,0.963414634146341,4,1,5
"lucene/analysis/icu/src/test/org/apache/lucene/analysis/icu/segmentation/TestLaoBreakIterator.java",0,0.988888888888889,1,1,2
"lucene/analysis/icu/src/test/org/apache/lucene/analysis/icu/segmentation/TestWithCJKBigramFilter.java",0,0.995575221238938,1,1,2
"lucene/analysis/icu/src/test/org/apache/lucene/collation/TestICUCollationKeyAnalyzer.java",0,0.670212765957447,2,2,4
"lucene/analysis/icu/src/test/org/apache/lucene/collation/TestICUCollationKeyFilter.java",0,0.73469387755102,2,3,5
"lucene/analysis/icu/src/tools/java/org/apache/lucene/analysis/icu/GenerateHTMLStripCharFilterSupplementaryMacros.java",0,0.990909090909091,1,1,2
"lucene/analysis/icu/src/tools/java/org/apache/lucene/analysis/icu/GenerateJFlexSupplementaryMacros.java",0,0.991228070175439,1,1,2
"lucene/analysis/icu/src/tools/java/org/apache/lucene/analysis/icu/RBBIRuleCompiler.java",0,0.989473684210526,1,1,2
"lucene/analysis/kuromoji/src/java/org/apache/lucene/analysis/ja/GraphvizFormatter.java",0,0.977900552486188,2,1,3
"lucene/analysis/kuromoji/src/java/org/apache/lucene/analysis/ja/JapaneseAnalyzer.java",0,0.808080808080808,1,2,3
"lucene/analysis/kuromoji/src/java/org/apache/lucene/analysis/ja/JapaneseBaseFormFilter.java",0,0.919354838709677,1,2,3
"lucene/analysis/kuromoji/src/java/org/apache/lucene/analysis/ja/JapaneseKatakanaStemFilter.java",0,0.989795918367347,1,1,2
"lucene/analysis/kuromoji/src/java/org/apache/lucene/analysis/ja/JapanesePartOfSpeechStopFilter.java",0,0.886363636363636,1,2,3
"lucene/analysis/kuromoji/src/java/org/apache/lucene/analysis/ja/JapaneseReadingFormFilter.java",0,0.984615384615385,1,1,2
"lucene/analysis/kuromoji/src/java/org/apache/lucene/analysis/ja/JapaneseTokenizer.java",0,0.885895404120444,2,2,4
"lucene/analysis/kuromoji/src/java/org/apache/lucene/analysis/ja/Token.java",0,0.834285714285714,2,2,4
"lucene/analysis/kuromoji/src/java/org/apache/lucene/analysis/ja/dict/BinaryDictionary.java",0,0.989830508474576,3,1,4
"lucene/analysis/kuromoji/src/java/org/apache/lucene/analysis/ja/dict/CharacterDefinition.java",0,0.975,3,1,4
"lucene/analysis/kuromoji/src/java/org/apache/lucene/analysis/ja/dict/ConnectionCosts.java",0,0.966292134831461,3,1,4
"lucene/analysis/kuromoji/src/java/org/apache/lucene/analysis/ja/dict/Dictionary.java",0,0.978260869565217,2,1,3
"lucene/analysis/kuromoji/src/java/org/apache/lucene/analysis/ja/dict/TokenInfoDictionary.java",0,0.973684210526316,2,1,3
"lucene/analysis/kuromoji/src/java/org/apache/lucene/analysis/ja/dict/TokenInfoFST.java",0,0.893617021276596,2,2,4
"lucene/analysis/kuromoji/src/java/org/apache/lucene/analysis/ja/dict/UnknownDictionary.java",0,0.976744186046512,2,1,3
"lucene/analysis/kuromoji/src/java/org/apache/lucene/analysis/ja/dict/UserDictionary.java",0,0.926739926739927,3,1,4
"lucene/analysis/kuromoji/src/java/org/apache/lucene/analysis/ja/tokenattributes/BaseFormAttribute.java",0,0.90625,1,2,3
"lucene/analysis/kuromoji/src/java/org/apache/lucene/analysis/ja/tokenattributes/BaseFormAttributeImpl.java",0,0.943396226415094,2,1,3
"lucene/analysis/kuromoji/src/java/org/apache/lucene/analysis/ja/tokenattributes/InflectionAttribute.java",0,0.909090909090909,1,2,3
"lucene/analysis/kuromoji/src/java/org/apache/lucene/analysis/ja/tokenattributes/InflectionAttributeImpl.java",0,0.938461538461538,2,1,3
"lucene/analysis/kuromoji/src/java/org/apache/lucene/analysis/ja/tokenattributes/PartOfSpeechAttribute.java",0,0.896551724137931,1,2,3
"lucene/analysis/kuromoji/src/java/org/apache/lucene/analysis/ja/tokenattributes/PartOfSpeechAttributeImpl.java",0,0.929824561403509,1,2,3
"lucene/analysis/kuromoji/src/java/org/apache/lucene/analysis/ja/tokenattributes/ReadingAttribute.java",0,0.909090909090909,1,2,3
"lucene/analysis/kuromoji/src/java/org/apache/lucene/analysis/ja/tokenattributes/ReadingAttributeImpl.java",0,0.938461538461538,2,1,3
"lucene/analysis/kuromoji/src/java/org/apache/lucene/analysis/ja/util/CSVUtil.java",0,0.982300884955752,2,1,3
"lucene/analysis/kuromoji/src/java/org/apache/lucene/analysis/ja/util/ToStringUtil.java",0,0.985428051001822,2,1,3
"lucene/analysis/kuromoji/src/test/org/apache/lucene/analysis/ja/TestExtendedMode.java",0,0.893333333333333,2,2,4
"lucene/analysis/kuromoji/src/test/org/apache/lucene/analysis/ja/TestJapaneseAnalyzer.java",0,0.523809523809524,2,3,5
"lucene/analysis/kuromoji/src/test/org/apache/lucene/analysis/ja/TestJapaneseBaseFormFilter.java",0,0.887096774193548,2,2,4
"lucene/analysis/kuromoji/src/test/org/apache/lucene/analysis/ja/TestJapaneseKatakanaStemFilter.java",0,0.843373493975904,2,2,4
"lucene/analysis/kuromoji/src/test/org/apache/lucene/analysis/ja/TestJapaneseReadingFormFilter.java",0,0.82051282051282,2,2,4
"lucene/analysis/kuromoji/src/test/org/apache/lucene/analysis/ja/TestJapaneseTokenizer.java",0,0.725490196078431,3,2,5
"lucene/analysis/kuromoji/src/test/org/apache/lucene/analysis/ja/TestSearchMode.java",0,0.792682926829268,1,2,3
"lucene/analysis/kuromoji/src/test/org/apache/lucene/analysis/ja/dict/TestTokenInfoDictionary.java",0,0.97196261682243,2,1,3
"lucene/analysis/kuromoji/src/test/org/apache/lucene/analysis/ja/dict/UserDictionaryTest.java",0,0.9125,1,2,3
"lucene/analysis/kuromoji/src/test/org/apache/lucene/analysis/ja/util/TestToStringUtil.java",0,0.982142857142857,2,1,3
"lucene/analysis/kuromoji/src/tools/java/org/apache/lucene/analysis/ja/util/BinaryDictionaryWriter.java",0,0.987341772151899,3,1,4
"lucene/analysis/kuromoji/src/tools/java/org/apache/lucene/analysis/ja/util/CharacterDefinitionWriter.java",0,0.957894736842105,3,1,4
"lucene/analysis/kuromoji/src/tools/java/org/apache/lucene/analysis/ja/util/ConnectionCostsBuilder.java",0,0.970149253731343,2,1,3
"lucene/analysis/kuromoji/src/tools/java/org/apache/lucene/analysis/ja/util/ConnectionCostsWriter.java",0,0.947368421052632,3,1,4
"lucene/analysis/kuromoji/src/tools/java/org/apache/lucene/analysis/ja/util/DictionaryBuilder.java",0,0.976470588235294,2,1,3
"lucene/analysis/kuromoji/src/tools/java/org/apache/lucene/analysis/ja/util/TokenInfoDictionaryBuilder.java",0,0.964912280701754,4,1,5
"lucene/analysis/kuromoji/src/tools/java/org/apache/lucene/analysis/ja/util/TokenInfoDictionaryWriter.java",0,0.9375,2,1,3
"lucene/analysis/kuromoji/src/tools/java/org/apache/lucene/analysis/ja/util/UnknownDictionaryBuilder.java",0,0.977777777777778,2,1,3
"lucene/analysis/kuromoji/src/tools/java/org/apache/lucene/analysis/ja/util/UnknownDictionaryWriter.java",0,0.938461538461538,2,1,3
"lucene/analysis/kuromoji/src/tools/test/org/apache/lucene/analysis/ja/dict/UnknownDictionaryTest.java",0,0.946666666666667,2,1,3
"lucene/analysis/morfologik/src/java/org/apache/lucene/analysis/morfologik/MorfologikAnalyzer.java",0,0.94047619047619,2,1,3
"lucene/analysis/morfologik/src/java/org/apache/lucene/analysis/morfologik/MorfologikFilter.java",0,0.992592592592593,1,1,2
"lucene/analysis/morfologik/src/java/org/apache/lucene/analysis/morfologik/MorphosyntacticTagAttribute.java",0,0.975,1,1,2
"lucene/analysis/morfologik/src/java/org/apache/lucene/analysis/morfologik/MorphosyntacticTagAttributeImpl.java",0,0.967391304347826,3,1,4
"lucene/analysis/morfologik/src/test/org/apache/lucene/analysis/morfologik/TestMorfologikAnalyzer.java",0,0.927272727272727,3,1,4
"lucene/analysis/phonetic/src/java/org/apache/lucene/analysis/phonetic/BeiderMorseFilter.java",0,0.982758620689655,2,1,3
"lucene/analysis/phonetic/src/java/org/apache/lucene/analysis/phonetic/DoubleMetaphoneFilter.java",0,0.45045045045045,1,3,4
"lucene/analysis/phonetic/src/java/org/apache/lucene/analysis/phonetic/PhoneticFilter.java",0,0.427083333333333,2,3,5
"lucene/analysis/phonetic/src/test/org/apache/lucene/analysis/phonetic/DoubleMetaphoneFilterTest.java",0,0.445454545454545,2,3,5
"lucene/analysis/phonetic/src/test/org/apache/lucene/analysis/phonetic/TestBeiderMorseFilter.java",0,0.981308411214953,2,1,3
"lucene/analysis/phonetic/src/test/org/apache/lucene/analysis/phonetic/TestPhoneticFilter.java",0,0.92436974789916,3,1,4
"lucene/analysis/smartcn/src/java/org/apache/lucene/analysis/cn/smart/AnalyzerProfile.java",0,0.869565217391304,2,2,4
"lucene/analysis/smartcn/src/java/org/apache/lucene/analysis/cn/smart/CharType.java",0,0.545454545454545,2,2,4
"lucene/analysis/smartcn/src/java/org/apache/lucene/analysis/cn/smart/SentenceTokenizer.java",0,0.557251908396947,2,4,6
"lucene/analysis/smartcn/src/java/org/apache/lucene/analysis/cn/smart/SmartChineseAnalyzer.java",0,0.549668874172185,2,3,5
"lucene/analysis/smartcn/src/java/org/apache/lucene/analysis/cn/smart/Utility.java",0,0.738888888888889,2,2,4
"lucene/analysis/smartcn/src/java/org/apache/lucene/analysis/cn/smart/WordSegmenter.java",0,0.606741573033708,1,4,5
"lucene/analysis/smartcn/src/java/org/apache/lucene/analysis/cn/smart/WordTokenFilter.java",0,0.339805825242718,1,4,5
"lucene/analysis/smartcn/src/java/org/apache/lucene/analysis/cn/smart/WordType.java",0,0.484848484848485,2,2,4
"lucene/analysis/smartcn/src/java/org/apache/lucene/analysis/cn/smart/hhmm/AbstractDictionary.java",0,0.7,3,2,5
"lucene/analysis/smartcn/src/java/org/apache/lucene/analysis/cn/smart/hhmm/BiSegGraph.java",0,0.741379310344828,2,3,5
"lucene/analysis/smartcn/src/java/org/apache/lucene/analysis/cn/smart/hhmm/BigramDictionary.java",0,0.934065934065934,3,1,4
"lucene/analysis/smartcn/src/java/org/apache/lucene/analysis/cn/smart/hhmm/HHMMSegmenter.java",0,0.800970873786408,2,3,5
"lucene/analysis/smartcn/src/java/org/apache/lucene/analysis/cn/smart/hhmm/PathNode.java",0,0.513513513513513,1,3,4
"lucene/analysis/smartcn/src/java/org/apache/lucene/analysis/cn/smart/hhmm/SegGraph.java",0,0.666666666666667,2,3,5
"lucene/analysis/smartcn/src/java/org/apache/lucene/analysis/cn/smart/hhmm/SegToken.java",0,0.909090909090909,2,2,4
"lucene/analysis/smartcn/src/java/org/apache/lucene/analysis/cn/smart/hhmm/SegTokenFilter.java",0,0.676470588235294,2,2,4
"lucene/analysis/smartcn/src/java/org/apache/lucene/analysis/cn/smart/hhmm/SegTokenPair.java",0,0.494505494505495,2,2,4
"lucene/analysis/smartcn/src/java/org/apache/lucene/analysis/cn/smart/hhmm/WordDictionary.java",0,0.860594795539034,1,3,4
"lucene/analysis/smartcn/src/test/org/apache/lucene/analysis/cn/smart/TestSmartChineseAnalyzer.java",0,0.554655870445344,4,3,7
"lucene/analysis/stempel/src/java/org/apache/lucene/analysis/pl/PolishAnalyzer.java",0,0.958904109589041,3,1,4
"lucene/analysis/stempel/src/java/org/apache/lucene/analysis/stempel/StempelFilter.java",0,1,0,1,1
"lucene/analysis/stempel/src/java/org/apache/lucene/analysis/stempel/StempelStemmer.java",0,1,0,1,1
"lucene/analysis/stempel/src/java/org/egothor/stemmer/Cell.java",0,1,0,1,1
"lucene/analysis/stempel/src/java/org/egothor/stemmer/Compile.java",0,1,0,1,1
"lucene/analysis/stempel/src/java/org/egothor/stemmer/Diff.java",0,1,0,1,1
"lucene/analysis/stempel/src/java/org/egothor/stemmer/DiffIt.java",0,1,0,1,1
"lucene/analysis/stempel/src/java/org/egothor/stemmer/Gener.java",0,1,0,1,1
"lucene/analysis/stempel/src/java/org/egothor/stemmer/Lift.java",0,1,0,1,1
"lucene/analysis/stempel/src/java/org/egothor/stemmer/MultiTrie.java",0,1,0,1,1
"lucene/analysis/stempel/src/java/org/egothor/stemmer/MultiTrie2.java",0,1,0,1,1
"lucene/analysis/stempel/src/java/org/egothor/stemmer/Optimizer.java",0,1,0,1,1
"lucene/analysis/stempel/src/java/org/egothor/stemmer/Optimizer2.java",0,1,0,1,1
"lucene/analysis/stempel/src/java/org/egothor/stemmer/Reduce.java",0,1,0,1,1
"lucene/analysis/stempel/src/java/org/egothor/stemmer/Row.java",0,1,0,1,1
"lucene/analysis/stempel/src/java/org/egothor/stemmer/Trie.java",0,1,0,1,1
"lucene/analysis/stempel/src/test/org/apache/lucene/analysis/pl/TestPolishAnalyzer.java",0,0.964285714285714,2,1,3
"lucene/analysis/stempel/src/test/org/egothor/stemmer/TestCompile.java",0,1,0,1,1
"lucene/analysis/stempel/src/test/org/egothor/stemmer/TestStemmer.java",0,1,0,1,1
"lucene/analysis/uima/src/java/org/apache/lucene/analysis/uima/BaseUIMATokenizer.java",0,0.872340425531915,0,2,2
"lucene/analysis/uima/src/java/org/apache/lucene/analysis/uima/UIMAAnnotationsTokenizer.java",0,0.975609756097561,1,1,2
"lucene/analysis/uima/src/java/org/apache/lucene/analysis/uima/UIMABaseAnalyzer.java",0,1,0,1,1
"lucene/analysis/uima/src/java/org/apache/lucene/analysis/uima/UIMATypeAwareAnalyzer.java",0,1,0,1,1
"lucene/analysis/uima/src/java/org/apache/lucene/analysis/uima/UIMATypeAwareAnnotationsTokenizer.java",0,0.980952380952381,1,1,2
"lucene/analysis/uima/src/java/org/apache/lucene/analysis/uima/ae/AEProvider.java",0,0.944444444444444,2,1,3
"lucene/analysis/uima/src/java/org/apache/lucene/analysis/uima/ae/AEProviderFactory.java",0,0.962025316455696,2,1,3
"lucene/analysis/uima/src/java/org/apache/lucene/analysis/uima/ae/BasicAEProvider.java",0,0.517241379310345,0,2,2
"lucene/analysis/uima/src/java/org/apache/lucene/analysis/uima/ae/OverridingParamsAEProvider.java",0,0.869565217391304,1,2,3
"lucene/analysis/uima/src/test/org/apache/lucene/analysis/uima/UIMABaseAnalyzerTest.java",0,0.96,2,1,3
"lucene/analysis/uima/src/test/org/apache/lucene/analysis/uima/UIMATypeAwareAnalyzerTest.java",0,0.985074626865672,1,1,2
"lucene/analysis/uima/src/test/org/apache/lucene/analysis/uima/ae/BasicAEProviderTest.java",0,1,0,1,1
"lucene/analysis/uima/src/test/org/apache/lucene/analysis/uima/ae/OverridingParamsAEProviderTest.java",0,1,0,1,1
"lucene/analysis/uima/src/test/org/apache/lucene/analysis/uima/an/SampleEntityAnnotator.java",0,1,0,1,1
"lucene/analysis/uima/src/test/org/apache/lucene/analysis/uima/an/SamplePoSTagger.java",0,1,0,1,1
"lucene/analysis/uima/src/test/org/apache/lucene/analysis/uima/an/SampleWSTokenizerAnnotator.java",0,1,0,1,1
"lucene/benchmark/src/java/org/apache/lucene/benchmark/Constants.java",0,0.96875,1,1,2
"lucene/benchmark/src/java/org/apache/lucene/benchmark/byTask/Benchmark.java",0,0.910344827586207,2,2,4
"lucene/benchmark/src/java/org/apache/lucene/benchmark/byTask/PerfRunData.java",0,0.352402745995423,4,5,9
"lucene/benchmark/src/java/org/apache/lucene/benchmark/byTask/feeds/AbstractQueryMaker.java",0,0.972222222222222,1,1,2
"lucene/benchmark/src/java/org/apache/lucene/benchmark/byTask/feeds/ContentItemsSource.java",0,0.967213114754098,2,1,3
"lucene/benchmark/src/java/org/apache/lucene/benchmark/byTask/feeds/ContentSource.java",0,0.842105263157895,1,2,3
"lucene/benchmark/src/java/org/apache/lucene/benchmark/byTask/feeds/DemoHTMLParser.java",0,0.847222222222222,3,2,5
"lucene/benchmark/src/java/org/apache/lucene/benchmark/byTask/feeds/DirContentSource.java",0,0.492,6,2,8
"lucene/benchmark/src/java/org/apache/lucene/benchmark/byTask/feeds/DocData.java",0,0.528301886792453,1,3,4
"lucene/benchmark/src/java/org/apache/lucene/benchmark/byTask/feeds/DocMaker.java",0,0.44468085106383,6,3,9
"lucene/benchmark/src/java/org/apache/lucene/benchmark/byTask/feeds/EnwikiContentSource.java",0,0.8801261829653,6,2,8
"lucene/benchmark/src/java/org/apache/lucene/benchmark/byTask/feeds/EnwikiQueryMaker.java",0,0.905109489051095,5,1,6
"lucene/benchmark/src/java/org/apache/lucene/benchmark/byTask/feeds/FacetSource.java",0,0.977777777777778,1,1,2
"lucene/benchmark/src/java/org/apache/lucene/benchmark/byTask/feeds/FileBasedQueryMaker.java",0,0.701030927835051,4,3,7
"lucene/benchmark/src/java/org/apache/lucene/benchmark/byTask/feeds/HTMLParser.java",0,0.956521739130435,2,1,3
"lucene/benchmark/src/java/org/apache/lucene/benchmark/byTask/feeds/LineDocSource.java",0,0.602836879432624,3,2,5
"lucene/benchmark/src/java/org/apache/lucene/benchmark/byTask/feeds/LongToEnglishContentSource.java",0,0.5,2,3,5
"lucene/benchmark/src/java/org/apache/lucene/benchmark/byTask/feeds/LongToEnglishQueryMaker.java",0,0.571428571428571,3,3,6
"lucene/benchmark/src/java/org/apache/lucene/benchmark/byTask/feeds/NoMoreDataException.java",0,0.925925925925926,0,2,2
"lucene/benchmark/src/java/org/apache/lucene/benchmark/byTask/feeds/QueryMaker.java",0,0.959183673469388,2,1,3
"lucene/benchmark/src/java/org/apache/lucene/benchmark/byTask/feeds/RandomFacetSource.java",0,0.987654320987654,1,1,2
"lucene/benchmark/src/java/org/apache/lucene/benchmark/byTask/feeds/ReutersContentSource.java",0,0.933774834437086,4,1,5
"lucene/benchmark/src/java/org/apache/lucene/benchmark/byTask/feeds/ReutersQueryMaker.java",0,0.808333333333333,5,3,8
"lucene/benchmark/src/java/org/apache/lucene/benchmark/byTask/feeds/SimpleQueryMaker.java",0,0.71830985915493,5,3,8
"lucene/benchmark/src/java/org/apache/lucene/benchmark/byTask/feeds/SimpleSloppyPhraseQueryMaker.java",0,0.674698795180723,4,2,6
"lucene/benchmark/src/java/org/apache/lucene/benchmark/byTask/feeds/SingleDocSource.java",0,0.444444444444444,2,3,5
"lucene/benchmark/src/java/org/apache/lucene/benchmark/byTask/feeds/SortableSingleDocSource.java",0,0.973684210526316,2,1,3
"lucene/benchmark/src/java/org/apache/lucene/benchmark/byTask/feeds/TrecContentSource.java",0,0.677142857142857,5,2,7
"lucene/benchmark/src/java/org/apache/lucene/benchmark/byTask/feeds/TrecDocParser.java",0,0.992647058823529,1,1,2
"lucene/benchmark/src/java/org/apache/lucene/benchmark/byTask/feeds/TrecFBISParser.java",0,0.984615384615385,1,1,2
"lucene/benchmark/src/java/org/apache/lucene/benchmark/byTask/feeds/TrecFR94Parser.java",0,0.984848484848485,1,1,2
"lucene/benchmark/src/java/org/apache/lucene/benchmark/byTask/feeds/TrecFTParser.java",0,0.982456140350877,1,1,2
"lucene/benchmark/src/java/org/apache/lucene/benchmark/byTask/feeds/TrecGov2Parser.java",0,0.983050847457627,1,1,2
"lucene/benchmark/src/java/org/apache/lucene/benchmark/byTask/feeds/TrecLATimesParser.java",0,0.985915492957746,1,1,2
"lucene/benchmark/src/java/org/apache/lucene/benchmark/byTask/feeds/TrecParserByPath.java",0,0.96969696969697,1,1,2
"lucene/benchmark/src/java/org/apache/lucene/benchmark/byTask/feeds/demohtml/Entities.java",0,0.924242424242424,8,1,9
"lucene/benchmark/src/java/org/apache/lucene/benchmark/byTask/feeds/demohtml/HTMLParser.java",0,0.798934753661784,5,3,8
"lucene/benchmark/src/java/org/apache/lucene/benchmark/byTask/feeds/demohtml/HTMLParserConstants.java",0,0.991935483870968,1,1,2
"lucene/benchmark/src/java/org/apache/lucene/benchmark/byTask/feeds/demohtml/HTMLParserTokenManager.java",0,0.969258589511754,3,1,4
"lucene/benchmark/src/java/org/apache/lucene/benchmark/byTask/feeds/demohtml/ParseException.java",0,0.98989898989899,1,1,2
"lucene/benchmark/src/java/org/apache/lucene/benchmark/byTask/feeds/demohtml/ParserThread.java",0,0.96,2,1,3
"lucene/benchmark/src/java/org/apache/lucene/benchmark/byTask/feeds/demohtml/SimpleCharStream.java",0,0.991525423728814,1,1,2
"lucene/benchmark/src/java/org/apache/lucene/benchmark/byTask/feeds/demohtml/Tags.java",0,0.895522388059702,2,2,4
"lucene/benchmark/src/java/org/apache/lucene/benchmark/byTask/feeds/demohtml/Token.java",0,0.983870967741935,1,1,2
"lucene/benchmark/src/java/org/apache/lucene/benchmark/byTask/feeds/demohtml/TokenMgrError.java",0,0.985815602836879,1,1,2
"lucene/benchmark/src/java/org/apache/lucene/benchmark/byTask/programmatic/Sample.java",0,0.96,2,1,3
"lucene/benchmark/src/java/org/apache/lucene/benchmark/byTask/stats/Points.java",0,0.842105263157895,2,3,5
"lucene/benchmark/src/java/org/apache/lucene/benchmark/byTask/stats/Report.java",0,0.953125,2,1,3
"lucene/benchmark/src/java/org/apache/lucene/benchmark/byTask/stats/TaskStats.java",0,0.823008849557522,6,2,8
"lucene/benchmark/src/java/org/apache/lucene/benchmark/byTask/tasks/AddDocTask.java",0,0.67032967032967,2,4,6
"lucene/benchmark/src/java/org/apache/lucene/benchmark/byTask/tasks/AddFacetedDocTask.java",0,0.987012987012987,1,1,2
"lucene/benchmark/src/java/org/apache/lucene/benchmark/byTask/tasks/AddIndexesTask.java",0,0.990196078431373,1,1,2
"lucene/benchmark/src/java/org/apache/lucene/benchmark/byTask/tasks/BenchmarkHighlighter.java",0,0.866666666666667,1,2,3
"lucene/benchmark/src/java/org/apache/lucene/benchmark/byTask/tasks/ClearStatsTask.java",0,0.91304347826087,3,1,4
"lucene/benchmark/src/java/org/apache/lucene/benchmark/byTask/tasks/CloseIndexTask.java",0,0.609375,2,3,5
"lucene/benchmark/src/java/org/apache/lucene/benchmark/byTask/tasks/CloseReaderTask.java",0,0.808510638297872,3,2,5
"lucene/benchmark/src/java/org/apache/lucene/benchmark/byTask/tasks/CloseTaxonomyIndexTask.java",0,0.976744186046512,1,1,2
"lucene/benchmark/src/java/org/apache/lucene/benchmark/byTask/tasks/CloseTaxonomyReaderTask.java",0,0.978260869565217,1,1,2
"lucene/benchmark/src/java/org/apache/lucene/benchmark/byTask/tasks/CommitIndexTask.java",0,0.596491228070175,1,3,4
"lucene/benchmark/src/java/org/apache/lucene/benchmark/byTask/tasks/CommitTaxonomyIndexTask.java",0,0.975609756097561,1,1,2
"lucene/benchmark/src/java/org/apache/lucene/benchmark/byTask/tasks/ConsumeContentSourceTask.java",0,0.826086956521739,2,2,4
"lucene/benchmark/src/java/org/apache/lucene/benchmark/byTask/tasks/CreateIndexTask.java",0,0.326424870466321,2,5,7
"lucene/benchmark/src/java/org/apache/lucene/benchmark/byTask/tasks/CreateTaxonomyIndexTask.java",0,0.931818181818182,2,1,3
"lucene/benchmark/src/java/org/apache/lucene/benchmark/byTask/tasks/ForceMergeTask.java",0,0.589285714285714,3,3,6
"lucene/benchmark/src/java/org/apache/lucene/benchmark/byTask/tasks/NearRealtimeReaderTask.java",0,0.932773109243697,2,2,4
"lucene/benchmark/src/java/org/apache/lucene/benchmark/byTask/tasks/NewAnalyzerTask.java",0,0.612612612612613,1,3,4
"lucene/benchmark/src/java/org/apache/lucene/benchmark/byTask/tasks/NewCollationAnalyzerTask.java",0,0.992,1,1,2
"lucene/benchmark/src/java/org/apache/lucene/benchmark/byTask/tasks/NewLocaleTask.java",0,0.98876404494382,1,1,2
"lucene/benchmark/src/java/org/apache/lucene/benchmark/byTask/tasks/NewRoundTask.java",0,0.91304347826087,3,1,4
"lucene/benchmark/src/java/org/apache/lucene/benchmark/byTask/tasks/NewShingleAnalyzerTask.java",0,0.760683760683761,1,3,4
"lucene/benchmark/src/java/org/apache/lucene/benchmark/byTask/tasks/OpenIndexTask.java",0,0.4625,3,3,6
"lucene/benchmark/src/java/org/apache/lucene/benchmark/byTask/tasks/OpenReaderTask.java",0,0.449438202247191,1,3,4
"lucene/benchmark/src/java/org/apache/lucene/benchmark/byTask/tasks/OpenTaxonomyIndexTask.java",0,0.906976744186046,1,2,3
"lucene/benchmark/src/java/org/apache/lucene/benchmark/byTask/tasks/OpenTaxonomyReaderTask.java",0,0.933333333333333,2,1,3
"lucene/benchmark/src/java/org/apache/lucene/benchmark/byTask/tasks/PerfTask.java",0,0.547169811320755,4,5,9
"lucene/benchmark/src/java/org/apache/lucene/benchmark/byTask/tasks/PrintReaderTask.java",0,0.827586206896552,1,2,3
"lucene/benchmark/src/java/org/apache/lucene/benchmark/byTask/tasks/ReadTask.java",0,0.409090909090909,5,3,8
"lucene/benchmark/src/java/org/apache/lucene/benchmark/byTask/tasks/ReadTokensTask.java",0,0.807407407407407,4,3,7
"lucene/benchmark/src/java/org/apache/lucene/benchmark/byTask/tasks/ReopenReaderTask.java",0,0.826086956521739,1,3,4
"lucene/benchmark/src/java/org/apache/lucene/benchmark/byTask/tasks/RepAllTask.java",0,0.526315789473684,4,2,6
"lucene/benchmark/src/java/org/apache/lucene/benchmark/byTask/tasks/RepSelectByPrefTask.java",0,0.554054054054054,4,2,6
"lucene/benchmark/src/java/org/apache/lucene/benchmark/byTask/tasks/RepSumByNameRoundTask.java",0,0.525,3,3,6
"lucene/benchmark/src/java/org/apache/lucene/benchmark/byTask/tasks/RepSumByNameTask.java",0,0.525,3,3,6
"lucene/benchmark/src/java/org/apache/lucene/benchmark/byTask/tasks/RepSumByPrefRoundTask.java",0,0.545454545454545,3,3,6
"lucene/benchmark/src/java/org/apache/lucene/benchmark/byTask/tasks/RepSumByPrefTask.java",0,0.911111111111111,4,1,5
"lucene/benchmark/src/java/org/apache/lucene/benchmark/byTask/tasks/ReportTask.java",0,0.585227272727273,4,3,7
"lucene/benchmark/src/java/org/apache/lucene/benchmark/byTask/tasks/ResetInputsTask.java",0,0.94,2,1,3
"lucene/benchmark/src/java/org/apache/lucene/benchmark/byTask/tasks/ResetSystemEraseTask.java",0,0.883720930232558,4,1,5
"lucene/benchmark/src/java/org/apache/lucene/benchmark/byTask/tasks/ResetSystemSoftTask.java",0,0.906976744186046,3,1,4
"lucene/benchmark/src/java/org/apache/lucene/benchmark/byTask/tasks/RollbackIndexTask.java",0,0.923076923076923,1,2,3
"lucene/benchmark/src/java/org/apache/lucene/benchmark/byTask/tasks/SearchTask.java",0,0.885245901639344,2,2,4
"lucene/benchmark/src/java/org/apache/lucene/benchmark/byTask/tasks/SearchTravRetHighlightTask.java",0,0.736842105263158,3,2,5
"lucene/benchmark/src/java/org/apache/lucene/benchmark/byTask/tasks/SearchTravRetLoadFieldSelectorTask.java",0,0.682352941176471,0,4,4
"lucene/benchmark/src/java/org/apache/lucene/benchmark/byTask/tasks/SearchTravRetTask.java",0,0.888888888888889,4,1,5
"lucene/benchmark/src/java/org/apache/lucene/benchmark/byTask/tasks/SearchTravRetVectorHighlightTask.java",0,0.884353741496599,5,1,6
"lucene/benchmark/src/java/org/apache/lucene/benchmark/byTask/tasks/SearchTravTask.java",0,0.651162790697674,1,3,4
"lucene/benchmark/src/java/org/apache/lucene/benchmark/byTask/tasks/SearchWithCollectorTask.java",0,0.989247311827957,1,1,2
"lucene/benchmark/src/java/org/apache/lucene/benchmark/byTask/tasks/SearchWithSortTask.java",0,0.581560283687943,3,3,6
"lucene/benchmark/src/java/org/apache/lucene/benchmark/byTask/tasks/SetPropTask.java",0,0.797101449275362,2,2,4
"lucene/benchmark/src/java/org/apache/lucene/benchmark/byTask/tasks/TaskSequence.java",0,0.466793168880455,7,2,9
"lucene/benchmark/src/java/org/apache/lucene/benchmark/byTask/tasks/UpdateDocTask.java",0,0.882978723404255,2,2,4
"lucene/benchmark/src/java/org/apache/lucene/benchmark/byTask/tasks/WaitForMergesTask.java",0,0.975,1,1,2
"lucene/benchmark/src/java/org/apache/lucene/benchmark/byTask/tasks/WaitTask.java",0,0.986666666666667,1,1,2
"lucene/benchmark/src/java/org/apache/lucene/benchmark/byTask/tasks/WarmTask.java",0,0.907692307692308,1,2,3
"lucene/benchmark/src/java/org/apache/lucene/benchmark/byTask/tasks/WriteLineDocTask.java",0,0.480952380952381,5,3,8
"lucene/benchmark/src/java/org/apache/lucene/benchmark/byTask/utils/Algorithm.java",0,0.687687687687688,5,3,8
"lucene/benchmark/src/java/org/apache/lucene/benchmark/byTask/utils/Config.java",0,0.482300884955752,5,3,8
"lucene/benchmark/src/java/org/apache/lucene/benchmark/byTask/utils/FileUtils.java",0,0.981481481481482,1,1,2
"lucene/benchmark/src/java/org/apache/lucene/benchmark/byTask/utils/Format.java",0,0.845454545454545,1,2,3
"lucene/benchmark/src/java/org/apache/lucene/benchmark/byTask/utils/StreamUtils.java",0,0.991452991452991,1,1,2
"lucene/benchmark/src/java/org/apache/lucene/benchmark/byTask/utils/StringBuilderReader.java",0,0.861878453038674,3,2,5
"lucene/benchmark/src/java/org/apache/lucene/benchmark/quality/Judge.java",0,0.981132075471698,1,1,2
"lucene/benchmark/src/java/org/apache/lucene/benchmark/quality/QualityBenchmark.java",0,0.962732919254658,2,1,3
"lucene/benchmark/src/java/org/apache/lucene/benchmark/quality/QualityQuery.java",0,0.918604651162791,1,2,3
"lucene/benchmark/src/java/org/apache/lucene/benchmark/quality/QualityQueryParser.java",0,0.941176470588235,2,1,3
"lucene/benchmark/src/java/org/apache/lucene/benchmark/quality/QualityStats.java",0,0.982993197278912,2,1,3
"lucene/benchmark/src/java/org/apache/lucene/benchmark/quality/trec/QueryDriver.java",0,0.48936170212766,3,3,6
"lucene/benchmark/src/java/org/apache/lucene/benchmark/quality/trec/Trec1MQReader.java",0,0.954022988505747,2,1,3
"lucene/benchmark/src/java/org/apache/lucene/benchmark/quality/trec/TrecJudge.java",0,0.923076923076923,2,2,4
"lucene/benchmark/src/java/org/apache/lucene/benchmark/quality/trec/TrecTopicsReader.java",0,0.797101449275362,3,2,5
"lucene/benchmark/src/java/org/apache/lucene/benchmark/quality/utils/DocNameExtractor.java",0,0.571428571428571,1,3,4
"lucene/benchmark/src/java/org/apache/lucene/benchmark/quality/utils/QualityQueriesFinder.java",0,0.830882352941177,4,2,6
"lucene/benchmark/src/java/org/apache/lucene/benchmark/quality/utils/SimpleQQParser.java",0,0.626666666666667,3,3,6
"lucene/benchmark/src/java/org/apache/lucene/benchmark/quality/utils/SubmissionReport.java",0,0.956989247311828,3,1,4
"lucene/benchmark/src/java/org/apache/lucene/benchmark/utils/ExtractReuters.java",0,0.684563758389262,1,2,3
"lucene/benchmark/src/java/org/apache/lucene/benchmark/utils/ExtractWikipedia.java",0,0.853503184713376,3,3,6
"lucene/benchmark/src/test/conf/ConfLoader.java",0,0.954545454545455,1,1,2
"lucene/benchmark/src/test/org/apache/lucene/benchmark/BenchmarkTestCase.java",0,0.741379310344828,2,2,4
"lucene/benchmark/src/test/org/apache/lucene/benchmark/byTask/TestPerfTasksLogic.java",0,0.435873605947955,5,4,9
"lucene/benchmark/src/test/org/apache/lucene/benchmark/byTask/TestPerfTasksParse.java",0,0.462068965517241,2,3,5
"lucene/benchmark/src/test/org/apache/lucene/benchmark/byTask/feeds/DocMakerTest.java",0,0.736842105263158,3,3,6
"lucene/benchmark/src/test/org/apache/lucene/benchmark/byTask/feeds/LineDocSourceTest.java",0,0.395833333333333,2,3,5
"lucene/benchmark/src/test/org/apache/lucene/benchmark/byTask/feeds/TrecContentSourceTest.java",0,0.707070707070707,2,3,5
"lucene/benchmark/src/test/org/apache/lucene/benchmark/byTask/feeds/demohtml/TestHtmlParser.java",0,0.984848484848485,2,1,3
"lucene/benchmark/src/test/org/apache/lucene/benchmark/byTask/tasks/AddIndexesTaskTest.java",0,0.992857142857143,1,1,2
"lucene/benchmark/src/test/org/apache/lucene/benchmark/byTask/tasks/CountingHighlighterTestTask.java",0,0.705882352941177,2,2,4
"lucene/benchmark/src/test/org/apache/lucene/benchmark/byTask/tasks/CountingSearchTestTask.java",0,0.763636363636364,2,2,4
"lucene/benchmark/src/test/org/apache/lucene/benchmark/byTask/tasks/CreateIndexTaskTest.java",0,0.722222222222222,2,2,4
"lucene/benchmark/src/test/org/apache/lucene/benchmark/byTask/tasks/PerfTaskTest.java",0,0.986301369863014,1,1,2
"lucene/benchmark/src/test/org/apache/lucene/benchmark/byTask/tasks/SearchWithSortTaskTest.java",0,1,0,1,1
"lucene/benchmark/src/test/org/apache/lucene/benchmark/byTask/tasks/WriteLineDocTaskTest.java",0,0.364864864864865,2,4,6
"lucene/benchmark/src/test/org/apache/lucene/benchmark/byTask/tasks/alt/AltPackageTaskTest.java",0,0.981818181818182,1,1,2
"lucene/benchmark/src/test/org/apache/lucene/benchmark/byTask/tasks/alt/AltTestTask.java",0,0.972972972972973,1,1,2
"lucene/benchmark/src/test/org/apache/lucene/benchmark/byTask/utils/StreamUtilsTest.java",0,0.993288590604027,1,1,2
"lucene/benchmark/src/test/org/apache/lucene/benchmark/byTask/utils/TestConfig.java",0,0.918918918918919,1,2,3
"lucene/benchmark/src/test/org/apache/lucene/benchmark/quality/TestQualityRun.java",0,0.601010101010101,5,2,7
"lucene/core/src/java/org/apache/lucene/LucenePackage.java",0,0.96551724137931,1,1,2
"lucene/core/src/java/org/apache/lucene/analysis/Analyzer.java",0,0.770642201834862,7,2,9
"lucene/core/src/java/org/apache/lucene/analysis/AnalyzerWrapper.java",0,0.946808510638298,0,2,2
"lucene/core/src/java/org/apache/lucene/analysis/CachingTokenFilter.java",0,0.988372093023256,1,1,2
"lucene/core/src/java/org/apache/lucene/analysis/CharReader.java",0,0.657894736842105,2,2,4
"lucene/core/src/java/org/apache/lucene/analysis/CharStream.java",0,0.975609756097561,1,1,2
"lucene/core/src/java/org/apache/lucene/analysis/NumericTokenStream.java",0,0.865814696485623,2,2,4
"lucene/core/src/java/org/apache/lucene/analysis/Token.java",0,0.47218045112782,7,5,12
"lucene/core/src/java/org/apache/lucene/analysis/TokenFilter.java",0,0.982142857142857,1,1,2
"lucene/core/src/java/org/apache/lucene/analysis/TokenStream.java",0,0.951351351351351,3,1,4
"lucene/core/src/java/org/apache/lucene/analysis/Tokenizer.java",0,0.218390804597701,4,7,11
"lucene/core/src/java/org/apache/lucene/analysis/tokenattributes/CharTermAttribute.java",0,0.989010989010989,1,1,2
"lucene/core/src/java/org/apache/lucene/analysis/tokenattributes/CharTermAttributeImpl.java",0,0.940298507462687,2,2,4
"lucene/core/src/java/org/apache/lucene/analysis/tokenattributes/FlagsAttribute.java",0,0.886363636363636,2,2,4
"lucene/core/src/java/org/apache/lucene/analysis/tokenattributes/FlagsAttributeImpl.java",0,0.897435897435897,2,2,4
"lucene/core/src/java/org/apache/lucene/analysis/tokenattributes/KeywordAttribute.java",0,0.979591836734694,1,1,2
"lucene/core/src/java/org/apache/lucene/analysis/tokenattributes/KeywordAttributeImpl.java",0,0.98780487804878,1,1,2
"lucene/core/src/java/org/apache/lucene/analysis/tokenattributes/OffsetAttribute.java",0,0.977272727272727,1,1,2
"lucene/core/src/java/org/apache/lucene/analysis/tokenattributes/OffsetAttributeImpl.java",0,0.843137254901961,2,2,4
"lucene/core/src/java/org/apache/lucene/analysis/tokenattributes/PayloadAttribute.java",0,0.861111111111111,1,2,3
"lucene/core/src/java/org/apache/lucene/analysis/tokenattributes/PayloadAttributeImpl.java",0,0.888888888888889,3,2,5
"lucene/core/src/java/org/apache/lucene/analysis/tokenattributes/PositionIncrementAttribute.java",0,0.966101694915254,2,1,3
"lucene/core/src/java/org/apache/lucene/analysis/tokenattributes/PositionIncrementAttributeImpl.java",0,0.928571428571429,2,2,4
"lucene/core/src/java/org/apache/lucene/analysis/tokenattributes/PositionLengthAttribute.java",0,0.975609756097561,1,1,2
"lucene/core/src/java/org/apache/lucene/analysis/tokenattributes/PositionLengthAttributeImpl.java",0,0.986301369863014,1,1,2
"lucene/core/src/java/org/apache/lucene/analysis/tokenattributes/TermToBytesRefAttribute.java",0,0.519480519480519,1,2,3
"lucene/core/src/java/org/apache/lucene/analysis/tokenattributes/TypeAttribute.java",0,0.861111111111111,1,2,3
"lucene/core/src/java/org/apache/lucene/analysis/tokenattributes/TypeAttributeImpl.java",0,0.868421052631579,2,2,4
"lucene/core/src/java/org/apache/lucene/codecs/BlockTermState.java",0,0.5,1,4,5
"lucene/core/src/java/org/apache/lucene/codecs/BlockTermsReader.java",0,0.947488584474886,4,1,5
"lucene/core/src/java/org/apache/lucene/codecs/BlockTermsWriter.java",0,0.547169811320755,4,3,7
"lucene/core/src/java/org/apache/lucene/codecs/BlockTreeTermsReader.java",0,0.979875086745316,6,1,7
"lucene/core/src/java/org/apache/lucene/codecs/BlockTreeTermsWriter.java",0,0.964285714285714,3,1,4
"lucene/core/src/java/org/apache/lucene/codecs/Codec.java",0,0.709090909090909,3,2,5
"lucene/core/src/java/org/apache/lucene/codecs/CodecUtil.java",0,0.464052287581699,2,3,5
"lucene/core/src/java/org/apache/lucene/codecs/DocValuesArraySource.java",0,0.971590909090909,2,1,3
"lucene/core/src/java/org/apache/lucene/codecs/DocValuesConsumer.java",0,0.581589958158996,2,2,4
"lucene/core/src/java/org/apache/lucene/codecs/DocValuesFormat.java",0,0.864864864864865,1,2,3
"lucene/core/src/java/org/apache/lucene/codecs/FieldInfosFormat.java",0,0.833333333333333,1,2,3
"lucene/core/src/java/org/apache/lucene/codecs/FieldInfosReader.java",0,0.96875,1,1,2
"lucene/core/src/java/org/apache/lucene/codecs/FieldInfosWriter.java",0,0.96875,1,1,2
"lucene/core/src/java/org/apache/lucene/codecs/FieldsConsumer.java",0,0.405797101449275,1,4,5
"lucene/core/src/java/org/apache/lucene/codecs/FieldsProducer.java",0,0.727272727272727,1,4,5
"lucene/core/src/java/org/apache/lucene/codecs/FixedGapTermsIndexReader.java",0,0.568922305764411,6,2,8
"lucene/core/src/java/org/apache/lucene/codecs/FixedGapTermsIndexWriter.java",0,0.466666666666667,3,4,7
"lucene/core/src/java/org/apache/lucene/codecs/LiveDocsFormat.java",0,0.666666666666667,1,2,3
"lucene/core/src/java/org/apache/lucene/codecs/MappingMultiDocsAndPositionsEnum.java",0,0.753623188405797,3,3,6
"lucene/core/src/java/org/apache/lucene/codecs/MappingMultiDocsEnum.java",0,0.81651376146789,2,3,5
"lucene/core/src/java/org/apache/lucene/codecs/MultiLevelSkipListReader.java",0,0.975438596491228,3,1,4
"lucene/core/src/java/org/apache/lucene/codecs/MultiLevelSkipListWriter.java",0,0.974025974025974,3,1,4
"lucene/core/src/java/org/apache/lucene/codecs/NormsFormat.java",0,0.702702702702703,1,3,4
"lucene/core/src/java/org/apache/lucene/codecs/PerDocConsumer.java",0,0.841121495327103,3,2,5
"lucene/core/src/java/org/apache/lucene/codecs/PerDocProducer.java",0,0.41304347826087,1,3,4
"lucene/core/src/java/org/apache/lucene/codecs/PerDocProducerBase.java",0,0.786885245901639,1,2,3
"lucene/core/src/java/org/apache/lucene/codecs/PostingsBaseFormat.java",0,0.98,1,1,2
"lucene/core/src/java/org/apache/lucene/codecs/PostingsConsumer.java",0,0.463576158940397,1,3,4
"lucene/core/src/java/org/apache/lucene/codecs/PostingsFormat.java",0,0.958904109589041,2,1,3
"lucene/core/src/java/org/apache/lucene/codecs/PostingsReaderBase.java",0,0.925373134328358,1,2,3
"lucene/core/src/java/org/apache/lucene/codecs/PostingsWriterBase.java",0,0.423728813559322,1,3,4
"lucene/core/src/java/org/apache/lucene/codecs/SegmentInfoFormat.java",0,0.727272727272727,2,2,4
"lucene/core/src/java/org/apache/lucene/codecs/SegmentInfoReader.java",0,0.731707317073171,2,3,5
"lucene/core/src/java/org/apache/lucene/codecs/SegmentInfoWriter.java",0,0.743589743589744,2,3,5
"lucene/core/src/java/org/apache/lucene/codecs/StoredFieldsFormat.java",0,0.447368421052632,1,3,4
"lucene/core/src/java/org/apache/lucene/codecs/StoredFieldsReader.java",0,1,0,1,1
"lucene/core/src/java/org/apache/lucene/codecs/StoredFieldsWriter.java",0,0.898305084745763,0,2,2
"lucene/core/src/java/org/apache/lucene/codecs/TermStats.java",0,0.722222222222222,1,2,3
"lucene/core/src/java/org/apache/lucene/codecs/TermVectorsFormat.java",0,0.842105263157895,1,2,3
"lucene/core/src/java/org/apache/lucene/codecs/TermVectorsReader.java",0,0.930232558139535,2,1,3
"lucene/core/src/java/org/apache/lucene/codecs/TermVectorsWriter.java",0,0.761565836298932,2,2,4
"lucene/core/src/java/org/apache/lucene/codecs/TermsConsumer.java",0,0.414285714285714,2,3,5
"lucene/core/src/java/org/apache/lucene/codecs/TermsIndexReaderBase.java",0,0.567567567567568,1,3,4
"lucene/core/src/java/org/apache/lucene/codecs/TermsIndexWriterBase.java",0,0.555555555555556,1,4,5
"lucene/core/src/java/org/apache/lucene/codecs/VariableGapTermsIndexReader.java",0,0.977973568281938,3,1,4
"lucene/core/src/java/org/apache/lucene/codecs/VariableGapTermsIndexWriter.java",0,0.884735202492212,4,2,6
"lucene/core/src/java/org/apache/lucene/codecs/appending/AppendingCodec.java",0,0.628865979381443,1,2,3
"lucene/core/src/java/org/apache/lucene/codecs/appending/AppendingPostingsFormat.java",0,0.9,1,2,3
"lucene/core/src/java/org/apache/lucene/codecs/appending/AppendingTermsReader.java",0,0.590163934426229,3,2,5
"lucene/core/src/java/org/apache/lucene/codecs/appending/AppendingTermsWriter.java",0,0.96875,2,1,3
"lucene/core/src/java/org/apache/lucene/codecs/intblock/FixedIntBlockIndexInput.java",0,0.870646766169154,2,3,5
"lucene/core/src/java/org/apache/lucene/codecs/intblock/FixedIntBlockIndexOutput.java",0,0.724409448818898,2,2,4
"lucene/core/src/java/org/apache/lucene/codecs/intblock/VariableIntBlockIndexInput.java",0,0.927927927927928,2,2,4
"lucene/core/src/java/org/apache/lucene/codecs/intblock/VariableIntBlockIndexOutput.java",0,0.918518518518519,1,2,3
"lucene/core/src/java/org/apache/lucene/codecs/lucene3x/Lucene3xCodec.java",0,0.80794701986755,2,2,4
"lucene/core/src/java/org/apache/lucene/codecs/lucene3x/Lucene3xFieldInfosFormat.java",0,0.955555555555556,2,1,3
"lucene/core/src/java/org/apache/lucene/codecs/lucene3x/Lucene3xFieldInfosReader.java",0,0.897435897435897,1,2,3
"lucene/core/src/java/org/apache/lucene/codecs/lucene3x/Lucene3xFields.java",0,0.50994575045208,2,3,5
"lucene/core/src/java/org/apache/lucene/codecs/lucene3x/Lucene3xNormsFormat.java",0,0.934782608695652,2,1,3
"lucene/core/src/java/org/apache/lucene/codecs/lucene3x/Lucene3xNormsProducer.java",0,0.5375,3,2,5
"lucene/core/src/java/org/apache/lucene/codecs/lucene3x/Lucene3xPostingsFormat.java",0,0.71875,2,3,5
"lucene/core/src/java/org/apache/lucene/codecs/lucene3x/Lucene3xSegmentInfoFormat.java",0,0.426966292134831,2,3,5
"lucene/core/src/java/org/apache/lucene/codecs/lucene3x/Lucene3xSegmentInfoReader.java",0,0.382352941176471,2,3,5
"lucene/core/src/java/org/apache/lucene/codecs/lucene3x/Lucene3xSkipListReader.java",0,0.991452991452991,1,1,2
"lucene/core/src/java/org/apache/lucene/codecs/lucene3x/Lucene3xStoredFieldsFormat.java",0,0.955555555555556,2,1,3
"lucene/core/src/java/org/apache/lucene/codecs/lucene3x/Lucene3xStoredFieldsReader.java",0,0.986577181208054,2,1,3
"lucene/core/src/java/org/apache/lucene/codecs/lucene3x/Lucene3xTermVectorsFormat.java",0,0.5,1,3,4
"lucene/core/src/java/org/apache/lucene/codecs/lucene3x/Lucene3xTermVectorsReader.java",0,0.984308131241084,3,1,4
"lucene/core/src/java/org/apache/lucene/codecs/lucene3x/SegmentTermDocs.java",0,0.877729257641921,1,3,4
"lucene/core/src/java/org/apache/lucene/codecs/lucene3x/SegmentTermEnum.java",0,0.36,4,6,10
"lucene/core/src/java/org/apache/lucene/codecs/lucene3x/SegmentTermPositions.java",0,0.91324200913242,2,2,4
"lucene/core/src/java/org/apache/lucene/codecs/lucene3x/TermBuffer.java",0,0.5546875,2,3,5
"lucene/core/src/java/org/apache/lucene/codecs/lucene3x/TermInfo.java",0,0.428571428571429,1,5,6
"lucene/core/src/java/org/apache/lucene/codecs/lucene3x/TermInfosReader.java",0,0.512820512820513,6,6,12
"lucene/core/src/java/org/apache/lucene/codecs/lucene3x/TermInfosReaderIndex.java",0,0.968871595330739,3,1,4
"lucene/core/src/java/org/apache/lucene/codecs/lucene40/BitVector.java",0,0.580952380952381,6,3,9
"lucene/core/src/java/org/apache/lucene/codecs/lucene40/Lucene40Codec.java",0,0.990909090909091,1,1,2
"lucene/core/src/java/org/apache/lucene/codecs/lucene40/Lucene40DocValuesConsumer.java",0,0.628205128205128,2,2,4
"lucene/core/src/java/org/apache/lucene/codecs/lucene40/Lucene40DocValuesFormat.java",0,0.767605633802817,1,3,4
"lucene/core/src/java/org/apache/lucene/codecs/lucene40/Lucene40DocValuesProducer.java",0,0.714285714285714,2,2,4
"lucene/core/src/java/org/apache/lucene/codecs/lucene40/Lucene40FieldInfosFormat.java",0,0.981981981981982,2,1,3
"lucene/core/src/java/org/apache/lucene/codecs/lucene40/Lucene40FieldInfosReader.java",0,0.673913043478261,3,2,5
"lucene/core/src/java/org/apache/lucene/codecs/lucene40/Lucene40FieldInfosWriter.java",0,0.631578947368421,3,2,5
"lucene/core/src/java/org/apache/lucene/codecs/lucene40/Lucene40LiveDocsFormat.java",0,0.824074074074074,2,2,4
"lucene/core/src/java/org/apache/lucene/codecs/lucene40/Lucene40NormsFormat.java",0,0.495798319327731,2,2,4
"lucene/core/src/java/org/apache/lucene/codecs/lucene40/Lucene40PostingsBaseFormat.java",0,0.96,2,1,3
"lucene/core/src/java/org/apache/lucene/codecs/lucene40/Lucene40PostingsFormat.java",0,0.653958944281525,2,3,5
"lucene/core/src/java/org/apache/lucene/codecs/lucene40/Lucene40PostingsReader.java",0,0.368600682593857,4,3,7
"lucene/core/src/java/org/apache/lucene/codecs/lucene40/Lucene40PostingsWriter.java",0,0.733333333333333,4,2,6
"lucene/core/src/java/org/apache/lucene/codecs/lucene40/Lucene40SegmentInfoFormat.java",0,0.954545454545455,3,1,4
"lucene/core/src/java/org/apache/lucene/codecs/lucene40/Lucene40SegmentInfoReader.java",0,0.378378378378378,3,3,6
"lucene/core/src/java/org/apache/lucene/codecs/lucene40/Lucene40SegmentInfoWriter.java",0,0.414285714285714,3,4,7
"lucene/core/src/java/org/apache/lucene/codecs/lucene40/Lucene40SkipListReader.java",0,0.74468085106383,1,2,3
"lucene/core/src/java/org/apache/lucene/codecs/lucene40/Lucene40SkipListWriter.java",0,0.649006622516556,1,2,3
"lucene/core/src/java/org/apache/lucene/codecs/lucene40/Lucene40StoredFieldsFormat.java",0,0.673684210526316,2,3,5
"lucene/core/src/java/org/apache/lucene/codecs/lucene40/Lucene40StoredFieldsReader.java",0,0.340248962655602,9,3,12
"lucene/core/src/java/org/apache/lucene/codecs/lucene40/Lucene40StoredFieldsWriter.java",0,0.46865671641791,5,3,8
"lucene/core/src/java/org/apache/lucene/codecs/lucene40/Lucene40TermVectorsFormat.java",0,0.929824561403509,2,2,4
"lucene/core/src/java/org/apache/lucene/codecs/lucene40/Lucene40TermVectorsReader.java",0,0.904624277456647,3,2,5
"lucene/core/src/java/org/apache/lucene/codecs/lucene40/Lucene40TermVectorsWriter.java",0,0.943298969072165,4,1,5
"lucene/core/src/java/org/apache/lucene/codecs/lucene40/values/Bytes.java",0,0.877850162866449,2,3,5
"lucene/core/src/java/org/apache/lucene/codecs/lucene40/values/DirectSource.java",0,0.956521739130435,2,1,3
"lucene/core/src/java/org/apache/lucene/codecs/lucene40/values/DocValuesWriterBase.java",0,0.697916666666667,2,3,5
"lucene/core/src/java/org/apache/lucene/codecs/lucene40/values/FixedDerefBytesImpl.java",0,0.904411764705882,2,2,4
"lucene/core/src/java/org/apache/lucene/codecs/lucene40/values/FixedSortedBytesImpl.java",0,0.853448275862069,1,3,4
"lucene/core/src/java/org/apache/lucene/codecs/lucene40/values/FixedStraightBytesImpl.java",0,0.83739837398374,1,2,3
"lucene/core/src/java/org/apache/lucene/codecs/lucene40/values/Floats.java",0,0.872,2,2,4
"lucene/core/src/java/org/apache/lucene/codecs/lucene40/values/Ints.java",0,0.84,2,2,4
"lucene/core/src/java/org/apache/lucene/codecs/lucene40/values/PackedIntValues.java",0,0.850980392156863,2,3,5
"lucene/core/src/java/org/apache/lucene/codecs/lucene40/values/VarDerefBytesImpl.java",0,0.928104575163399,2,2,4
"lucene/core/src/java/org/apache/lucene/codecs/lucene40/values/VarSortedBytesImpl.java",0,0.825581395348837,1,3,4
"lucene/core/src/java/org/apache/lucene/codecs/lucene40/values/VarStraightBytesImpl.java",0,0.846153846153846,1,2,3
"lucene/core/src/java/org/apache/lucene/codecs/lucene40/values/Writer.java",0,0.811023622047244,1,3,4
"lucene/core/src/java/org/apache/lucene/codecs/memory/MemoryPostingsFormat.java",0,0.732083792723264,3,2,5
"lucene/core/src/java/org/apache/lucene/codecs/perfield/PerFieldPostingsFormat.java",0,0.953307392996109,2,1,3
"lucene/core/src/java/org/apache/lucene/codecs/pulsing/Pulsing40PostingsFormat.java",0,0.977777777777778,1,1,2
"lucene/core/src/java/org/apache/lucene/codecs/pulsing/PulsingPostingsFormat.java",0,0.458333333333333,2,3,5
"lucene/core/src/java/org/apache/lucene/codecs/pulsing/PulsingPostingsReader.java",0,0.436220472440945,3,3,6
"lucene/core/src/java/org/apache/lucene/codecs/pulsing/PulsingPostingsWriter.java",0,0.52744630071599,1,3,4
"lucene/core/src/java/org/apache/lucene/codecs/sep/IntIndexInput.java",0,0.881578947368421,3,2,5
"lucene/core/src/java/org/apache/lucene/codecs/sep/IntIndexOutput.java",0,0.915254237288136,1,2,3
"lucene/core/src/java/org/apache/lucene/codecs/sep/IntStreamFactory.java",0,0.827586206896552,3,2,5
"lucene/core/src/java/org/apache/lucene/codecs/sep/SepDocValuesConsumer.java",0,0.857142857142857,1,3,4
"lucene/core/src/java/org/apache/lucene/codecs/sep/SepDocValuesProducer.java",0,0.549450549450549,2,2,4
"lucene/core/src/java/org/apache/lucene/codecs/sep/SepPostingsReader.java",0,0.630173564753004,3,3,6
"lucene/core/src/java/org/apache/lucene/codecs/sep/SepPostingsWriter.java",0,0.4,2,4,6
"lucene/core/src/java/org/apache/lucene/codecs/sep/SepSkipListReader.java",0,0.937799043062201,1,2,3
"lucene/core/src/java/org/apache/lucene/codecs/sep/SepSkipListWriter.java",0,0.92,2,2,4
"lucene/core/src/java/org/apache/lucene/codecs/simpletext/SimpleTextCodec.java",0,0.978021978021978,2,1,3
"lucene/core/src/java/org/apache/lucene/codecs/simpletext/SimpleTextDocValuesConsumer.java",0,0.95578231292517,3,1,4
"lucene/core/src/java/org/apache/lucene/codecs/simpletext/SimpleTextDocValuesFormat.java",0,0.862745098039216,1,2,3
"lucene/core/src/java/org/apache/lucene/codecs/simpletext/SimpleTextFieldInfosFormat.java",0,0.977777777777778,1,1,2
"lucene/core/src/java/org/apache/lucene/codecs/simpletext/SimpleTextFieldInfosReader.java",0,0.82312925170068,1,2,3
"lucene/core/src/java/org/apache/lucene/codecs/simpletext/SimpleTextFieldInfosWriter.java",0,0.911764705882353,1,2,3
"lucene/core/src/java/org/apache/lucene/codecs/simpletext/SimpleTextFieldsReader.java",0,0.865030674846626,2,2,4
"lucene/core/src/java/org/apache/lucene/codecs/simpletext/SimpleTextFieldsWriter.java",0,0.79144385026738,3,2,5
"lucene/core/src/java/org/apache/lucene/codecs/simpletext/SimpleTextLiveDocsFormat.java",0,0.951351351351351,2,1,3
"lucene/core/src/java/org/apache/lucene/codecs/simpletext/SimpleTextNormsFormat.java",0,0.536,1,3,4
"lucene/core/src/java/org/apache/lucene/codecs/simpletext/SimpleTextPerDocConsumer.java",0,0.887096774193548,2,2,4
"lucene/core/src/java/org/apache/lucene/codecs/simpletext/SimpleTextPerDocProducer.java",0,0.983908045977012,3,1,4
"lucene/core/src/java/org/apache/lucene/codecs/simpletext/SimpleTextPostingsFormat.java",0,0.830508474576271,2,2,4
"lucene/core/src/java/org/apache/lucene/codecs/simpletext/SimpleTextSegmentInfoFormat.java",0,0.888888888888889,3,1,4
"lucene/core/src/java/org/apache/lucene/codecs/simpletext/SimpleTextSegmentInfoReader.java",0,0.551181102362205,2,2,4
"lucene/core/src/java/org/apache/lucene/codecs/simpletext/SimpleTextSegmentInfoWriter.java",0,0.551470588235294,1,2,3
"lucene/core/src/java/org/apache/lucene/codecs/simpletext/SimpleTextStoredFieldsFormat.java",0,0.468085106382979,3,2,5
"lucene/core/src/java/org/apache/lucene/codecs/simpletext/SimpleTextStoredFieldsReader.java",0,0.953367875647668,2,1,3
"lucene/core/src/java/org/apache/lucene/codecs/simpletext/SimpleTextStoredFieldsWriter.java",0,0.826530612244898,2,2,4
"lucene/core/src/java/org/apache/lucene/codecs/simpletext/SimpleTextTermVectorsFormat.java",0,0.957446808510638,2,1,3
"lucene/core/src/java/org/apache/lucene/codecs/simpletext/SimpleTextTermVectorsReader.java",0,0.915057915057915,2,2,4
"lucene/core/src/java/org/apache/lucene/codecs/simpletext/SimpleTextTermVectorsWriter.java",0,0.989528795811518,2,1,3
"lucene/core/src/java/org/apache/lucene/codecs/simpletext/SimpleTextUtil.java",0,0.985714285714286,1,1,2
"lucene/core/src/java/org/apache/lucene/document/ByteDocValuesField.java",0,0.941176470588235,0,2,2
"lucene/core/src/java/org/apache/lucene/document/CompressionTools.java",0,0.825174825174825,3,2,5
"lucene/core/src/java/org/apache/lucene/document/DateTools.java",0,0.79047619047619,3,2,5
"lucene/core/src/java/org/apache/lucene/document/DerefBytesDocValuesField.java",0,0.955882352941177,1,1,2
"lucene/core/src/java/org/apache/lucene/document/Document.java",0,0.5,3,2,5
"lucene/core/src/java/org/apache/lucene/document/DocumentStoredFieldVisitor.java",0,0.801980198019802,1,2,3
"lucene/core/src/java/org/apache/lucene/document/DoubleDocValuesField.java",0,0.941176470588235,0,2,2
"lucene/core/src/java/org/apache/lucene/document/DoubleField.java",0,0.993548387096774,1,1,2
"lucene/core/src/java/org/apache/lucene/document/Field.java",0,0.869752421959096,11,2,13
"lucene/core/src/java/org/apache/lucene/document/FieldType.java",0,0.95850622406639,2,1,3
"lucene/core/src/java/org/apache/lucene/document/FloatDocValuesField.java",0,0.96,1,1,2
"lucene/core/src/java/org/apache/lucene/document/FloatField.java",0,0.993548387096774,1,1,2
"lucene/core/src/java/org/apache/lucene/document/IntDocValuesField.java",0,0.96,1,1,2
"lucene/core/src/java/org/apache/lucene/document/IntField.java",0,0.993548387096774,1,1,2
"lucene/core/src/java/org/apache/lucene/document/LongDocValuesField.java",0,0.96,1,1,2
"lucene/core/src/java/org/apache/lucene/document/LongField.java",0,0.636363636363636,2,2,4
"lucene/core/src/java/org/apache/lucene/document/PackedLongDocValuesField.java",0,0.944444444444444,0,2,2
"lucene/core/src/java/org/apache/lucene/document/ShortDocValuesField.java",0,0.941176470588235,0,2,2
"lucene/core/src/java/org/apache/lucene/document/SortedBytesDocValuesField.java",0,0.952380952380952,1,1,2
"lucene/core/src/java/org/apache/lucene/document/StoredField.java",0,0.985915492957746,1,1,2
"lucene/core/src/java/org/apache/lucene/document/StraightBytesDocValuesField.java",0,0.955223880597015,1,1,2
"lucene/core/src/java/org/apache/lucene/document/StringField.java",0,0.983333333333333,1,1,2
"lucene/core/src/java/org/apache/lucene/document/TextField.java",0,0.984126984126984,1,1,2
"lucene/core/src/java/org/apache/lucene/index/AtomicReader.java",0,0.882075471698113,2,2,4
"lucene/core/src/java/org/apache/lucene/index/AtomicReaderContext.java",0,0.985507246376812,1,1,2
"lucene/core/src/java/org/apache/lucene/index/AutomatonTermsEnum.java",0,0.700934579439252,2,3,5
"lucene/core/src/java/org/apache/lucene/index/BaseCompositeReader.java",0,0.974522292993631,2,1,3
"lucene/core/src/java/org/apache/lucene/index/BitsSlice.java",0,0.980392156862745,1,1,2
"lucene/core/src/java/org/apache/lucene/index/BufferedDeletes.java",0,0.925465838509317,4,1,5
"lucene/core/src/java/org/apache/lucene/index/BufferedDeletesStream.java",0,0.811740890688259,4,2,6
"lucene/core/src/java/org/apache/lucene/index/ByteSliceReader.java",0,0.936170212765957,1,2,3
"lucene/core/src/java/org/apache/lucene/index/ByteSliceWriter.java",0,0.941860465116279,3,1,4
"lucene/core/src/java/org/apache/lucene/index/CheckIndex.java",0,0.542241855328548,9,2,11
"lucene/core/src/java/org/apache/lucene/index/CoalescedDeletes.java",0,0.994764397905759,1,1,2
"lucene/core/src/java/org/apache/lucene/index/CompositeReader.java",0,0.96969696969697,3,1,4
"lucene/core/src/java/org/apache/lucene/index/CompositeReaderContext.java",0,0.991935483870968,1,1,2
"lucene/core/src/java/org/apache/lucene/index/ConcurrentMergeScheduler.java",0,0.898272552783109,3,2,5
"lucene/core/src/java/org/apache/lucene/index/CorruptIndexException.java",0,0.966666666666667,1,1,2
"lucene/core/src/java/org/apache/lucene/index/DirectoryReader.java",0,0.805687203791469,5,2,7
"lucene/core/src/java/org/apache/lucene/index/DocConsumer.java",0,0.827586206896552,2,2,4
"lucene/core/src/java/org/apache/lucene/index/DocFieldConsumer.java",0,0.785714285714286,3,2,5
"lucene/core/src/java/org/apache/lucene/index/DocFieldConsumerPerField.java",0,0.888888888888889,3,1,4
"lucene/core/src/java/org/apache/lucene/index/DocFieldProcessor.java",0,0.392,1,6,7
"lucene/core/src/java/org/apache/lucene/index/DocFieldProcessorPerField.java",0,0.701754385964912,1,3,4
"lucene/core/src/java/org/apache/lucene/index/DocInverter.java",0,0.633333333333333,3,2,5
"lucene/core/src/java/org/apache/lucene/index/DocInverterPerField.java",0,0.461538461538462,4,4,8
"lucene/core/src/java/org/apache/lucene/index/DocTermOrds.java",0,0.872235872235872,5,2,7
"lucene/core/src/java/org/apache/lucene/index/DocValues.java",0,0.916780354706685,3,2,5
"lucene/core/src/java/org/apache/lucene/index/DocsAndPositionsEnum.java",0,0.693877551020408,1,2,3
"lucene/core/src/java/org/apache/lucene/index/DocsEnum.java",0,0.790697674418605,3,2,5
"lucene/core/src/java/org/apache/lucene/index/DocumentsWriter.java",0,0.461016949152542,3,4,7
"lucene/core/src/java/org/apache/lucene/index/DocumentsWriterDeleteQueue.java",0,0.930622009569378,2,2,4
"lucene/core/src/java/org/apache/lucene/index/DocumentsWriterFlushControl.java",0,0.950995405819296,4,1,5
"lucene/core/src/java/org/apache/lucene/index/DocumentsWriterFlushQueue.java",0,0.986238532110092,2,1,3
"lucene/core/src/java/org/apache/lucene/index/DocumentsWriterPerThread.java",0,0.444061962134251,4,4,8
"lucene/core/src/java/org/apache/lucene/index/DocumentsWriterPerThreadPool.java",0,0.822157434402332,3,3,6
"lucene/core/src/java/org/apache/lucene/index/DocumentsWriterStallControl.java",0,1,0,1,1
"lucene/core/src/java/org/apache/lucene/index/FieldInfo.java",0,0.560606060606061,1,4,5
"lucene/core/src/java/org/apache/lucene/index/FieldInfos.java",0,0.891025641025641,2,2,4
"lucene/core/src/java/org/apache/lucene/index/FieldInvertState.java",0,0.705479452054795,3,2,5
"lucene/core/src/java/org/apache/lucene/index/Fields.java",0,0.455882352941176,2,3,5
"lucene/core/src/java/org/apache/lucene/index/FieldsEnum.java",0,0.772151898734177,3,2,5
"lucene/core/src/java/org/apache/lucene/index/FilterAtomicReader.java",0,0.580487804878049,7,3,10
"lucene/core/src/java/org/apache/lucene/index/FilteredTermsEnum.java",0,0.743801652892562,2,3,5
"lucene/core/src/java/org/apache/lucene/index/FlushByRamOrCountsPolicy.java",0,0.8828125,3,2,5
"lucene/core/src/java/org/apache/lucene/index/FlushPolicy.java",0,0.817567567567568,3,2,5
"lucene/core/src/java/org/apache/lucene/index/FreqProxTermsWriter.java",0,0.544715447154472,3,4,7
"lucene/core/src/java/org/apache/lucene/index/FreqProxTermsWriterPerField.java",0,0.317028985507246,3,4,7
"lucene/core/src/java/org/apache/lucene/index/FrozenBufferedDeletes.java",0,0.717241379310345,1,3,4
"lucene/core/src/java/org/apache/lucene/index/IndexCommit.java",0,0.801652892561983,3,2,5
"lucene/core/src/java/org/apache/lucene/index/IndexDeletionPolicy.java",0,0.989795918367347,1,1,2
"lucene/core/src/java/org/apache/lucene/index/IndexFileDeleter.java",0,0.765714285714286,7,2,9
"lucene/core/src/java/org/apache/lucene/index/IndexFileNames.java",0,0.338541666666667,2,6,8
"lucene/core/src/java/org/apache/lucene/index/IndexFormatTooNewException.java",0,0.675,1,2,3
"lucene/core/src/java/org/apache/lucene/index/IndexFormatTooOldException.java",0,0.519230769230769,1,3,4
"lucene/core/src/java/org/apache/lucene/index/IndexNotFoundException.java",0,0.9375,2,1,3
"lucene/core/src/java/org/apache/lucene/index/IndexReader.java",0,0.345351043643264,10,4,14
"lucene/core/src/java/org/apache/lucene/index/IndexReaderContext.java",0,0.984615384615385,1,1,2
"lucene/core/src/java/org/apache/lucene/index/IndexUpgrader.java",0,0.730538922155689,2,3,5
"lucene/core/src/java/org/apache/lucene/index/IndexWriter.java",0,0.778216843665102,17,2,19
"lucene/core/src/java/org/apache/lucene/index/IndexWriterConfig.java",0,0.503861003861004,5,4,9
"lucene/core/src/java/org/apache/lucene/index/IndexableField.java",0,0.742857142857143,2,3,5
"lucene/core/src/java/org/apache/lucene/index/IndexableFieldType.java",0,0.714285714285714,0,3,3
"lucene/core/src/java/org/apache/lucene/index/IntBlockPool.java",0,0.8,2,3,5
"lucene/core/src/java/org/apache/lucene/index/InvertedDocConsumer.java",0,0.8,2,2,4
"lucene/core/src/java/org/apache/lucene/index/InvertedDocConsumerPerField.java",0,0.857142857142857,1,2,3
"lucene/core/src/java/org/apache/lucene/index/InvertedDocEndConsumer.java",0,0.793103448275862,2,2,4
"lucene/core/src/java/org/apache/lucene/index/InvertedDocEndConsumerPerField.java",0,0.84,1,2,3
"lucene/core/src/java/org/apache/lucene/index/KeepOnlyLastCommitDeletionPolicy.java",0,0.98,1,1,2
"lucene/core/src/java/org/apache/lucene/index/LiveIndexWriterConfig.java",0,1,0,1,1
"lucene/core/src/java/org/apache/lucene/index/LogByteSizeMergePolicy.java",0,0.747663551401869,1,3,4
"lucene/core/src/java/org/apache/lucene/index/LogDocMergePolicy.java",0,0.890625,1,2,3
"lucene/core/src/java/org/apache/lucene/index/LogMergePolicy.java",0,0.460410557184751,2,3,5
"lucene/core/src/java/org/apache/lucene/index/MergePolicy.java",0,0.899425287356322,6,2,8
"lucene/core/src/java/org/apache/lucene/index/MergeScheduler.java",0,0.947368421052632,2,1,3
"lucene/core/src/java/org/apache/lucene/index/MergeState.java",0,0.780392156862745,3,3,6
"lucene/core/src/java/org/apache/lucene/index/MultiBits.java",0,0.695652173913043,1,3,4
"lucene/core/src/java/org/apache/lucene/index/MultiDocValues.java",0,0.700996677740864,2,3,5
"lucene/core/src/java/org/apache/lucene/index/MultiDocsAndPositionsEnum.java",0,0.803921568627451,2,2,4
"lucene/core/src/java/org/apache/lucene/index/MultiDocsEnum.java",0,0.776978417266187,2,3,5
"lucene/core/src/java/org/apache/lucene/index/MultiFields.java",0,0.71259842519685,2,4,6
"lucene/core/src/java/org/apache/lucene/index/MultiFieldsEnum.java",0,0.909774436090226,4,1,5
"lucene/core/src/java/org/apache/lucene/index/MultiReader.java",0,0.494117647058824,2,6,8
"lucene/core/src/java/org/apache/lucene/index/MultiTerms.java",0,0.527397260273973,1,3,4
"lucene/core/src/java/org/apache/lucene/index/MultiTermsEnum.java",0,0.625698324022346,2,2,4
"lucene/core/src/java/org/apache/lucene/index/NoDeletionPolicy.java",0,0.560975609756098,2,2,4
"lucene/core/src/java/org/apache/lucene/index/NoMergePolicy.java",0,0.936708860759494,1,2,3
"lucene/core/src/java/org/apache/lucene/index/NoMergeScheduler.java",0,0.956521739130435,2,1,3
"lucene/core/src/java/org/apache/lucene/index/Norm.java",0,0.71195652173913,1,2,3
"lucene/core/src/java/org/apache/lucene/index/NormsConsumer.java",0,0.436363636363636,3,4,7
"lucene/core/src/java/org/apache/lucene/index/NormsConsumerPerField.java",0,0.554347826086957,3,3,6
"lucene/core/src/java/org/apache/lucene/index/OrdTermState.java",0,0.842105263157895,1,2,3
"lucene/core/src/java/org/apache/lucene/index/ParallelAtomicReader.java",0,0.928571428571429,3,1,4
"lucene/core/src/java/org/apache/lucene/index/ParallelCompositeReader.java",0,0.99468085106383,1,1,2
"lucene/core/src/java/org/apache/lucene/index/ParallelPostingsArray.java",0,0.551724137931034,1,3,4
"lucene/core/src/java/org/apache/lucene/index/PayloadProcessorProvider.java",0,0.851851851851852,1,2,3
"lucene/core/src/java/org/apache/lucene/index/PerDocWriteState.java",0,0.5,1,3,4
"lucene/core/src/java/org/apache/lucene/index/PersistentSnapshotDeletionPolicy.java",0,0.935643564356436,5,1,6
"lucene/core/src/java/org/apache/lucene/index/PrefixCodedTerms.java",0,0.986206896551724,2,1,3
"lucene/core/src/java/org/apache/lucene/index/ReaderManager.java",0,1,0,1,1
"lucene/core/src/java/org/apache/lucene/index/ReaderSlice.java",0,1,0,1,1
"lucene/core/src/java/org/apache/lucene/index/ReaderUtil.java",0,0.542553191489362,2,3,5
"lucene/core/src/java/org/apache/lucene/index/ReadersAndLiveDocs.java",0,0.996632996632997,1,1,2
"lucene/core/src/java/org/apache/lucene/index/SegmentCoreReaders.java",0,0.582352941176471,2,3,5
"lucene/core/src/java/org/apache/lucene/index/SegmentInfo.java",0,0.466666666666667,8,4,12
"lucene/core/src/java/org/apache/lucene/index/SegmentInfoPerCommit.java",0,0.993197278911565,1,1,2
"lucene/core/src/java/org/apache/lucene/index/SegmentInfos.java",0,0.748878923766816,12,3,15
"lucene/core/src/java/org/apache/lucene/index/SegmentMerger.java",0,0.317460317460317,4,6,10
"lucene/core/src/java/org/apache/lucene/index/SegmentReadState.java",0,0.420289855072464,1,4,5
"lucene/core/src/java/org/apache/lucene/index/SegmentReader.java",0,0.425454545454545,6,6,12
"lucene/core/src/java/org/apache/lucene/index/SegmentWriteState.java",0,0.481927710843373,1,4,5
"lucene/core/src/java/org/apache/lucene/index/SerialMergeScheduler.java",0,0.976744186046512,1,1,2
"lucene/core/src/java/org/apache/lucene/index/SingleTermsEnum.java",0,0.792452830188679,2,2,4
"lucene/core/src/java/org/apache/lucene/index/SlowCompositeReaderWrapper.java",0,0.518987341772152,2,3,5
"lucene/core/src/java/org/apache/lucene/index/SnapshotDeletionPolicy.java",0,0.828729281767956,2,2,4
"lucene/core/src/java/org/apache/lucene/index/SortedBytesMergeUtils.java",0,0.914600550964187,3,1,4
"lucene/core/src/java/org/apache/lucene/index/StandardDirectoryReader.java",0,0.90952380952381,2,2,4
"lucene/core/src/java/org/apache/lucene/index/StoredFieldVisitor.java",0,0.548780487804878,1,2,3
"lucene/core/src/java/org/apache/lucene/index/StoredFieldsConsumer.java",0,0.530612244897959,2,3,5
"lucene/core/src/java/org/apache/lucene/index/Term.java",0,0.892086330935252,2,2,4
"lucene/core/src/java/org/apache/lucene/index/TermContext.java",0,0.684848484848485,2,3,5
"lucene/core/src/java/org/apache/lucene/index/TermState.java",0,0.538461538461538,2,3,5
"lucene/core/src/java/org/apache/lucene/index/TermVectorsConsumer.java",0,0.983783783783784,2,1,3
"lucene/core/src/java/org/apache/lucene/index/TermVectorsConsumerPerField.java",0,0.51937984496124,3,4,7
"lucene/core/src/java/org/apache/lucene/index/Terms.java",0,0.412844036697248,1,3,4
"lucene/core/src/java/org/apache/lucene/index/TermsEnum.java",0,0.488095238095238,1,3,4
"lucene/core/src/java/org/apache/lucene/index/TermsHash.java",0,0.523489932885906,4,3,7
"lucene/core/src/java/org/apache/lucene/index/TermsHashConsumer.java",0,0.827586206896552,2,2,4
"lucene/core/src/java/org/apache/lucene/index/TermsHashConsumerPerField.java",0,0.837837837837838,1,3,4
"lucene/core/src/java/org/apache/lucene/index/TermsHashPerField.java",0,0.545731707317073,2,4,6
"lucene/core/src/java/org/apache/lucene/index/ThreadAffinityDocumentsWriterThreadPool.java",0,0.571428571428571,2,3,5
"lucene/core/src/java/org/apache/lucene/index/TieredMergePolicy.java",0,0.988095238095238,3,1,4
"lucene/core/src/java/org/apache/lucene/index/TwoPhaseCommit.java",0,0.974025974025974,2,1,3
"lucene/core/src/java/org/apache/lucene/index/TwoPhaseCommitTool.java",0,0.987654320987654,2,1,3
"lucene/core/src/java/org/apache/lucene/index/TypePromoter.java",0,0.604972375690608,1,2,3
"lucene/core/src/java/org/apache/lucene/index/UpgradeIndexMergePolicy.java",0,0.773584905660377,1,2,3
"lucene/core/src/java/org/apache/lucene/search/AutomatonQuery.java",0,0.786259541984733,2,2,4
"lucene/core/src/java/org/apache/lucene/search/BitsFilteredDocIdSet.java",0,0.984126984126984,1,1,2
"lucene/core/src/java/org/apache/lucene/search/BooleanClause.java",0,0.981308411214953,2,1,3
"lucene/core/src/java/org/apache/lucene/search/BooleanQuery.java",0,0.219202898550725,6,8,14
"lucene/core/src/java/org/apache/lucene/search/BooleanScorer.java",0,0.794797687861272,3,3,6
"lucene/core/src/java/org/apache/lucene/search/BooleanScorer2.java",0,0.8125,3,3,6
"lucene/core/src/java/org/apache/lucene/search/BoostAttribute.java",0,0.897435897435897,4,1,5
"lucene/core/src/java/org/apache/lucene/search/BoostAttributeImpl.java",0,0.977777777777778,1,1,2
"lucene/core/src/java/org/apache/lucene/search/CachingCollector.java",0,0.690322580645161,2,3,5
"lucene/core/src/java/org/apache/lucene/search/CachingWrapperFilter.java",0,0.407643312101911,4,4,8
"lucene/core/src/java/org/apache/lucene/search/CollectionStatistics.java",0,0.986842105263158,1,1,2
"lucene/core/src/java/org/apache/lucene/search/Collector.java",0,0.886363636363636,3,2,5
"lucene/core/src/java/org/apache/lucene/search/ComplexExplanation.java",0,0.985915492957746,1,1,2
"lucene/core/src/java/org/apache/lucene/search/ConjunctionScorer.java",0,0.956834532374101,3,1,4
"lucene/core/src/java/org/apache/lucene/search/ConjunctionTermScorer.java",0,0.849557522123894,3,2,5
"lucene/core/src/java/org/apache/lucene/search/ConstantScoreAutoRewrite.java",0,0.727272727272727,4,2,6
"lucene/core/src/java/org/apache/lucene/search/ConstantScoreQuery.java",0,0.914590747330961,4,1,5
"lucene/core/src/java/org/apache/lucene/search/DisjunctionMaxQuery.java",0,0.855704697986577,3,2,5
"lucene/core/src/java/org/apache/lucene/search/DisjunctionMaxScorer.java",0,0.695431472081218,2,3,5
"lucene/core/src/java/org/apache/lucene/search/DisjunctionSumScorer.java",0,0.525,4,4,8
"lucene/core/src/java/org/apache/lucene/search/DocIdSet.java",0,0.989010989010989,1,1,2
"lucene/core/src/java/org/apache/lucene/search/DocIdSetIterator.java",0,0.63265306122449,3,3,6
"lucene/core/src/java/org/apache/lucene/search/ExactPhraseScorer.java",0,0.864779874213837,3,2,5
"lucene/core/src/java/org/apache/lucene/search/Explanation.java",0,0.984375,2,1,3
"lucene/core/src/java/org/apache/lucene/search/FieldCache.java",0,0.326055312954876,6,5,11
"lucene/core/src/java/org/apache/lucene/search/FieldCacheDocIdSet.java",0,0.993464052287582,1,1,2
"lucene/core/src/java/org/apache/lucene/search/FieldCacheImpl.java",0,0.776444111027757,12,2,14
"lucene/core/src/java/org/apache/lucene/search/FieldCacheRangeFilter.java",0,0.968379446640316,3,1,4
"lucene/core/src/java/org/apache/lucene/search/FieldCacheTermsFilter.java",0,0.91970802919708,2,2,4
"lucene/core/src/java/org/apache/lucene/search/FieldComparator.java",0,0.813186813186813,6,2,8
"lucene/core/src/java/org/apache/lucene/search/FieldComparatorSource.java",0,0.902439024390244,3,1,4
"lucene/core/src/java/org/apache/lucene/search/FieldDoc.java",0,0.817073170731707,1,2,3
"lucene/core/src/java/org/apache/lucene/search/FieldValueFilter.java",0,0.943661971830986,2,1,3
"lucene/core/src/java/org/apache/lucene/search/FieldValueHitQueue.java",0,0.836363636363636,5,2,7
"lucene/core/src/java/org/apache/lucene/search/Filter.java",0,0.283333333333333,2,7,9
"lucene/core/src/java/org/apache/lucene/search/FilteredDocIdSet.java",0,0.979591836734694,2,1,3
"lucene/core/src/java/org/apache/lucene/search/FilteredDocIdSetIterator.java",0,0.929411764705882,1,2,3
"lucene/core/src/java/org/apache/lucene/search/FilteredQuery.java",0,0.973597359735974,4,1,5
"lucene/core/src/java/org/apache/lucene/search/FuzzyQuery.java",0,0.412844036697248,6,6,12
"lucene/core/src/java/org/apache/lucene/search/FuzzyTermsEnum.java",0,0.46606334841629,3,3,6
"lucene/core/src/java/org/apache/lucene/search/HitQueue.java",0,0.98780487804878,1,1,2
"lucene/core/src/java/org/apache/lucene/search/IndexSearcher.java",0,0.591928251121076,11,4,15
"lucene/core/src/java/org/apache/lucene/search/MatchAllDocsQuery.java",0,0.438709677419355,6,5,11
"lucene/core/src/java/org/apache/lucene/search/MatchOnlyConjunctionTermsScorer.java",0,0.972972972972973,1,1,2
"lucene/core/src/java/org/apache/lucene/search/MatchOnlyTermScorer.java",0,0.957446808510638,2,1,3
"lucene/core/src/java/org/apache/lucene/search/MaxNonCompetitiveBoostAttribute.java",0,0.91304347826087,3,1,4
"lucene/core/src/java/org/apache/lucene/search/MaxNonCompetitiveBoostAttributeImpl.java",0,0.982758620689655,1,1,2
"lucene/core/src/java/org/apache/lucene/search/MultiCollector.java",0,0.959677419354839,4,1,5
"lucene/core/src/java/org/apache/lucene/search/MultiPhraseQuery.java",0,0.340241796200345,8,5,13
"lucene/core/src/java/org/apache/lucene/search/MultiTermQuery.java",0,0.365558912386707,9,3,12
"lucene/core/src/java/org/apache/lucene/search/MultiTermQueryWrapperFilter.java",0,0.745901639344262,2,2,4
"lucene/core/src/java/org/apache/lucene/search/NGramPhraseQuery.java",0,0.989795918367347,1,1,2
"lucene/core/src/java/org/apache/lucene/search/NRTManager.java",0,0.843828715365239,2,2,4
"lucene/core/src/java/org/apache/lucene/search/NRTManagerReopenThread.java",0,0.96969696969697,2,1,3
"lucene/core/src/java/org/apache/lucene/search/NumericRangeFilter.java",0,0.928934010152284,1,2,3
"lucene/core/src/java/org/apache/lucene/search/NumericRangeQuery.java",0,0.844765342960289,3,2,5
"lucene/core/src/java/org/apache/lucene/search/PhrasePositions.java",0,0.775280898876405,2,2,4
"lucene/core/src/java/org/apache/lucene/search/PhraseQuery.java",0,0.196517412935323,8,7,15
"lucene/core/src/java/org/apache/lucene/search/PhraseQueue.java",0,0.777777777777778,1,2,3
"lucene/core/src/java/org/apache/lucene/search/PhraseScorer.java",0,0.503759398496241,6,5,11
"lucene/core/src/java/org/apache/lucene/search/PositiveScoresOnlyCollector.java",0,0.952380952380952,2,1,3
"lucene/core/src/java/org/apache/lucene/search/PrefixFilter.java",0,0.978723404255319,1,1,2
"lucene/core/src/java/org/apache/lucene/search/PrefixQuery.java",0,0.9375,3,1,4
"lucene/core/src/java/org/apache/lucene/search/PrefixTermsEnum.java",0,0.843137254901961,3,2,5
"lucene/core/src/java/org/apache/lucene/search/Query.java",0,0.27906976744186,6,6,12
"lucene/core/src/java/org/apache/lucene/search/QueryWrapperFilter.java",0,0.641975308641975,4,2,6
"lucene/core/src/java/org/apache/lucene/search/ReferenceManager.java",0,0.92093023255814,1,2,3
"lucene/core/src/java/org/apache/lucene/search/RegexpQuery.java",0,0.981132075471698,2,1,3
"lucene/core/src/java/org/apache/lucene/search/ReqExclScorer.java",0,0.558333333333333,4,3,7
"lucene/core/src/java/org/apache/lucene/search/ReqOptSumScorer.java",0,0.583333333333333,3,4,7
"lucene/core/src/java/org/apache/lucene/search/ScoreCachingWrappingScorer.java",0,0.962962962962963,3,1,4
"lucene/core/src/java/org/apache/lucene/search/ScoreDoc.java",0,0.627450980392157,2,2,4
"lucene/core/src/java/org/apache/lucene/search/Scorer.java",0,0.284615384615385,5,6,11
"lucene/core/src/java/org/apache/lucene/search/ScoringRewrite.java",0,0.870466321243523,4,2,6
"lucene/core/src/java/org/apache/lucene/search/SearcherFactory.java",0,0.982456140350877,1,1,2
"lucene/core/src/java/org/apache/lucene/search/SearcherLifetimeManager.java",0,0.968152866242038,3,1,4
"lucene/core/src/java/org/apache/lucene/search/SearcherManager.java",0,0.451219512195122,4,3,7
"lucene/core/src/java/org/apache/lucene/search/SloppyPhraseScorer.java",0,0.921104536489152,2,2,4
"lucene/core/src/java/org/apache/lucene/search/Sort.java",0,0.857843137254902,3,2,5
"lucene/core/src/java/org/apache/lucene/search/SortField.java",0,0.441501103752759,10,4,14
"lucene/core/src/java/org/apache/lucene/search/TermCollectingRewrite.java",0,0.796116504854369,4,2,6
"lucene/core/src/java/org/apache/lucene/search/TermQuery.java",0,0.18942731277533,6,6,12
"lucene/core/src/java/org/apache/lucene/search/TermRangeFilter.java",0,0.829545454545455,1,2,3
"lucene/core/src/java/org/apache/lucene/search/TermRangeQuery.java",0,0.817647058823529,1,2,3
"lucene/core/src/java/org/apache/lucene/search/TermRangeTermsEnum.java",0,0.672727272727273,2,2,4
"lucene/core/src/java/org/apache/lucene/search/TermScorer.java",0,0.239130434782609,2,7,9
"lucene/core/src/java/org/apache/lucene/search/TermStatistics.java",0,0.927272727272727,1,2,3
"lucene/core/src/java/org/apache/lucene/search/TimeLimitingCollector.java",0,0.557324840764331,2,2,4
"lucene/core/src/java/org/apache/lucene/search/TopDocs.java",0,0.83969465648855,7,2,9
"lucene/core/src/java/org/apache/lucene/search/TopDocsCollector.java",0,0.857142857142857,1,3,4
"lucene/core/src/java/org/apache/lucene/search/TopFieldCollector.java",0,0.94189852700491,6,1,7
"lucene/core/src/java/org/apache/lucene/search/TopFieldDocs.java",0,0.41025641025641,1,3,4
"lucene/core/src/java/org/apache/lucene/search/TopScoreDocCollector.java",0,0.459807073954984,2,3,5
"lucene/core/src/java/org/apache/lucene/search/TopTermsRewrite.java",0,0.785714285714286,3,2,5
"lucene/core/src/java/org/apache/lucene/search/TotalHitCountCollector.java",0,0.862745098039216,3,2,5
"lucene/core/src/java/org/apache/lucene/search/Weight.java",0,0.6484375,2,3,5
"lucene/core/src/java/org/apache/lucene/search/WildcardQuery.java",0,0.833333333333333,2,2,4
"lucene/core/src/java/org/apache/lucene/search/payloads/AveragePayloadFunction.java",0,0.848484848484849,1,2,3
"lucene/core/src/java/org/apache/lucene/search/payloads/MaxPayloadFunction.java",0,0.594202898550725,1,3,4
"lucene/core/src/java/org/apache/lucene/search/payloads/MinPayloadFunction.java",0,0.485294117647059,1,3,4
"lucene/core/src/java/org/apache/lucene/search/payloads/PayloadFunction.java",0,0.774647887323944,2,3,5
"lucene/core/src/java/org/apache/lucene/search/payloads/PayloadNearQuery.java",0,0.72962962962963,3,3,6
"lucene/core/src/java/org/apache/lucene/search/payloads/PayloadSpanUtil.java",0,0.763819095477387,3,4,7
"lucene/core/src/java/org/apache/lucene/search/payloads/PayloadTermQuery.java",0,0.75,2,2,4
"lucene/core/src/java/org/apache/lucene/search/similarities/AfterEffect.java",0,0.984126984126984,1,1,2
"lucene/core/src/java/org/apache/lucene/search/similarities/AfterEffectB.java",0,0.979591836734694,1,1,2
"lucene/core/src/java/org/apache/lucene/search/similarities/AfterEffectL.java",0,0.977777777777778,1,1,2
"lucene/core/src/java/org/apache/lucene/search/similarities/BM25Similarity.java",0,0.983050847457627,3,1,4
"lucene/core/src/java/org/apache/lucene/search/similarities/BasicModel.java",0,0.983333333333333,1,1,2
"lucene/core/src/java/org/apache/lucene/search/similarities/BasicModelBE.java",0,0.980392156862745,1,1,2
"lucene/core/src/java/org/apache/lucene/search/similarities/BasicModelD.java",0,0.980769230769231,1,1,2
"lucene/core/src/java/org/apache/lucene/search/similarities/BasicModelG.java",0,0.976744186046512,1,1,2
"lucene/core/src/java/org/apache/lucene/search/similarities/BasicModelIF.java",0,0.973684210526316,1,1,2
"lucene/core/src/java/org/apache/lucene/search/similarities/BasicModelIn.java",0,0.980769230769231,1,1,2
"lucene/core/src/java/org/apache/lucene/search/similarities/BasicModelIne.java",0,0.975,1,1,2
"lucene/core/src/java/org/apache/lucene/search/similarities/BasicModelP.java",0,0.978260869565217,1,1,2
"lucene/core/src/java/org/apache/lucene/search/similarities/BasicStats.java",0,0.993150684931507,1,1,2
"lucene/core/src/java/org/apache/lucene/search/similarities/DFRSimilarity.java",0,0.989795918367347,1,1,2
"lucene/core/src/java/org/apache/lucene/search/similarities/DefaultSimilarity.java",0,0.317307692307692,3,4,7
"lucene/core/src/java/org/apache/lucene/search/similarities/Distribution.java",0,0.977777777777778,1,1,2
"lucene/core/src/java/org/apache/lucene/search/similarities/DistributionLL.java",0,0.972972972972973,1,1,2
"lucene/core/src/java/org/apache/lucene/search/similarities/DistributionSPL.java",0,0.976190476190476,1,1,2
"lucene/core/src/java/org/apache/lucene/search/similarities/IBSimilarity.java",0,0.990566037735849,1,1,2
"lucene/core/src/java/org/apache/lucene/search/similarities/LMDirichletSimilarity.java",0,0.989690721649485,1,1,2
"lucene/core/src/java/org/apache/lucene/search/similarities/LMJelinekMercerSimilarity.java",0,0.987012987012987,1,1,2
"lucene/core/src/java/org/apache/lucene/search/similarities/LMSimilarity.java",0,0.993464052287582,1,1,2
"lucene/core/src/java/org/apache/lucene/search/similarities/Lambda.java",0,0.976190476190476,1,1,2
"lucene/core/src/java/org/apache/lucene/search/similarities/LambdaDF.java",0,0.979166666666667,1,1,2
"lucene/core/src/java/org/apache/lucene/search/similarities/LambdaTTF.java",0,0.979166666666667,1,1,2
"lucene/core/src/java/org/apache/lucene/search/similarities/MultiSimilarity.java",0,0.96875,3,1,4
"lucene/core/src/java/org/apache/lucene/search/similarities/Normalization.java",0,0.986666666666667,1,1,2
"lucene/core/src/java/org/apache/lucene/search/similarities/NormalizationH1.java",0,0.981481481481482,1,1,2
"lucene/core/src/java/org/apache/lucene/search/similarities/NormalizationH2.java",0,0.982142857142857,1,1,2
"lucene/core/src/java/org/apache/lucene/search/similarities/NormalizationH3.java",0,0.979166666666667,1,1,2
"lucene/core/src/java/org/apache/lucene/search/similarities/NormalizationZ.java",0,0.979166666666667,1,1,2
"lucene/core/src/java/org/apache/lucene/search/similarities/PerFieldSimilarityWrapper.java",0,0.98780487804878,1,1,2
"lucene/core/src/java/org/apache/lucene/search/similarities/Similarity.java",0,0.802158273381295,8,2,10
"lucene/core/src/java/org/apache/lucene/search/similarities/SimilarityBase.java",0,0.970149253731343,4,1,5
"lucene/core/src/java/org/apache/lucene/search/similarities/TFIDFSimilarity.java",0,0.990022172949002,3,1,4
"lucene/core/src/java/org/apache/lucene/search/spans/FieldMaskingSpanQuery.java",0,0.842767295597484,4,2,6
"lucene/core/src/java/org/apache/lucene/search/spans/NearSpansOrdered.java",0,0.976945244956772,2,1,3
"lucene/core/src/java/org/apache/lucene/search/spans/NearSpansUnordered.java",0,0.981366459627329,2,1,3
"lucene/core/src/java/org/apache/lucene/search/spans/SpanFirstQuery.java",0,0.733333333333333,3,3,6
"lucene/core/src/java/org/apache/lucene/search/spans/SpanMultiTermQueryWrapper.java",0,0.962962962962963,2,1,3
"lucene/core/src/java/org/apache/lucene/search/spans/SpanNearPayloadCheckQuery.java",0,0.931623931623932,2,2,4
"lucene/core/src/java/org/apache/lucene/search/spans/SpanNearQuery.java",0,0.923076923076923,4,1,5
"lucene/core/src/java/org/apache/lucene/search/spans/SpanNotQuery.java",0,0.958333333333333,3,1,4
"lucene/core/src/java/org/apache/lucene/search/spans/SpanOrQuery.java",0,0.969811320754717,3,1,4
"lucene/core/src/java/org/apache/lucene/search/spans/SpanPayloadCheckQuery.java",0,0.932773109243697,2,2,4
"lucene/core/src/java/org/apache/lucene/search/spans/SpanPositionCheckQuery.java",0,0.735449735449735,2,2,4
"lucene/core/src/java/org/apache/lucene/search/spans/SpanPositionRangeQuery.java",0,0.904761904761905,2,2,4
"lucene/core/src/java/org/apache/lucene/search/spans/SpanQuery.java",0,0.844444444444444,2,2,4
"lucene/core/src/java/org/apache/lucene/search/spans/SpanScorer.java",0,0.26,3,7,10
"lucene/core/src/java/org/apache/lucene/search/spans/SpanTermQuery.java",0,0.681818181818182,2,2,4
"lucene/core/src/java/org/apache/lucene/search/spans/SpanWeight.java",0,0.353982300884956,3,7,10
"lucene/core/src/java/org/apache/lucene/search/spans/Spans.java",0,0.425287356321839,4,4,8
"lucene/core/src/java/org/apache/lucene/search/spans/TermSpans.java",0,1,0,1,1
"lucene/core/src/java/org/apache/lucene/store/AlreadyClosedException.java",0,0.964285714285714,1,1,2
"lucene/core/src/java/org/apache/lucene/store/BufferedIndexInput.java",0,0.662162162162162,3,4,7
"lucene/core/src/java/org/apache/lucene/store/BufferedIndexOutput.java",0,0.992805755395683,1,1,2
"lucene/core/src/java/org/apache/lucene/store/ByteArrayDataInput.java",0,0.712574850299401,2,2,4
"lucene/core/src/java/org/apache/lucene/store/ByteArrayDataOutput.java",0,0.763888888888889,1,2,3
"lucene/core/src/java/org/apache/lucene/store/ChecksumIndexInput.java",0,0.844155844155844,1,3,4
"lucene/core/src/java/org/apache/lucene/store/ChecksumIndexOutput.java",0,0.831325301204819,1,3,4
"lucene/core/src/java/org/apache/lucene/store/CompoundFileDirectory.java",0,0.753926701570681,3,2,5
"lucene/core/src/java/org/apache/lucene/store/CompoundFileWriter.java",0,0.926829268292683,3,2,5
"lucene/core/src/java/org/apache/lucene/store/DataInput.java",0,0.857142857142857,2,3,5
"lucene/core/src/java/org/apache/lucene/store/DataOutput.java",0,0.457912457912458,2,3,5
"lucene/core/src/java/org/apache/lucene/store/Directory.java",0,0.4,3,4,7
"lucene/core/src/java/org/apache/lucene/store/FSDirectory.java",0,0.628252788104089,9,4,13
"lucene/core/src/java/org/apache/lucene/store/FSLockFactory.java",0,0.962264150943396,2,1,3
"lucene/core/src/java/org/apache/lucene/store/FileSwitchDirectory.java",0,0.694444444444444,1,4,5
"lucene/core/src/java/org/apache/lucene/store/FlushInfo.java",0,0.974025974025974,2,1,3
"lucene/core/src/java/org/apache/lucene/store/IOContext.java",0,0.993055555555556,1,1,2
"lucene/core/src/java/org/apache/lucene/store/IndexInput.java",0,0.36046511627907,3,4,7
"lucene/core/src/java/org/apache/lucene/store/IndexOutput.java",0,0.629032258064516,2,4,6
"lucene/core/src/java/org/apache/lucene/store/InputStreamDataInput.java",0,0.96551724137931,2,1,3
"lucene/core/src/java/org/apache/lucene/store/Lock.java",0,0.993006993006993,1,1,2
"lucene/core/src/java/org/apache/lucene/store/LockFactory.java",0,0.986486486486487,1,1,2
"lucene/core/src/java/org/apache/lucene/store/LockObtainFailedException.java",0,0.939393939393939,2,1,3
"lucene/core/src/java/org/apache/lucene/store/LockReleaseFailedException.java",0,0.935483870967742,2,1,3
"lucene/core/src/java/org/apache/lucene/store/LockStressTest.java",0,0.990909090909091,1,1,2
"lucene/core/src/java/org/apache/lucene/store/LockVerifyServer.java",0,0.989583333333333,1,1,2
"lucene/core/src/java/org/apache/lucene/store/MMapDirectory.java",0,0.525531914893617,3,5,8
"lucene/core/src/java/org/apache/lucene/store/MergeInfo.java",0,0.898876404494382,1,2,3
"lucene/core/src/java/org/apache/lucene/store/NIOFSDirectory.java",0,0.582089552238806,2,4,6
"lucene/core/src/java/org/apache/lucene/store/NRTCachingDirectory.java",0,0.862295081967213,1,3,4
"lucene/core/src/java/org/apache/lucene/store/NativeFSLockFactory.java",0,0.583081570996979,4,3,7
"lucene/core/src/java/org/apache/lucene/store/NoLockFactory.java",0,0.842857142857143,2,2,4
"lucene/core/src/java/org/apache/lucene/store/NoSuchDirectoryException.java",0,0.967741935483871,1,1,2
"lucene/core/src/java/org/apache/lucene/store/OutputStreamDataOutput.java",0,0.956521739130435,2,1,3
"lucene/core/src/java/org/apache/lucene/store/RAMDirectory.java",0,0.299019607843137,5,6,11
"lucene/core/src/java/org/apache/lucene/store/RAMFile.java",0,0.35,4,4,8
"lucene/core/src/java/org/apache/lucene/store/RAMInputStream.java",0,0.753521126760563,3,2,5
"lucene/core/src/java/org/apache/lucene/store/RAMOutputStream.java",0,0.348039215686274,4,4,8
"lucene/core/src/java/org/apache/lucene/store/RateLimiter.java",0,0.817204301075269,2,2,4
"lucene/core/src/java/org/apache/lucene/store/SimpleFSDirectory.java",0,0.703703703703704,4,3,7
"lucene/core/src/java/org/apache/lucene/store/SimpleFSLockFactory.java",0,0.561643835616438,4,3,7
"lucene/core/src/java/org/apache/lucene/store/SingleInstanceLockFactory.java",0,0.802197802197802,1,3,4
"lucene/core/src/java/org/apache/lucene/store/TrackingDirectoryWrapper.java",0,0.992063492063492,1,1,2
"lucene/core/src/java/org/apache/lucene/store/VerifyingLockFactory.java",0,0.992,1,1,2
"lucene/core/src/java/org/apache/lucene/util/ArrayUtil.java",0,0.510800508259212,3,3,6
"lucene/core/src/java/org/apache/lucene/util/Attribute.java",0,0.958333333333333,1,1,2
"lucene/core/src/java/org/apache/lucene/util/AttributeImpl.java",0,0.488888888888889,3,2,5
"lucene/core/src/java/org/apache/lucene/util/AttributeReflector.java",0,0.970588235294118,1,1,2
"lucene/core/src/java/org/apache/lucene/util/AttributeSource.java",0,0.506,5,2,7
"lucene/core/src/java/org/apache/lucene/util/BitUtil.java",0,0.945172824791418,5,1,6
"lucene/core/src/java/org/apache/lucene/util/Bits.java",0,0.470588235294118,1,4,5
"lucene/core/src/java/org/apache/lucene/util/ByteBlockPool.java",0,0.48036253776435,1,3,4
"lucene/core/src/java/org/apache/lucene/util/BytesRef.java",0,0.585294117647059,3,3,6
"lucene/core/src/java/org/apache/lucene/util/BytesRefHash.java",0,0.879032258064516,4,2,6
"lucene/core/src/java/org/apache/lucene/util/BytesRefIterator.java",0,0.885245901639344,1,2,3
"lucene/core/src/java/org/apache/lucene/util/CharsRef.java",0,0.576923076923077,2,2,4
"lucene/core/src/java/org/apache/lucene/util/CloseableThreadLocal.java",0,0.902097902097902,2,2,4
"lucene/core/src/java/org/apache/lucene/util/CollectionUtil.java",0,0.982558139534884,2,1,3
"lucene/core/src/java/org/apache/lucene/util/CommandLineUtil.java",0,0.991071428571429,1,1,2
"lucene/core/src/java/org/apache/lucene/util/Constants.java",0,0.428571428571429,6,3,9
"lucene/core/src/java/org/apache/lucene/util/Counter.java",0,0.989247311827957,1,1,2
"lucene/core/src/java/org/apache/lucene/util/DocIdBitSet.java",0,0.98989898989899,1,1,2
"lucene/core/src/java/org/apache/lucene/util/DoubleBarrelLRUCache.java",0,0.950819672131147,4,1,5
"lucene/core/src/java/org/apache/lucene/util/FieldCacheSanityChecker.java",0,0.648148148148148,2,2,4
"lucene/core/src/java/org/apache/lucene/util/FixedBitSet.java",0,0.763593380614657,2,2,4
"lucene/core/src/java/org/apache/lucene/util/IOUtils.java",0,0.334328358208955,2,4,6
"lucene/core/src/java/org/apache/lucene/util/IndexableBinaryStringTools.java",0,0.609958506224066,2,2,4
"lucene/core/src/java/org/apache/lucene/util/InfoStream.java",0,0.564102564102564,1,3,4
"lucene/core/src/java/org/apache/lucene/util/IntsRef.java",0,0.479041916167665,1,3,4
"lucene/core/src/java/org/apache/lucene/util/MapOfSets.java",0,0.841463414634146,1,2,3
"lucene/core/src/java/org/apache/lucene/util/MathUtil.java",0,0.822222222222222,1,2,3
"lucene/core/src/java/org/apache/lucene/util/MutableBits.java",0,0.96,1,1,2
"lucene/core/src/java/org/apache/lucene/util/NamedSPILoader.java",0,0.991596638655462,1,1,2
"lucene/core/src/java/org/apache/lucene/util/NamedThreadFactory.java",0,0.985074626865672,1,1,2
"lucene/core/src/java/org/apache/lucene/util/NumericUtils.java",0,0.954648526077097,4,1,5
"lucene/core/src/java/org/apache/lucene/util/OpenBitSet.java",0,0.824561403508772,5,3,8
"lucene/core/src/java/org/apache/lucene/util/OpenBitSetDISI.java",0,0.961538461538462,2,1,3
"lucene/core/src/java/org/apache/lucene/util/OpenBitSetIterator.java",0,0.72020725388601,2,2,4
"lucene/core/src/java/org/apache/lucene/util/PagedBytes.java",0,0.686486486486486,4,3,7
"lucene/core/src/java/org/apache/lucene/util/PrintStreamInfoStream.java",0,0.492537313432836,2,2,4
"lucene/core/src/java/org/apache/lucene/util/PriorityQueue.java",0,0.347169811320755,9,3,12
"lucene/core/src/java/org/apache/lucene/util/RamUsageEstimator.java",0,0.909310761789601,1,2,3
"lucene/core/src/java/org/apache/lucene/util/RecyclingByteBlockAllocator.java",0,0.929936305732484,2,2,4
"lucene/core/src/java/org/apache/lucene/util/RollingCharBuffer.java",0,0.9,1,2,3
"lucene/core/src/java/org/apache/lucene/util/ScorerDocQueue.java",0,0.949771689497717,3,1,4
"lucene/core/src/java/org/apache/lucene/util/SentinelIntSet.java",0,0.88,3,1,4
"lucene/core/src/java/org/apache/lucene/util/SetOnce.java",0,0.974025974025974,2,1,3
"lucene/core/src/java/org/apache/lucene/util/SmallFloat.java",0,0.959677419354839,2,1,3
"lucene/core/src/java/org/apache/lucene/util/SortedVIntList.java",0,0.81057268722467,2,2,4
"lucene/core/src/java/org/apache/lucene/util/SorterTemplate.java",0,0.995283018867924,1,1,2
"lucene/core/src/java/org/apache/lucene/util/StringHelper.java",0,0.39041095890411,3,5,8
"lucene/core/src/java/org/apache/lucene/util/ThreadInterruptedException.java",0,0.966666666666667,1,1,2
"lucene/core/src/java/org/apache/lucene/util/ToStringUtils.java",0,0.695652173913043,1,2,3
"lucene/core/src/java/org/apache/lucene/util/UnicodeUtil.java",0,0.798045602605863,3,3,6
"lucene/core/src/java/org/apache/lucene/util/Version.java",0,0.512396694214876,1,5,6
"lucene/core/src/java/org/apache/lucene/util/VirtualMethod.java",0,0.979865771812081,2,1,3
"lucene/core/src/java/org/apache/lucene/util/WeakIdentityMap.java",0,0.995098039215686,1,1,2
"lucene/core/src/java/org/apache/lucene/util/automaton/Automaton.java",0,0.76159793814433,1,2,3
"lucene/core/src/java/org/apache/lucene/util/automaton/AutomatonProvider.java",0,1,0,1,1
"lucene/core/src/java/org/apache/lucene/util/automaton/BasicAutomata.java",0,0.962809917355372,1,1,2
"lucene/core/src/java/org/apache/lucene/util/automaton/BasicOperations.java",0,0.640845070422535,1,2,3
"lucene/core/src/java/org/apache/lucene/util/automaton/ByteRunAutomaton.java",0,0.782608695652174,1,2,3
"lucene/core/src/java/org/apache/lucene/util/automaton/CharacterRunAutomaton.java",0,0.925925925925926,1,2,3
"lucene/core/src/java/org/apache/lucene/util/automaton/CompiledAutomaton.java",0,0.870689655172414,1,2,3
"lucene/core/src/java/org/apache/lucene/util/automaton/Lev1ParametricDescription.java",0,0.94017094017094,1,2,3
"lucene/core/src/java/org/apache/lucene/util/automaton/Lev1TParametricDescription.java",0,0.991596638655462,1,1,2
"lucene/core/src/java/org/apache/lucene/util/automaton/Lev2ParametricDescription.java",0,0.686635944700461,1,2,3
"lucene/core/src/java/org/apache/lucene/util/automaton/Lev2TParametricDescription.java",0,0.996212121212121,1,1,2
"lucene/core/src/java/org/apache/lucene/util/automaton/LevenshteinAutomata.java",0,0.863636363636364,2,2,4
"lucene/core/src/java/org/apache/lucene/util/automaton/MinimizationOperations.java",0,0.953846153846154,1,1,2
"lucene/core/src/java/org/apache/lucene/util/automaton/RegExp.java",0,0.9800796812749,2,1,3
"lucene/core/src/java/org/apache/lucene/util/automaton/RunAutomaton.java",0,0.791666666666667,1,2,3
"lucene/core/src/java/org/apache/lucene/util/automaton/SortedIntSet.java",0,0.974820143884892,2,1,3
"lucene/core/src/java/org/apache/lucene/util/automaton/SpecialOperations.java",0,0.641509433962264,1,2,3
"lucene/core/src/java/org/apache/lucene/util/automaton/State.java",0,0.58695652173913,1,2,3
"lucene/core/src/java/org/apache/lucene/util/automaton/StatePair.java",0,1,0,1,1
"lucene/core/src/java/org/apache/lucene/util/automaton/Transition.java",0,0.731132075471698,1,2,3
"lucene/core/src/java/org/apache/lucene/util/automaton/UTF32ToUTF8.java",0,0.965189873417722,2,1,3
"lucene/core/src/java/org/apache/lucene/util/fst/Builder.java",0,0.874003189792663,4,2,6
"lucene/core/src/java/org/apache/lucene/util/fst/ByteSequenceOutputs.java",0,0.992857142857143,1,1,2
"lucene/core/src/java/org/apache/lucene/util/fst/BytesRefFSTEnum.java",0,0.976190476190476,2,1,3
"lucene/core/src/java/org/apache/lucene/util/fst/CharSequenceOutputs.java",0,0.993103448275862,1,1,2
"lucene/core/src/java/org/apache/lucene/util/fst/FST.java",0,0.861936193619362,5,2,7
"lucene/core/src/java/org/apache/lucene/util/fst/FSTEnum.java",0,0.98109640831758,3,1,4
"lucene/core/src/java/org/apache/lucene/util/fst/IntSequenceOutputs.java",0,0.993055555555556,1,1,2
"lucene/core/src/java/org/apache/lucene/util/fst/IntsRefFSTEnum.java",0,0.976190476190476,2,1,3
"lucene/core/src/java/org/apache/lucene/util/fst/NoOutputs.java",0,0.979381443298969,2,1,3
"lucene/core/src/java/org/apache/lucene/util/fst/NodeHash.java",0,0.976608187134503,3,1,4
"lucene/core/src/java/org/apache/lucene/util/fst/Outputs.java",0,0.985294117647059,1,1,2
"lucene/core/src/java/org/apache/lucene/util/fst/PairOutputs.java",0,0.982035928143713,3,1,4
"lucene/core/src/java/org/apache/lucene/util/fst/PositiveIntOutputs.java",0,0.992307692307692,1,1,2
"lucene/core/src/java/org/apache/lucene/util/fst/UpToTwoPositiveIntOutputs.java",0,0.991150442477876,2,1,3
"lucene/core/src/java/org/apache/lucene/util/fst/Util.java",0,0.480048367593712,3,3,6
"lucene/core/src/java/org/apache/lucene/util/mutable/MutableValue.java",0,0.796875,2,2,4
"lucene/core/src/java/org/apache/lucene/util/mutable/MutableValueBool.java",0,0.90625,2,2,4
"lucene/core/src/java/org/apache/lucene/util/mutable/MutableValueDate.java",0,0.842105263157895,2,2,4
"lucene/core/src/java/org/apache/lucene/util/mutable/MutableValueDouble.java",0,0.91044776119403,2,2,4
"lucene/core/src/java/org/apache/lucene/util/mutable/MutableValueFloat.java",0,0.907692307692308,2,2,4
"lucene/core/src/java/org/apache/lucene/util/mutable/MutableValueInt.java",0,0.914285714285714,2,2,4
"lucene/core/src/java/org/apache/lucene/util/mutable/MutableValueLong.java",0,0.761194029850746,2,2,4
"lucene/core/src/java/org/apache/lucene/util/mutable/MutableValueStr.java",0,0.867647058823529,3,2,5
"lucene/core/src/java/org/apache/lucene/util/packed/Direct16.java",0,0.647058823529412,2,2,4
"lucene/core/src/java/org/apache/lucene/util/packed/Direct32.java",0,0.63265306122449,2,2,4
"lucene/core/src/java/org/apache/lucene/util/packed/Direct64.java",0,0.504504504504504,2,3,5
"lucene/core/src/java/org/apache/lucene/util/packed/Direct8.java",0,0.650485436893204,2,2,4
"lucene/core/src/java/org/apache/lucene/util/packed/DirectPacked64SingleBlockReader.java",0,0.898305084745763,1,2,3
"lucene/core/src/java/org/apache/lucene/util/packed/DirectPackedReader.java",0,0.925925925925926,1,2,3
"lucene/core/src/java/org/apache/lucene/util/packed/GrowableWriter.java",0,0.8828125,1,2,3
"lucene/core/src/java/org/apache/lucene/util/packed/Packed16ThreeBlocks.java",0,0.989583333333333,1,1,2
"lucene/core/src/java/org/apache/lucene/util/packed/Packed64.java",0,0.695652173913043,3,2,5
"lucene/core/src/java/org/apache/lucene/util/packed/Packed64SingleBlock.java",0,0.909747292418773,1,2,3
"lucene/core/src/java/org/apache/lucene/util/packed/Packed64SingleBlockReaderIterator.java",0,0.988636363636364,1,1,2
"lucene/core/src/java/org/apache/lucene/util/packed/Packed64SingleBlockWriter.java",0,0.987654320987654,1,1,2
"lucene/core/src/java/org/apache/lucene/util/packed/Packed8ThreeBlocks.java",0,0.989690721649485,1,1,2
"lucene/core/src/java/org/apache/lucene/util/packed/PackedInts.java",0,0.531666666666667,3,3,6
"lucene/core/src/java/org/apache/lucene/util/packed/PackedReaderIterator.java",0,0.580645161290323,1,3,4
"lucene/core/src/java/org/apache/lucene/util/packed/PackedWriter.java",0,0.92436974789916,2,2,4
"lucene/core/src/test/org/apache/lucene/TestAssertions.java",0,0.8,1,3,4
"lucene/core/src/test/org/apache/lucene/TestDemo.java",0,0.4375,4,6,10
"lucene/core/src/test/org/apache/lucene/TestExternalCodecs.java",0,0.541984732824427,3,3,6
"lucene/core/src/test/org/apache/lucene/TestMergeSchedulerExternal.java",0,0.624161073825503,3,3,6
"lucene/core/src/test/org/apache/lucene/TestSearch.java",0,0.373417721518987,6,5,11
"lucene/core/src/test/org/apache/lucene/TestSearchForDuplicates.java",0,0.486301369863014,6,5,11
"lucene/core/src/test/org/apache/lucene/analysis/TestCachingTokenFilter.java",0,0.663934426229508,3,3,6
"lucene/core/src/test/org/apache/lucene/analysis/TestGraphTokenizers.java",0,0.946015424164524,1,2,3
"lucene/core/src/test/org/apache/lucene/analysis/TestLookaheadTokenFilter.java",0,0.911764705882353,1,2,3
"lucene/core/src/test/org/apache/lucene/analysis/TestMockAnalyzer.java",0,0.802919708029197,2,3,5
"lucene/core/src/test/org/apache/lucene/analysis/TestMockCharFilter.java",0,0.982758620689655,1,1,2
"lucene/core/src/test/org/apache/lucene/analysis/TestNumericTokenStream.java",0,0.956521739130435,2,1,3
"lucene/core/src/test/org/apache/lucene/analysis/TestToken.java",0,0.561151079136691,2,3,5
"lucene/core/src/test/org/apache/lucene/analysis/tokenattributes/TestCharTermAttributeImpl.java",0,0.981308411214953,2,1,3
"lucene/core/src/test/org/apache/lucene/analysis/tokenattributes/TestSimpleAttributeImpl.java",0,0.9375,2,1,3
"lucene/core/src/test/org/apache/lucene/codecs/appending/TestAppendingCodec.java",0,0.619047619047619,3,3,6
"lucene/core/src/test/org/apache/lucene/codecs/intblock/TestIntBlockCodec.java",0,0.515625,1,4,5
"lucene/core/src/test/org/apache/lucene/codecs/lucene3x/TestImpersonation.java",0,0.970588235294118,1,1,2
"lucene/core/src/test/org/apache/lucene/codecs/lucene3x/TestSurrogates.java",0,0.660112359550562,4,2,6
"lucene/core/src/test/org/apache/lucene/codecs/lucene3x/TestTermInfosReaderIndex.java",0,0.684210526315789,3,2,5
"lucene/core/src/test/org/apache/lucene/codecs/lucene40/TestAllFilesHaveCodecHeader.java",0,0.989130434782609,1,1,2
"lucene/core/src/test/org/apache/lucene/codecs/lucene40/TestBitVector.java",0,0.519163763066202,3,4,7
"lucene/core/src/test/org/apache/lucene/codecs/lucene40/TestLucene40PostingsReader.java",0,1,0,1,1
"lucene/core/src/test/org/apache/lucene/codecs/lucene40/TestReuseDocsEnum.java",0,0.721590909090909,3,3,6
"lucene/core/src/test/org/apache/lucene/codecs/lucene40/values/TestDocValues.java",0,0.771604938271605,2,4,6
"lucene/core/src/test/org/apache/lucene/codecs/perfield/TestPerFieldPostingsFormat.java",0,0.466257668711656,2,3,5
"lucene/core/src/test/org/apache/lucene/codecs/pulsing/Test10KPulsings.java",0,0.847133757961783,1,3,4
"lucene/core/src/test/org/apache/lucene/codecs/pulsing/TestPulsingReuse.java",0,0.888888888888889,4,1,5
"lucene/core/src/test/org/apache/lucene/document/TestBinaryDocument.java",0,0.457142857142857,3,4,7
"lucene/core/src/test/org/apache/lucene/document/TestDateTools.java",0,0.921182266009852,4,1,5
"lucene/core/src/test/org/apache/lucene/document/TestDocument.java",0,0.415816326530612,7,3,10
"lucene/core/src/test/org/apache/lucene/index/BinaryTokenStream.java",0,0.987341772151899,1,1,2
"lucene/core/src/test/org/apache/lucene/index/Test2BDocs.java",0,1,0,1,1
"lucene/core/src/test/org/apache/lucene/index/Test2BPostings.java",0,0.909090909090909,3,2,5
"lucene/core/src/test/org/apache/lucene/index/Test2BTerms.java",0,0.882352941176471,6,2,8
"lucene/core/src/test/org/apache/lucene/index/TestAddIndexes.java",0,0.433227344992051,6,4,10
"lucene/core/src/test/org/apache/lucene/index/TestAtomicUpdate.java",0,0.892857142857143,4,1,5
"lucene/core/src/test/org/apache/lucene/index/TestBackwardsCompatibility.java",0,0.50967007963595,6,3,9
"lucene/core/src/test/org/apache/lucene/index/TestBinaryTerms.java",0,0.891891891891892,3,2,5
"lucene/core/src/test/org/apache/lucene/index/TestByteSlices.java",0,0.839080459770115,4,2,6
"lucene/core/src/test/org/apache/lucene/index/TestCheckIndex.java",0,0.785046728971963,5,2,7
"lucene/core/src/test/org/apache/lucene/index/TestCodecs.java",0,0.682965299684543,3,3,6
"lucene/core/src/test/org/apache/lucene/index/TestCompoundFile.java",0,0.406542056074766,9,5,14
"lucene/core/src/test/org/apache/lucene/index/TestConcurrentMergeScheduler.java",0,0.842105263157895,4,2,6
"lucene/core/src/test/org/apache/lucene/index/TestConsistentFieldNumbers.java",0,0.593175853018373,4,2,6
"lucene/core/src/test/org/apache/lucene/index/TestCrash.java",0,0.69620253164557,3,3,6
"lucene/core/src/test/org/apache/lucene/index/TestCrashCausesCorruptIndex.java",0,0.983739837398374,3,1,4
"lucene/core/src/test/org/apache/lucene/index/TestCustomNorms.java",0,0.623134328358209,3,3,6
"lucene/core/src/test/org/apache/lucene/index/TestDeletionPolicy.java",0,0.858310626702997,5,2,7
"lucene/core/src/test/org/apache/lucene/index/TestDirectoryReader.java",0,0.808900523560209,5,2,7
"lucene/core/src/test/org/apache/lucene/index/TestDirectoryReaderReopen.java",0,0.606299212598425,5,4,9
"lucene/core/src/test/org/apache/lucene/index/TestDoc.java",0,0.35632183908046,9,4,13
"lucene/core/src/test/org/apache/lucene/index/TestDocCount.java",0,0.870588235294118,2,2,4
"lucene/core/src/test/org/apache/lucene/index/TestDocTermOrds.java",0,0.879895561357702,5,1,6
"lucene/core/src/test/org/apache/lucene/index/TestDocValuesIndexing.java",0,0.608652900688299,4,3,7
"lucene/core/src/test/org/apache/lucene/index/TestDocValuesTypeCompatibility.java",0,0.993730407523511,1,1,2
"lucene/core/src/test/org/apache/lucene/index/TestDocsAndPositions.java",0,0.605405405405405,1,5,6
"lucene/core/src/test/org/apache/lucene/index/TestDocumentWriter.java",0,0.24188790560472,4,9,13
"lucene/core/src/test/org/apache/lucene/index/TestDocumentsWriterDeleteQueue.java",0,0.869047619047619,3,2,5
"lucene/core/src/test/org/apache/lucene/index/TestDocumentsWriterStallControl.java",0,1,0,1,1
"lucene/core/src/test/org/apache/lucene/index/TestDuelingCodecs.java",0,0.835579514824798,3,2,5
"lucene/core/src/test/org/apache/lucene/index/TestFieldInfos.java",0,0.389830508474576,2,3,5
"lucene/core/src/test/org/apache/lucene/index/TestFieldsReader.java",0,0.523364485981308,9,4,13
"lucene/core/src/test/org/apache/lucene/index/TestFilterAtomicReader.java",0,0.406862745098039,3,4,7
"lucene/core/src/test/org/apache/lucene/index/TestFlex.java",0,0.720930232558139,2,3,5
"lucene/core/src/test/org/apache/lucene/index/TestFlushByRamOrCountsPolicy.java",0,0.92271662763466,5,1,6
"lucene/core/src/test/org/apache/lucene/index/TestForTooMuchCloning.java",0,0.9125,3,1,4
"lucene/core/src/test/org/apache/lucene/index/TestForceMergeForever.java",0,0.942857142857143,3,1,4
"lucene/core/src/test/org/apache/lucene/index/TestIndexCommit.java",0,0.885245901639344,2,2,4
"lucene/core/src/test/org/apache/lucene/index/TestIndexFileDeleter.java",0,0.722222222222222,4,3,7
"lucene/core/src/test/org/apache/lucene/index/TestIndexInput.java",0,0.966346153846154,3,1,4
"lucene/core/src/test/org/apache/lucene/index/TestIndexWriter.java",0,0.658157602663707,12,2,14
"lucene/core/src/test/org/apache/lucene/index/TestIndexWriterCommit.java",0,0.908527131782946,5,1,6
"lucene/core/src/test/org/apache/lucene/index/TestIndexWriterConfig.java",0,0.605042016806723,4,4,8
"lucene/core/src/test/org/apache/lucene/index/TestIndexWriterDelete.java",0,0.76937441643324,7,2,9
"lucene/core/src/test/org/apache/lucene/index/TestIndexWriterExceptions.java",0,0.503891050583658,7,3,10
"lucene/core/src/test/org/apache/lucene/index/TestIndexWriterForceMerge.java",0,0.872037914691943,3,2,5
"lucene/core/src/test/org/apache/lucene/index/TestIndexWriterLockRelease.java",0,0.606741573033708,3,4,7
"lucene/core/src/test/org/apache/lucene/index/TestIndexWriterMergePolicy.java",0,0.590225563909774,3,4,7
"lucene/core/src/test/org/apache/lucene/index/TestIndexWriterMerging.java",0,0.634146341463415,3,3,6
"lucene/core/src/test/org/apache/lucene/index/TestIndexWriterNRTIsCurrent.java",0,0.94,4,1,5
"lucene/core/src/test/org/apache/lucene/index/TestIndexWriterOnDiskFull.java",0,0.867132867132867,3,2,5
"lucene/core/src/test/org/apache/lucene/index/TestIndexWriterOnJRECrash.java",0,0.982035928143713,2,1,3
"lucene/core/src/test/org/apache/lucene/index/TestIndexWriterReader.java",0,0.702312138728324,3,3,6
"lucene/core/src/test/org/apache/lucene/index/TestIndexWriterUnicode.java",0,0.952380952380952,4,1,5
"lucene/core/src/test/org/apache/lucene/index/TestIndexWriterWithThreads.java",0,0.614478114478115,5,3,8
"lucene/core/src/test/org/apache/lucene/index/TestIndexableField.java",0,0.774193548387097,4,2,6
"lucene/core/src/test/org/apache/lucene/index/TestIsCurrent.java",0,0.944954128440367,3,1,4
"lucene/core/src/test/org/apache/lucene/index/TestLazyProxSkipping.java",0,0.497854077253219,6,4,10
"lucene/core/src/test/org/apache/lucene/index/TestLongPostings.java",0,0.485651214128035,3,3,6
"lucene/core/src/test/org/apache/lucene/index/TestMaxTermFrequency.java",0,0.913793103448276,4,1,5
"lucene/core/src/test/org/apache/lucene/index/TestMixedCodecs.java",0,0.902173913043478,2,2,4
"lucene/core/src/test/org/apache/lucene/index/TestMultiFields.java",0,0.825581395348837,3,3,6
"lucene/core/src/test/org/apache/lucene/index/TestMultiLevelSkipList.java",0,0.636363636363636,5,5,10
"lucene/core/src/test/org/apache/lucene/index/TestNRTReaderWithThreads.java",0,0.808695652173913,2,3,5
"lucene/core/src/test/org/apache/lucene/index/TestNRTThreads.java",0,0.930232558139535,4,1,5
"lucene/core/src/test/org/apache/lucene/index/TestNeverDelete.java",0,0.936363636363636,3,1,4
"lucene/core/src/test/org/apache/lucene/index/TestNewestSegment.java",0,0.78125,2,2,4
"lucene/core/src/test/org/apache/lucene/index/TestNoDeletionPolicy.java",0,0.870588235294118,4,2,6
"lucene/core/src/test/org/apache/lucene/index/TestNoMergePolicy.java",0,0.959459459459459,2,1,3
"lucene/core/src/test/org/apache/lucene/index/TestNoMergeScheduler.java",0,0.903225806451613,3,1,4
"lucene/core/src/test/org/apache/lucene/index/TestNorms.java",0,0.516,6,3,9
"lucene/core/src/test/org/apache/lucene/index/TestOmitNorms.java",0,0.812297734627832,3,2,5
"lucene/core/src/test/org/apache/lucene/index/TestOmitPositions.java",0,0.789473684210526,2,2,4
"lucene/core/src/test/org/apache/lucene/index/TestOmitTf.java",0,0.733183856502242,3,3,6
"lucene/core/src/test/org/apache/lucene/index/TestParallelAtomicReader.java",0,0.432885906040268,5,5,10
"lucene/core/src/test/org/apache/lucene/index/TestParallelCompositeReader.java",0,0.857471264367816,2,2,4
"lucene/core/src/test/org/apache/lucene/index/TestParallelReaderEmptyIndex.java",0,0.633540372670807,2,3,5
"lucene/core/src/test/org/apache/lucene/index/TestParallelTermEnum.java",0,0.610619469026549,3,4,7
"lucene/core/src/test/org/apache/lucene/index/TestPayloadProcessorProvider.java",0,0.781609195402299,5,2,7
"lucene/core/src/test/org/apache/lucene/index/TestPayloads.java",0,0.574290484140234,5,4,9
"lucene/core/src/test/org/apache/lucene/index/TestPerSegmentDeletes.java",0,0.793103448275862,5,2,7
"lucene/core/src/test/org/apache/lucene/index/TestPersistentSnapshotDeletionPolicy.java",0,0.827225130890052,3,2,5
"lucene/core/src/test/org/apache/lucene/index/TestPostingsOffsets.java",0,0.536489151873767,3,2,5
"lucene/core/src/test/org/apache/lucene/index/TestPrefixCodedTerms.java",0,0.963235294117647,2,1,3
"lucene/core/src/test/org/apache/lucene/index/TestRandomStoredFields.java",0,0.970802919708029,3,1,4
"lucene/core/src/test/org/apache/lucene/index/TestReaderClosed.java",0,0.723404255319149,2,2,4
"lucene/core/src/test/org/apache/lucene/index/TestRollback.java",0,0.910714285714286,3,1,4
"lucene/core/src/test/org/apache/lucene/index/TestRollingUpdates.java",0,0.49685534591195,2,4,6
"lucene/core/src/test/org/apache/lucene/index/TestSameTokenSamePosition.java",0,0.652173913043478,2,3,5
"lucene/core/src/test/org/apache/lucene/index/TestSegmentMerger.java",0,0.38121546961326,4,5,9
"lucene/core/src/test/org/apache/lucene/index/TestSegmentReader.java",0,0.30622009569378,7,5,12
"lucene/core/src/test/org/apache/lucene/index/TestSegmentTermDocs.java",0,0.398601398601399,4,5,9
"lucene/core/src/test/org/apache/lucene/index/TestSegmentTermEnum.java",0,0.269503546099291,4,5,9
"lucene/core/src/test/org/apache/lucene/index/TestSizeBoundedForceMerge.java",0,0.900537634408602,2,2,4
"lucene/core/src/test/org/apache/lucene/index/TestSnapshotDeletionPolicy.java",0,0.554809843400447,3,3,6
"lucene/core/src/test/org/apache/lucene/index/TestStressAdvance.java",0,0.892086330935252,4,1,5
"lucene/core/src/test/org/apache/lucene/index/TestStressIndexing.java",0,0.871345029239766,3,2,5
"lucene/core/src/test/org/apache/lucene/index/TestStressIndexing2.java",0,0.619528619528619,4,3,7
"lucene/core/src/test/org/apache/lucene/index/TestStressNRT.java",0,0.904392764857881,4,1,5
"lucene/core/src/test/org/apache/lucene/index/TestSumDocFreq.java",0,0.855670103092783,1,3,4
"lucene/core/src/test/org/apache/lucene/index/TestTerm.java",0,0.972222222222222,1,1,2
"lucene/core/src/test/org/apache/lucene/index/TestTermVectorsReader.java",0,0.376770538243626,6,6,12
"lucene/core/src/test/org/apache/lucene/index/TestTermVectorsWriter.java",0,0.678756476683938,4,2,6
"lucene/core/src/test/org/apache/lucene/index/TestTermdocPerf.java",0,0.572413793103448,1,5,6
"lucene/core/src/test/org/apache/lucene/index/TestTermsEnum.java",0,0.934193548387097,4,1,5
"lucene/core/src/test/org/apache/lucene/index/TestTermsEnum2.java",0,0.885057471264368,2,2,4
"lucene/core/src/test/org/apache/lucene/index/TestThreadedForceMerge.java",0,0.825503355704698,2,3,5
"lucene/core/src/test/org/apache/lucene/index/TestTieredMergePolicy.java",0,0.942307692307692,3,1,4
"lucene/core/src/test/org/apache/lucene/index/TestTransactionRollback.java",0,0.899082568807339,3,2,5
"lucene/core/src/test/org/apache/lucene/index/TestTransactions.java",0,0.823770491803279,3,2,5
"lucene/core/src/test/org/apache/lucene/index/TestTypePromotion.java",0,0.57840616966581,2,3,5
"lucene/core/src/test/org/apache/lucene/index/TestUniqueTermCount.java",0,0.910891089108911,4,1,5
"lucene/core/src/test/org/apache/lucene/search/BaseTestRangeFilter.java",0,0.557894736842105,5,3,8
"lucene/core/src/test/org/apache/lucene/search/FieldCacheRewriteMethod.java",0,0.891891891891892,2,2,4
"lucene/core/src/test/org/apache/lucene/search/JustCompileSearch.java",0,0.741379310344828,5,3,8
"lucene/core/src/test/org/apache/lucene/search/MockFilter.java",0,0.975609756097561,1,1,2
"lucene/core/src/test/org/apache/lucene/search/MultiCollectorTest.java",0,0.936363636363636,4,1,5
"lucene/core/src/test/org/apache/lucene/search/SingleDocTestFilter.java",0,0.975,1,1,2
"lucene/core/src/test/org/apache/lucene/search/TestAutomatonQuery.java",0,0.835748792270531,3,2,5
"lucene/core/src/test/org/apache/lucene/search/TestAutomatonQueryUnicode.java",0,0.7734375,2,3,5
"lucene/core/src/test/org/apache/lucene/search/TestBoolean2.java",0,0.224431818181818,5,5,10
"lucene/core/src/test/org/apache/lucene/search/TestBooleanMinShouldMatch.java",0,0.809768637532134,6,2,8
"lucene/core/src/test/org/apache/lucene/search/TestBooleanOr.java",0,0.648484848484848,5,3,8
"lucene/core/src/test/org/apache/lucene/search/TestBooleanQuery.java",0,0.384615384615385,6,4,10
"lucene/core/src/test/org/apache/lucene/search/TestBooleanScorer.java",0,0.561111111111111,4,3,7
"lucene/core/src/test/org/apache/lucene/search/TestCachingCollector.java",0,0.967391304347826,4,1,5
"lucene/core/src/test/org/apache/lucene/search/TestCachingWrapperFilter.java",0,0.44408945686901,6,4,10
"lucene/core/src/test/org/apache/lucene/search/TestComplexExplanations.java",0,0.64,4,2,6
"lucene/core/src/test/org/apache/lucene/search/TestComplexExplanationsOfNonMatches.java",0,0.815789473684211,1,2,3
"lucene/core/src/test/org/apache/lucene/search/TestConstantScoreQuery.java",0,0.9125,6,1,7
"lucene/core/src/test/org/apache/lucene/search/TestCustomSearcherSort.java",0,0.668032786885246,4,3,7
"lucene/core/src/test/org/apache/lucene/search/TestDateFilter.java",0,0.76219512195122,3,4,7
"lucene/core/src/test/org/apache/lucene/search/TestDateSort.java",0,0.741379310344828,6,2,8
"lucene/core/src/test/org/apache/lucene/search/TestDisjunctionMaxQuery.java",0,0.768611670020121,5,3,8
"lucene/core/src/test/org/apache/lucene/search/TestDocBoost.java",0,0.354166666666667,4,6,10
"lucene/core/src/test/org/apache/lucene/search/TestDocIdSet.java",0,0.654545454545455,3,2,5
"lucene/core/src/test/org/apache/lucene/search/TestDocValuesScoring.java",0,0.880733944954128,4,2,6
"lucene/core/src/test/org/apache/lucene/search/TestElevationComparator.java",0,0.845771144278607,3,3,6
"lucene/core/src/test/org/apache/lucene/search/TestExplanations.java",0,0.810810810810811,5,2,7
"lucene/core/src/test/org/apache/lucene/search/TestFieldCache.java",0,0.481308411214953,1,5,6
"lucene/core/src/test/org/apache/lucene/search/TestFieldCacheRangeFilter.java",0,0.671378091872792,2,3,5
"lucene/core/src/test/org/apache/lucene/search/TestFieldCacheRewriteMethod.java",0,0.977272727272727,1,1,2
"lucene/core/src/test/org/apache/lucene/search/TestFieldCacheTermsFilter.java",0,0.864864864864865,1,3,4
"lucene/core/src/test/org/apache/lucene/search/TestFieldValueFilter.java",0,0.870689655172414,3,2,5
"lucene/core/src/test/org/apache/lucene/search/TestFilteredQuery.java",0,0.458333333333333,9,4,13
"lucene/core/src/test/org/apache/lucene/search/TestFilteredSearch.java",0,0.467741935483871,3,4,7
"lucene/core/src/test/org/apache/lucene/search/TestFuzzyQuery.java",0,0.418181818181818,6,4,10
"lucene/core/src/test/org/apache/lucene/search/TestMatchAllDocsQuery.java",0,0.439252336448598,4,6,10
"lucene/core/src/test/org/apache/lucene/search/TestMultiPhraseQuery.java",0,0.343257443082312,6,4,10
"lucene/core/src/test/org/apache/lucene/search/TestMultiTermConstantScore.java",0,0.863636363636364,5,2,7
"lucene/core/src/test/org/apache/lucene/search/TestMultiTermQueryRewrites.java",0,0.876543209876543,4,2,6
"lucene/core/src/test/org/apache/lucene/search/TestMultiThreadTermVectors.java",0,0.606060606060606,5,4,9
"lucene/core/src/test/org/apache/lucene/search/TestMultiValuedNumericRangeQuery.java",0,0.6625,2,4,6
"lucene/core/src/test/org/apache/lucene/search/TestNGramPhraseQuery.java",0,0.956989247311828,3,1,4
"lucene/core/src/test/org/apache/lucene/search/TestNRTManager.java",0,0.734939759036145,3,2,5
"lucene/core/src/test/org/apache/lucene/search/TestNot.java",0,0.43859649122807,5,5,10
"lucene/core/src/test/org/apache/lucene/search/TestNumericRangeQuery32.java",0,0.815384615384615,5,2,7
"lucene/core/src/test/org/apache/lucene/search/TestNumericRangeQuery64.java",0,0.81304347826087,6,2,8
"lucene/core/src/test/org/apache/lucene/search/TestPhrasePrefixQuery.java",0,0.545454545454545,2,5,7
"lucene/core/src/test/org/apache/lucene/search/TestPhraseQuery.java",0,0.199140401146132,9,7,16
"lucene/core/src/test/org/apache/lucene/search/TestPositionIncrement.java",0,0.268707482993197,8,6,14
"lucene/core/src/test/org/apache/lucene/search/TestPositiveScoresOnlyCollector.java",0,0.78125,3,2,5
"lucene/core/src/test/org/apache/lucene/search/TestPrefixFilter.java",0,0.682242990654206,3,3,6
"lucene/core/src/test/org/apache/lucene/search/TestPrefixInBooleanQuery.java",0,0.675438596491228,2,2,4
"lucene/core/src/test/org/apache/lucene/search/TestPrefixQuery.java",0,0.402985074626866,2,7,9
"lucene/core/src/test/org/apache/lucene/search/TestPrefixRandom.java",0,0.895522388059702,6,1,7
"lucene/core/src/test/org/apache/lucene/search/TestQueryWrapperFilter.java",0,0.384105960264901,2,4,6
"lucene/core/src/test/org/apache/lucene/search/TestRegexpQuery.java",0,0.846774193548387,3,2,5
"lucene/core/src/test/org/apache/lucene/search/TestRegexpRandom.java",0,0.591549295774648,4,2,6
"lucene/core/src/test/org/apache/lucene/search/TestRegexpRandom2.java",0,0.527272727272727,4,3,7
"lucene/core/src/test/org/apache/lucene/search/TestScoreCachingWrappingScorer.java",0,0.857142857142857,3,2,5
"lucene/core/src/test/org/apache/lucene/search/TestScorerPerf.java",0,0.776978417266187,5,3,8
"lucene/core/src/test/org/apache/lucene/search/TestSearchAfter.java",0,0.524509803921569,2,2,4
"lucene/core/src/test/org/apache/lucene/search/TestSearchWithThreads.java",0,0.789915966386555,2,3,5
"lucene/core/src/test/org/apache/lucene/search/TestSearcherManager.java",0,0.444444444444444,2,4,6
"lucene/core/src/test/org/apache/lucene/search/TestShardSearching.java",0,0.936548223350254,4,1,5
"lucene/core/src/test/org/apache/lucene/search/TestSimilarity.java",0,0.317647058823529,8,4,12
"lucene/core/src/test/org/apache/lucene/search/TestSimilarityProvider.java",0,0.909090909090909,4,1,5
"lucene/core/src/test/org/apache/lucene/search/TestSimpleExplanations.java",0,0.630872483221476,1,2,3
"lucene/core/src/test/org/apache/lucene/search/TestSimpleExplanationsOfNonMatches.java",0,0.82051282051282,1,2,3
"lucene/core/src/test/org/apache/lucene/search/TestSimpleSearchEquivalence.java",0,0.994764397905759,1,1,2
"lucene/core/src/test/org/apache/lucene/search/TestSloppyPhraseQuery.java",0,0.773255813953488,5,2,7
"lucene/core/src/test/org/apache/lucene/search/TestSloppyPhraseQuery2.java",0,0.970443349753695,2,1,3
"lucene/core/src/test/org/apache/lucene/search/TestSort.java",0,0.652459016393443,12,2,14
"lucene/core/src/test/org/apache/lucene/search/TestSubScorerFreqs.java",0,0.809302325581395,4,2,6
"lucene/core/src/test/org/apache/lucene/search/TestTermRangeFilter.java",0,0.859154929577465,5,2,7
"lucene/core/src/test/org/apache/lucene/search/TestTermRangeQuery.java",0,0.269794721407625,5,5,10
"lucene/core/src/test/org/apache/lucene/search/TestTermScorer.java",0,0.737704918032787,5,3,8
"lucene/core/src/test/org/apache/lucene/search/TestTermVectors.java",0,0.345215759849906,8,4,12
"lucene/core/src/test/org/apache/lucene/search/TestTimeLimitingCollector.java",0,0.837465564738292,5,2,7
"lucene/core/src/test/org/apache/lucene/search/TestTopDocsCollector.java",0,0.900473933649289,5,1,6
"lucene/core/src/test/org/apache/lucene/search/TestTopDocsMerge.java",0,0.777327935222672,2,3,5
"lucene/core/src/test/org/apache/lucene/search/TestTopScoreDocCollector.java",0,0.735294117647059,2,3,5
"lucene/core/src/test/org/apache/lucene/search/TestWildcard.java",0,0.215,9,5,14
"lucene/core/src/test/org/apache/lucene/search/TestWildcardRandom.java",0,0.58273381294964,3,3,6
"lucene/core/src/test/org/apache/lucene/search/payloads/PayloadHelper.java",0,0.427586206896552,4,5,9
"lucene/core/src/test/org/apache/lucene/search/payloads/TestPayloadExplanations.java",0,0.989130434782609,1,1,2
"lucene/core/src/test/org/apache/lucene/search/payloads/TestPayloadNearQuery.java",0,0.380403458213256,7,3,10
"lucene/core/src/test/org/apache/lucene/search/payloads/TestPayloadTermQuery.java",0,0.630813953488372,7,3,10
"lucene/core/src/test/org/apache/lucene/search/similarities/TestSimilarity2.java",0,0.941908713692946,3,1,4
"lucene/core/src/test/org/apache/lucene/search/similarities/TestSimilarityBase.java",0,0.993115318416523,3,1,4
"lucene/core/src/test/org/apache/lucene/search/spans/JustCompileSearchSpans.java",0,0.754966887417219,2,3,5
"lucene/core/src/test/org/apache/lucene/search/spans/MultiSpansWrapper.java",0,0.705882352941177,1,3,4
"lucene/core/src/test/org/apache/lucene/search/spans/TestBasics.java",0,0.324281150159744,8,5,13
"lucene/core/src/test/org/apache/lucene/search/spans/TestFieldMaskingSpanQuery.java",0,0.847025495750708,5,2,7
"lucene/core/src/test/org/apache/lucene/search/spans/TestNearSpansOrdered.java",0,0.725806451612903,4,4,8
"lucene/core/src/test/org/apache/lucene/search/spans/TestPayloadSpans.java",0,0.514018691588785,7,4,11
"lucene/core/src/test/org/apache/lucene/search/spans/TestSpanExplanations.java",0,0.966101694915254,1,1,2
"lucene/core/src/test/org/apache/lucene/search/spans/TestSpanExplanationsOfNonMatches.java",0,0.975609756097561,1,1,2
"lucene/core/src/test/org/apache/lucene/search/spans/TestSpanFirstQuery.java",0,0.909090909090909,3,1,4
"lucene/core/src/test/org/apache/lucene/search/spans/TestSpanMultiTermQueryWrapper.java",0,0.826530612244898,2,3,5
"lucene/core/src/test/org/apache/lucene/search/spans/TestSpanSearchEquivalence.java",0,0.990825688073395,1,1,2
"lucene/core/src/test/org/apache/lucene/search/spans/TestSpans.java",0,0.320792079207921,5,6,11
"lucene/core/src/test/org/apache/lucene/search/spans/TestSpansAdvanced.java",0,0.761363636363636,4,2,6
"lucene/core/src/test/org/apache/lucene/search/spans/TestSpansAdvanced2.java",0,0.738461538461539,3,3,6
"lucene/core/src/test/org/apache/lucene/store/TestBufferedIndexInput.java",0,0.612903225806452,3,5,8
"lucene/core/src/test/org/apache/lucene/store/TestByteArrayDataInput.java",0,0.96969696969697,1,1,2
"lucene/core/src/test/org/apache/lucene/store/TestCopyBytes.java",0,0.433526011560694,1,4,5
"lucene/core/src/test/org/apache/lucene/store/TestDirectory.java",0,0.433862433862434,4,3,7
"lucene/core/src/test/org/apache/lucene/store/TestFileSwitchDirectory.java",0,0.518987341772152,1,3,4
"lucene/core/src/test/org/apache/lucene/store/TestHugeRamFile.java",0,0.911764705882353,2,2,4
"lucene/core/src/test/org/apache/lucene/store/TestLock.java",0,0.981818181818182,1,1,2
"lucene/core/src/test/org/apache/lucene/store/TestLockFactory.java",0,0.629976580796253,5,4,9
"lucene/core/src/test/org/apache/lucene/store/TestMultiMMap.java",0,0.491525423728814,2,3,5
"lucene/core/src/test/org/apache/lucene/store/TestNRTCachingDirectory.java",0,0.574468085106383,2,3,5
"lucene/core/src/test/org/apache/lucene/store/TestRAMDirectory.java",0,0.39572192513369,6,3,9
"lucene/core/src/test/org/apache/lucene/store/TestWindowsMMap.java",0,0.342857142857143,2,4,6
"lucene/core/src/test/org/apache/lucene/util/StressRamUsageEstimator.java",0,0.878787878787879,2,2,4
"lucene/core/src/test/org/apache/lucene/util/TestArrayUtil.java",0,0.509505703422053,4,2,6
"lucene/core/src/test/org/apache/lucene/util/TestAttributeSource.java",0,0.5,1,2,3
"lucene/core/src/test/org/apache/lucene/util/TestBitUtil.java",0,0.992481203007519,1,1,2
"lucene/core/src/test/org/apache/lucene/util/TestByteBlockPool.java",0,0.882352941176471,2,2,4
"lucene/core/src/test/org/apache/lucene/util/TestBytesRef.java",0,0.970149253731343,2,1,3
"lucene/core/src/test/org/apache/lucene/util/TestBytesRefHash.java",0,0.855907780979827,4,2,6
"lucene/core/src/test/org/apache/lucene/util/TestCharsRef.java",0,0.806451612903226,2,2,4
"lucene/core/src/test/org/apache/lucene/util/TestCloseableThreadLocal.java",0,0.96,2,1,3
"lucene/core/src/test/org/apache/lucene/util/TestCollectionUtil.java",0,0.944,4,1,5
"lucene/core/src/test/org/apache/lucene/util/TestDoubleBarrelLRUCache.java",0,0.941489361702128,4,1,5
"lucene/core/src/test/org/apache/lucene/util/TestFieldCacheSanityChecker.java",0,0.568047337278107,2,3,5
"lucene/core/src/test/org/apache/lucene/util/TestFixedBitSet.java",0,0.878787878787879,3,2,5
"lucene/core/src/test/org/apache/lucene/util/TestIOUtils.java",0,0.96969696969697,2,1,3
"lucene/core/src/test/org/apache/lucene/util/TestIdentityHashSet.java",0,0.964285714285714,2,1,3
"lucene/core/src/test/org/apache/lucene/util/TestIndexableBinaryStringTools.java",0,0.747826086956522,3,2,5
"lucene/core/src/test/org/apache/lucene/util/TestIntsRef.java",0,0.975,1,1,2
"lucene/core/src/test/org/apache/lucene/util/TestNamedSPILoader.java",0,0.977272727272727,1,1,2
"lucene/core/src/test/org/apache/lucene/util/TestNumericUtils.java",0,0.97887323943662,4,1,5
"lucene/core/src/test/org/apache/lucene/util/TestOpenBitSet.java",0,0.53680981595092,3,4,7
"lucene/core/src/test/org/apache/lucene/util/TestPagedBytes.java",0,0.917910447761194,1,2,3
"lucene/core/src/test/org/apache/lucene/util/TestPriorityQueue.java",0,0.982608695652174,2,1,3
"lucene/core/src/test/org/apache/lucene/util/TestRamUsageEstimator.java",0,0.725925925925926,2,2,4
"lucene/core/src/test/org/apache/lucene/util/TestRamUsageEstimatorOnWildAnimals.java",0,0.981481481481482,1,1,2
"lucene/core/src/test/org/apache/lucene/util/TestRecyclingByteBlockAllocator.java",0,0.881118881118881,2,2,4
"lucene/core/src/test/org/apache/lucene/util/TestRollingBuffer.java",0,0.950617283950617,2,1,3
"lucene/core/src/test/org/apache/lucene/util/TestRollingCharBuffer.java",0,0.96875,2,1,3
"lucene/core/src/test/org/apache/lucene/util/TestSentinelIntSet.java",0,0.615384615384615,0,3,3
"lucene/core/src/test/org/apache/lucene/util/TestSetOnce.java",0,0.919191919191919,2,2,4
"lucene/core/src/test/org/apache/lucene/util/TestSmallFloat.java",0,0.973333333333333,3,1,4
"lucene/core/src/test/org/apache/lucene/util/TestSortedVIntList.java",0,0.938461538461538,1,2,3
"lucene/core/src/test/org/apache/lucene/util/TestTwoPhaseCommitTool.java",0,0.933734939759036,3,1,4
"lucene/core/src/test/org/apache/lucene/util/TestUnicodeUtil.java",0,0.60655737704918,5,2,7
"lucene/core/src/test/org/apache/lucene/util/TestVersion.java",0,0.75,1,3,4
"lucene/core/src/test/org/apache/lucene/util/TestVersionComparator.java",0,0.884615384615385,1,2,3
"lucene/core/src/test/org/apache/lucene/util/TestVirtualMethod.java",0,0.990476190476191,1,1,2
"lucene/core/src/test/org/apache/lucene/util/TestWeakIdentityMap.java",0,0.991561181434599,2,1,3
"lucene/core/src/test/org/apache/lucene/util/automaton/TestBasicOperations.java",0,0.512396694214876,2,3,5
"lucene/core/src/test/org/apache/lucene/util/automaton/TestCompiledAutomaton.java",0,0.918032786885246,2,2,4
"lucene/core/src/test/org/apache/lucene/util/automaton/TestDeterminism.java",0,0.756410256410256,3,2,5
"lucene/core/src/test/org/apache/lucene/util/automaton/TestDeterminizeLexicon.java",0,0.857142857142857,3,2,5
"lucene/core/src/test/org/apache/lucene/util/automaton/TestLevenshteinAutomata.java",0,0.661417322834646,2,2,4
"lucene/core/src/test/org/apache/lucene/util/automaton/TestMinimize.java",0,0.859649122807018,2,2,4
"lucene/core/src/test/org/apache/lucene/util/automaton/TestSpecialOperations.java",0,0.941176470588235,2,1,3
"lucene/core/src/test/org/apache/lucene/util/automaton/TestUTF32ToUTF8.java",0,0.933054393305439,4,1,5
"lucene/core/src/test/org/apache/lucene/util/fst/TestFSTs.java",0,0.779277318241184,4,3,7
"lucene/core/src/test/org/apache/lucene/util/junitcompat/SorePoint.java",0,0.484848484848485,1,2,3
"lucene/core/src/test/org/apache/lucene/util/junitcompat/SoreType.java",0,0.666666666666667,1,2,3
"lucene/core/src/test/org/apache/lucene/util/junitcompat/TestBeforeAfterOverrides.java",0,0.985507246376812,1,1,2
"lucene/core/src/test/org/apache/lucene/util/junitcompat/TestCodecReported.java",0,0.978723404255319,1,1,2
"lucene/core/src/test/org/apache/lucene/util/junitcompat/TestExceptionInBeforeClassHooks.java",0,0.875,1,2,3
"lucene/core/src/test/org/apache/lucene/util/junitcompat/TestJUnitRuleOrder.java",0,0.815217391304348,1,2,3
"lucene/core/src/test/org/apache/lucene/util/junitcompat/TestReproduceMessage.java",0,0.917763157894737,1,2,3
"lucene/core/src/test/org/apache/lucene/util/junitcompat/TestSameRandomnessLocalePassedOrNot.java",0,0.98780487804878,1,1,2
"lucene/core/src/test/org/apache/lucene/util/junitcompat/TestSeedFromUncaught.java",0,0.903225806451613,1,2,3
"lucene/core/src/test/org/apache/lucene/util/junitcompat/TestSetupTeardownChaining.java",0,0.792682926829268,1,2,3
"lucene/core/src/test/org/apache/lucene/util/junitcompat/TestSystemPropertiesInvariantRule.java",0,0.892405063291139,1,2,3
"lucene/core/src/test/org/apache/lucene/util/junitcompat/WithNestedTests.java",0,0.858333333333333,1,2,3
"lucene/core/src/test/org/apache/lucene/util/packed/TestPackedInts.java",0,0.542087542087542,4,4,8
"lucene/demo/src/java/org/apache/lucene/demo/IndexFiles.java",0,0.539906103286385,8,4,12
"lucene/demo/src/java/org/apache/lucene/demo/SearchFiles.java",0,0.832635983263598,3,3,6
"lucene/demo/src/java/org/apache/lucene/demo/xmlparser/FormBasedXmlQueryDemo.java",0,0.59375,3,5,8
"lucene/demo/src/test/org/apache/lucene/demo/TestDemo.java",0,0.690909090909091,1,3,4
"lucene/facet/src/examples/org/apache/lucene/facet/example/ExampleResult.java",0,0.979591836734694,1,1,2
"lucene/facet/src/examples/org/apache/lucene/facet/example/ExampleUtils.java",0,0.947368421052632,2,1,3
"lucene/facet/src/examples/org/apache/lucene/facet/example/adaptive/AdaptiveMain.java",0,0.985074626865672,1,1,2
"lucene/facet/src/examples/org/apache/lucene/facet/example/adaptive/AdaptiveSearcher.java",0,0.971153846153846,2,1,3
"lucene/facet/src/examples/org/apache/lucene/facet/example/association/AssociationIndexer.java",0,0.953488372093023,3,1,4
"lucene/facet/src/examples/org/apache/lucene/facet/example/association/AssociationMain.java",0,0.98780487804878,1,1,2
"lucene/facet/src/examples/org/apache/lucene/facet/example/association/AssociationSearcher.java",0,0.951219512195122,2,1,3
"lucene/facet/src/examples/org/apache/lucene/facet/example/association/AssociationUtils.java",0,0.987341772151899,1,1,2
"lucene/facet/src/examples/org/apache/lucene/facet/example/merge/TaxonomyMergeUtils.java",0,0.864077669902913,1,2,3
"lucene/facet/src/examples/org/apache/lucene/facet/example/multiCL/MultiCLIndexer.java",0,0.951923076923077,4,1,5
"lucene/facet/src/examples/org/apache/lucene/facet/example/multiCL/MultiCLMain.java",0,0.984615384615385,1,1,2
"lucene/facet/src/examples/org/apache/lucene/facet/example/multiCL/MultiCLSearcher.java",0,0.976744186046512,2,1,3
"lucene/facet/src/examples/org/apache/lucene/facet/example/simple/SimpleIndexer.java",0,0.910891089108911,4,1,5
"lucene/facet/src/examples/org/apache/lucene/facet/example/simple/SimpleMain.java",0,0.96,2,1,3
"lucene/facet/src/examples/org/apache/lucene/facet/example/simple/SimpleSearcher.java",0,0.994047619047619,1,1,2
"lucene/facet/src/examples/org/apache/lucene/facet/example/simple/SimpleUtils.java",0,0.986666666666667,1,1,2
"lucene/facet/src/java/org/apache/lucene/facet/FacetException.java",0,0.978260869565217,1,1,2
"lucene/facet/src/java/org/apache/lucene/facet/enhancements/CategoryEnhancement.java",0,0.765151515151515,1,2,3
"lucene/facet/src/java/org/apache/lucene/facet/enhancements/EnhancementsCategoryTokenizer.java",0,0.967479674796748,2,1,3
"lucene/facet/src/java/org/apache/lucene/facet/enhancements/EnhancementsDocumentBuilder.java",0,0.989247311827957,1,1,2
"lucene/facet/src/java/org/apache/lucene/facet/enhancements/EnhancementsPayloadIterator.java",0,0.990476190476191,1,1,2
"lucene/facet/src/java/org/apache/lucene/facet/enhancements/association/AssociationEnhancement.java",0,0.91566265060241,1,2,3
"lucene/facet/src/java/org/apache/lucene/facet/enhancements/association/AssociationFloatProperty.java",0,0.986486486486487,1,1,2
"lucene/facet/src/java/org/apache/lucene/facet/enhancements/association/AssociationIntProperty.java",0,0.983333333333333,1,1,2
"lucene/facet/src/java/org/apache/lucene/facet/enhancements/association/AssociationListTokenizer.java",0,0.956521739130435,2,1,3
"lucene/facet/src/java/org/apache/lucene/facet/enhancements/association/AssociationProperty.java",0,0.986301369863014,1,1,2
"lucene/facet/src/java/org/apache/lucene/facet/enhancements/association/AssociationsPayloadIterator.java",0,0.995744680851064,1,1,2
"lucene/facet/src/java/org/apache/lucene/facet/enhancements/params/DefaultEnhancementsIndexingParams.java",0,0.989795918367347,1,1,2
"lucene/facet/src/java/org/apache/lucene/facet/enhancements/params/EnhancementsIndexingParams.java",0,0.984848484848485,1,1,2
"lucene/facet/src/java/org/apache/lucene/facet/index/CategoryContainer.java",0,0.98134328358209,2,1,3
"lucene/facet/src/java/org/apache/lucene/facet/index/CategoryDocumentBuilder.java",0,0.973154362416107,4,1,5
"lucene/facet/src/java/org/apache/lucene/facet/index/CategoryListPayloadStream.java",0,0.953846153846154,2,1,3
"lucene/facet/src/java/org/apache/lucene/facet/index/FacetsPayloadProcessorProvider.java",0,0.934010152284264,3,2,5
"lucene/facet/src/java/org/apache/lucene/facet/index/attributes/CategoryAttribute.java",0,0.992248062015504,1,1,2
"lucene/facet/src/java/org/apache/lucene/facet/index/attributes/CategoryAttributeImpl.java",0,0.984375,2,1,3
"lucene/facet/src/java/org/apache/lucene/facet/index/attributes/CategoryAttributesIterable.java",0,0.985507246376812,1,1,2
"lucene/facet/src/java/org/apache/lucene/facet/index/attributes/CategoryProperty.java",0,0.980392156862745,1,1,2
"lucene/facet/src/java/org/apache/lucene/facet/index/attributes/OrdinalProperty.java",0,0.985915492957746,1,1,2
"lucene/facet/src/java/org/apache/lucene/facet/index/categorypolicy/DefaultOrdinalPolicy.java",0,0.976744186046512,1,1,2
"lucene/facet/src/java/org/apache/lucene/facet/index/categorypolicy/DefaultPathPolicy.java",0,0.973684210526316,1,1,2
"lucene/facet/src/java/org/apache/lucene/facet/index/categorypolicy/NonTopLevelOrdinalPolicy.java",0,0.985915492957746,1,1,2
"lucene/facet/src/java/org/apache/lucene/facet/index/categorypolicy/NonTopLevelPathPolicy.java",0,0.976744186046512,1,1,2
"lucene/facet/src/java/org/apache/lucene/facet/index/categorypolicy/OrdinalPolicy.java",0,0.982142857142857,1,1,2
"lucene/facet/src/java/org/apache/lucene/facet/index/categorypolicy/PathPolicy.java",0,0.978723404255319,1,1,2
"lucene/facet/src/java/org/apache/lucene/facet/index/params/CategoryListParams.java",0,0.993288590604027,1,1,2
"lucene/facet/src/java/org/apache/lucene/facet/index/params/DefaultFacetIndexingParams.java",0,0.994897959183674,1,1,2
"lucene/facet/src/java/org/apache/lucene/facet/index/params/FacetIndexingParams.java",0,0.989795918367347,1,1,2
"lucene/facet/src/java/org/apache/lucene/facet/index/params/FacetParamsMissingPropertyException.java",0,0.96875,1,1,2
"lucene/facet/src/java/org/apache/lucene/facet/index/params/PerDimensionIndexingParams.java",0,0.990476190476191,1,1,2
"lucene/facet/src/java/org/apache/lucene/facet/index/streaming/CategoryAttributesStream.java",0,0.987654320987654,1,1,2
"lucene/facet/src/java/org/apache/lucene/facet/index/streaming/CategoryListTokenizer.java",0,0.985074626865672,1,1,2
"lucene/facet/src/java/org/apache/lucene/facet/index/streaming/CategoryParentsStream.java",0,0.994708994708995,1,1,2
"lucene/facet/src/java/org/apache/lucene/facet/index/streaming/CategoryTokenizer.java",0,0.985074626865672,1,1,2
"lucene/facet/src/java/org/apache/lucene/facet/index/streaming/CategoryTokenizerBase.java",0,0.961538461538462,2,1,3
"lucene/facet/src/java/org/apache/lucene/facet/index/streaming/CountingListTokenizer.java",0,0.968503937007874,2,1,3
"lucene/facet/src/java/org/apache/lucene/facet/search/AdaptiveFacetsAccumulator.java",0,0.957983193277311,2,1,3
"lucene/facet/src/java/org/apache/lucene/facet/search/CategoryListIterator.java",0,0.985507246376812,1,1,2
"lucene/facet/src/java/org/apache/lucene/facet/search/DrillDown.java",0,0.990909090909091,1,1,2
"lucene/facet/src/java/org/apache/lucene/facet/search/FacetArrays.java",0,0.989010989010989,1,1,2
"lucene/facet/src/java/org/apache/lucene/facet/search/FacetResultsHandler.java",0,0.993788819875776,1,1,2
"lucene/facet/src/java/org/apache/lucene/facet/search/FacetsAccumulator.java",0,0.993197278911565,1,1,2
"lucene/facet/src/java/org/apache/lucene/facet/search/FacetsCollector.java",0,0.985401459854015,2,1,3
"lucene/facet/src/java/org/apache/lucene/facet/search/FloatArrayAllocator.java",0,0.985294117647059,1,1,2
"lucene/facet/src/java/org/apache/lucene/facet/search/Heap.java",0,0.982142857142857,1,1,2
"lucene/facet/src/java/org/apache/lucene/facet/search/IntArrayAllocator.java",0,0.985294117647059,1,1,2
"lucene/facet/src/java/org/apache/lucene/facet/search/PayloadIntDecodingIterator.java",0,0.991452991452991,1,1,2
"lucene/facet/src/java/org/apache/lucene/facet/search/PayloadIterator.java",0,0.978260869565217,2,1,3
"lucene/facet/src/java/org/apache/lucene/facet/search/SamplingWrapper.java",0,0.991525423728814,1,1,2
"lucene/facet/src/java/org/apache/lucene/facet/search/ScoredDocIDs.java",0,0.976190476190476,1,1,2
"lucene/facet/src/java/org/apache/lucene/facet/search/ScoredDocIDsIterator.java",0,0.976744186046512,1,1,2
"lucene/facet/src/java/org/apache/lucene/facet/search/ScoredDocIdCollector.java",0,0.991071428571429,2,1,3
"lucene/facet/src/java/org/apache/lucene/facet/search/StandardFacetsAccumulator.java",0,0.99112426035503,2,1,3
"lucene/facet/src/java/org/apache/lucene/facet/search/TemporaryObjectAllocator.java",0,0.991228070175439,1,1,2
"lucene/facet/src/java/org/apache/lucene/facet/search/TopKFacetResultsHandler.java",0,0.996575342465753,1,1,2
"lucene/facet/src/java/org/apache/lucene/facet/search/TopKInEachNodeHandler.java",0,0.99874686716792,1,1,2
"lucene/facet/src/java/org/apache/lucene/facet/search/TotalFacetCounts.java",0,0.994652406417112,1,1,2
"lucene/facet/src/java/org/apache/lucene/facet/search/TotalFacetCountsCache.java",0,0.996491228070175,1,1,2
"lucene/facet/src/java/org/apache/lucene/facet/search/aggregator/Aggregator.java",0,0.980392156862745,1,1,2
"lucene/facet/src/java/org/apache/lucene/facet/search/aggregator/ComplementCountingAggregator.java",0,0.972972972972973,1,1,2
"lucene/facet/src/java/org/apache/lucene/facet/search/aggregator/CountingAggregator.java",0,0.983050847457627,1,1,2
"lucene/facet/src/java/org/apache/lucene/facet/search/aggregator/ScoringAggregator.java",0,0.982758620689655,1,1,2
"lucene/facet/src/java/org/apache/lucene/facet/search/aggregator/association/AssociationFloatSumAggregator.java",0,0.986486486486487,1,1,2
"lucene/facet/src/java/org/apache/lucene/facet/search/aggregator/association/AssociationIntSumAggregator.java",0,0.986486486486487,1,1,2
"lucene/facet/src/java/org/apache/lucene/facet/search/cache/CategoryListCache.java",0,0.983606557377049,1,1,2
"lucene/facet/src/java/org/apache/lucene/facet/search/cache/CategoryListData.java",0,0.992592592592593,1,1,2
"lucene/facet/src/java/org/apache/lucene/facet/search/params/CountFacetRequest.java",0,0.986666666666667,1,1,2
"lucene/facet/src/java/org/apache/lucene/facet/search/params/FacetRequest.java",0,0.984084880636605,3,1,4
"lucene/facet/src/java/org/apache/lucene/facet/search/params/FacetSearchParams.java",0,0.992307692307692,1,1,2
"lucene/facet/src/java/org/apache/lucene/facet/search/params/ScoreFacetRequest.java",0,0.984126984126984,1,1,2
"lucene/facet/src/java/org/apache/lucene/facet/search/params/association/AssociationFloatSumFacetRequest.java",0,0.985714285714286,1,1,2
"lucene/facet/src/java/org/apache/lucene/facet/search/params/association/AssociationIntSumFacetRequest.java",0,0.985714285714286,1,1,2
"lucene/facet/src/java/org/apache/lucene/facet/search/results/FacetResult.java",0,0.990291262135922,1,1,2
"lucene/facet/src/java/org/apache/lucene/facet/search/results/FacetResultNode.java",0,0.990909090909091,1,1,2
"lucene/facet/src/java/org/apache/lucene/facet/search/results/IntermediateFacetResult.java",0,0.975609756097561,1,1,2
"lucene/facet/src/java/org/apache/lucene/facet/search/results/MutableFacetResultNode.java",0,0.997093023255814,1,1,2
"lucene/facet/src/java/org/apache/lucene/facet/search/sampling/RandomSampler.java",0,0.985915492957746,1,1,2
"lucene/facet/src/java/org/apache/lucene/facet/search/sampling/RepeatableSampler.java",0,0.829736211031175,1,2,3
"lucene/facet/src/java/org/apache/lucene/facet/search/sampling/SampleFixer.java",0,0.977272727272727,1,1,2
"lucene/facet/src/java/org/apache/lucene/facet/search/sampling/Sampler.java",0,0.938053097345133,1,2,3
"lucene/facet/src/java/org/apache/lucene/facet/search/sampling/SamplingAccumulator.java",0,0.993006993006993,1,1,2
"lucene/facet/src/java/org/apache/lucene/facet/search/sampling/SamplingParams.java",0,0.994082840236686,1,1,2
"lucene/facet/src/java/org/apache/lucene/facet/search/sampling/TakmiSampleFixer.java",0,0.967032967032967,2,1,3
"lucene/facet/src/java/org/apache/lucene/facet/taxonomy/CategoryPath.java",0,0.998100664767331,2,1,3
"lucene/facet/src/java/org/apache/lucene/facet/taxonomy/InconsistentTaxonomyException.java",0,0.975,1,1,2
"lucene/facet/src/java/org/apache/lucene/facet/taxonomy/TaxonomyReader.java",0,0.957597173144876,3,1,4
"lucene/facet/src/java/org/apache/lucene/facet/taxonomy/TaxonomyWriter.java",0,0.962616822429907,3,1,4
"lucene/facet/src/java/org/apache/lucene/facet/taxonomy/directory/Consts.java",0,0.714285714285714,2,2,4
"lucene/facet/src/java/org/apache/lucene/facet/taxonomy/directory/DirectoryTaxonomyReader.java",0,0.780165289256198,4,2,6
"lucene/facet/src/java/org/apache/lucene/facet/taxonomy/directory/DirectoryTaxonomyWriter.java",0,0.507692307692308,3,3,6
"lucene/facet/src/java/org/apache/lucene/facet/taxonomy/directory/ParentArray.java",0,0.944444444444444,4,1,5
"lucene/facet/src/java/org/apache/lucene/facet/taxonomy/writercache/TaxonomyWriterCache.java",0,0.87719298245614,1,2,3
"lucene/facet/src/java/org/apache/lucene/facet/taxonomy/writercache/cl2o/CharBlockArray.java",0,0.994871794871795,1,1,2
"lucene/facet/src/java/org/apache/lucene/facet/taxonomy/writercache/cl2o/Cl2oTaxonomyWriterCache.java",0,0.503937007874016,1,2,3
"lucene/facet/src/java/org/apache/lucene/facet/taxonomy/writercache/cl2o/CollisionMap.java",0,0.99625468164794,1,1,2
"lucene/facet/src/java/org/apache/lucene/facet/taxonomy/writercache/cl2o/CompactLabelToOrdinal.java",0,0.970383275261324,3,1,4
"lucene/facet/src/java/org/apache/lucene/facet/taxonomy/writercache/cl2o/LabelToOrdinal.java",0,0.986301369863014,1,1,2
"lucene/facet/src/java/org/apache/lucene/facet/taxonomy/writercache/lru/LruTaxonomyWriterCache.java",0,0.855072463768116,1,2,3
"lucene/facet/src/java/org/apache/lucene/facet/taxonomy/writercache/lru/NameHashIntCacheLRU.java",0,0.978260869565217,1,1,2
"lucene/facet/src/java/org/apache/lucene/facet/taxonomy/writercache/lru/NameIntCacheLRU.java",0,0.951048951048951,2,1,3
"lucene/facet/src/java/org/apache/lucene/facet/util/MultiCategoryListIterator.java",0,0.987951807228916,1,1,2
"lucene/facet/src/java/org/apache/lucene/facet/util/PartitionsUtils.java",0,0.990384615384615,1,1,2
"lucene/facet/src/java/org/apache/lucene/facet/util/ResultSortUtils.java",0,0.994845360824742,1,1,2
"lucene/facet/src/java/org/apache/lucene/facet/util/ScoredDocIdsUtils.java",0,0.984962406015038,3,1,4
"lucene/facet/src/java/org/apache/lucene/util/UnsafeByteArrayInputStream.java",0,0.993197278911565,1,1,2
"lucene/facet/src/java/org/apache/lucene/util/UnsafeByteArrayOutputStream.java",0,0.994565217391304,1,1,2
"lucene/facet/src/java/org/apache/lucene/util/Vint8.java",0,0.995633187772926,1,1,2
"lucene/facet/src/java/org/apache/lucene/util/collections/ArrayHashMap.java",0,0.994505494505495,2,1,3
"lucene/facet/src/java/org/apache/lucene/util/collections/DoubleIterator.java",0,0.967741935483871,1,1,2
"lucene/facet/src/java/org/apache/lucene/util/collections/FloatIterator.java",0,0.967741935483871,1,1,2
"lucene/facet/src/java/org/apache/lucene/util/collections/FloatToObjectMap.java",0,0.995238095238095,2,1,3
"lucene/facet/src/java/org/apache/lucene/util/collections/IntArray.java",0,0.996031746031746,1,1,2
"lucene/facet/src/java/org/apache/lucene/util/collections/IntHashSet.java",0,0.994545454545455,2,1,3
"lucene/facet/src/java/org/apache/lucene/util/collections/IntIterator.java",0,0.967741935483871,1,1,2
"lucene/facet/src/java/org/apache/lucene/util/collections/IntToDoubleMap.java",0,0.995230524642289,2,1,3
"lucene/facet/src/java/org/apache/lucene/util/collections/IntToIntMap.java",0,0.995161290322581,2,1,3
"lucene/facet/src/java/org/apache/lucene/util/collections/IntToObjectMap.java",0,0.995238095238095,2,1,3
"lucene/facet/src/java/org/apache/lucene/util/collections/LRUHashMap.java",0,0.990476190476191,1,1,2
"lucene/facet/src/java/org/apache/lucene/util/collections/ObjectToFloatMap.java",0,0.995169082125604,2,1,3
"lucene/facet/src/java/org/apache/lucene/util/collections/ObjectToIntMap.java",0,0.995161290322581,2,1,3
"lucene/facet/src/java/org/apache/lucene/util/encoding/ChunksIntEncoder.java",0,0.990476190476191,1,1,2
"lucene/facet/src/java/org/apache/lucene/util/encoding/DGapIntDecoder.java",0,0.983870967741935,1,1,2
"lucene/facet/src/java/org/apache/lucene/util/encoding/DGapIntEncoder.java",0,0.985507246376812,1,1,2
"lucene/facet/src/java/org/apache/lucene/util/encoding/EightFlagsIntDecoder.java",0,0.989010989010989,1,1,2
"lucene/facet/src/java/org/apache/lucene/util/encoding/EightFlagsIntEncoder.java",0,0.988095238095238,1,1,2
"lucene/facet/src/java/org/apache/lucene/util/encoding/FourFlagsIntDecoder.java",0,0.989130434782609,1,1,2
"lucene/facet/src/java/org/apache/lucene/util/encoding/FourFlagsIntEncoder.java",0,0.98989898989899,1,1,2
"lucene/facet/src/java/org/apache/lucene/util/encoding/IntDecoder.java",0,0.981132075471698,1,1,2
"lucene/facet/src/java/org/apache/lucene/util/encoding/IntEncoder.java",0,0.991150442477876,1,1,2
"lucene/facet/src/java/org/apache/lucene/util/encoding/IntEncoderFilter.java",0,0.982758620689655,1,1,2
"lucene/facet/src/java/org/apache/lucene/util/encoding/NOnesIntDecoder.java",0,0.987341772151899,1,1,2
"lucene/facet/src/java/org/apache/lucene/util/encoding/NOnesIntEncoder.java",0,0.991304347826087,1,1,2
"lucene/facet/src/java/org/apache/lucene/util/encoding/SimpleIntDecoder.java",0,0.984848484848485,1,1,2
"lucene/facet/src/java/org/apache/lucene/util/encoding/SimpleIntEncoder.java",0,0.982456140350877,1,1,2
"lucene/facet/src/java/org/apache/lucene/util/encoding/SortingIntEncoder.java",0,0.988235294117647,1,1,2
"lucene/facet/src/java/org/apache/lucene/util/encoding/UniqueValuesIntEncoder.java",0,0.985915492957746,1,1,2
"lucene/facet/src/java/org/apache/lucene/util/encoding/VInt8IntDecoder.java",0,0.982758620689655,1,1,2
"lucene/facet/src/java/org/apache/lucene/util/encoding/VInt8IntEncoder.java",0,0.988372093023256,1,1,2
"lucene/facet/src/test/org/apache/lucene/facet/FacetTestBase.java",0,0.805084745762712,4,2,6
"lucene/facet/src/test/org/apache/lucene/facet/FacetTestUtils.java",0,0.95679012345679,3,1,4
"lucene/facet/src/test/org/apache/lucene/facet/enhancements/CategoryEnhancementDummy1.java",0,0.985714285714286,1,1,2
"lucene/facet/src/test/org/apache/lucene/facet/enhancements/CategoryEnhancementDummy2.java",0,0.987341772151899,1,1,2
"lucene/facet/src/test/org/apache/lucene/facet/enhancements/CategoryEnhancementDummy3.java",0,0.987179487179487,1,1,2
"lucene/facet/src/test/org/apache/lucene/facet/enhancements/EnhancementsPayloadIteratorTest.java",0,0.991150442477876,1,1,2
"lucene/facet/src/test/org/apache/lucene/facet/enhancements/TwoEnhancementsTest.java",0,0.941176470588235,3,1,4
"lucene/facet/src/test/org/apache/lucene/facet/enhancements/association/AssociationPropertyTest.java",0,0.984615384615385,1,1,2
"lucene/facet/src/test/org/apache/lucene/facet/enhancements/association/CustomAssociationPropertyTest.java",0,0.931372549019608,3,1,4
"lucene/facet/src/test/org/apache/lucene/facet/enhancements/params/DefaultEnhancementsIndexingParamsTest.java",0,0.985074626865672,1,1,2
"lucene/facet/src/test/org/apache/lucene/facet/example/TestAdaptiveExample.java",0,0.975,1,1,2
"lucene/facet/src/test/org/apache/lucene/facet/example/TestAssociationExample.java",0,0.981818181818182,1,1,2
"lucene/facet/src/test/org/apache/lucene/facet/example/TestMultiCLExample.java",0,0.988888888888889,1,1,2
"lucene/facet/src/test/org/apache/lucene/facet/example/TestSimpleExample.java",0,0.985074626865672,1,1,2
"lucene/facet/src/test/org/apache/lucene/facet/index/CategoryContainerTest.java",0,0.995901639344262,1,1,2
"lucene/facet/src/test/org/apache/lucene/facet/index/CategoryContainerTestBase.java",0,0.977777777777778,1,1,2
"lucene/facet/src/test/org/apache/lucene/facet/index/CategoryListPayloadStreamTest.java",0,0.975,2,1,3
"lucene/facet/src/test/org/apache/lucene/facet/index/DummyProperty.java",0,0.98,1,1,2
"lucene/facet/src/test/org/apache/lucene/facet/index/FacetsPayloadProcessorProviderTest.java",0,0.921052631578947,4,1,5
"lucene/facet/src/test/org/apache/lucene/facet/index/attributes/CategoryAttributeImplTest.java",0,0.992,1,1,2
"lucene/facet/src/test/org/apache/lucene/facet/index/attributes/CategoryAttributesIterableTest.java",0,0.981132075471698,1,1,2
"lucene/facet/src/test/org/apache/lucene/facet/index/categorypolicy/OrdinalPolicyTest.java",0,0.924731182795699,3,1,4
"lucene/facet/src/test/org/apache/lucene/facet/index/categorypolicy/PathPolicyTest.java",0,0.91578947368421,2,2,4
"lucene/facet/src/test/org/apache/lucene/facet/index/params/CategoryListParamsTest.java",0,0.988372093023256,1,1,2
"lucene/facet/src/test/org/apache/lucene/facet/index/params/DefaultFacetIndexingParamsTest.java",0,0.966666666666667,2,1,3
"lucene/facet/src/test/org/apache/lucene/facet/index/params/PerDimensionIndexingParamsTest.java",0,0.987654320987654,1,1,2
"lucene/facet/src/test/org/apache/lucene/facet/index/streaming/CategoryAttributesStreamTest.java",0,0.98780487804878,1,1,2
"lucene/facet/src/test/org/apache/lucene/facet/index/streaming/CategoryParentsStreamTest.java",0,0.97196261682243,2,1,3
"lucene/facet/src/test/org/apache/lucene/facet/index/streaming/CategoryTokenizerTest.java",0,0.965217391304348,2,1,3
"lucene/facet/src/test/org/apache/lucene/facet/search/AdaptiveAccumulatorTest.java",0,0.973684210526316,1,1,2
"lucene/facet/src/test/org/apache/lucene/facet/search/BaseTestTopK.java",0,0.947368421052632,4,1,5
"lucene/facet/src/test/org/apache/lucene/facet/search/CategoryListIteratorTest.java",0,0.865979381443299,5,2,7
"lucene/facet/src/test/org/apache/lucene/facet/search/DrillDownTest.java",0,0.932642487046632,4,1,5
"lucene/facet/src/test/org/apache/lucene/facet/search/SamplingWrapperTest.java",0,0.972972972972973,1,1,2
"lucene/facet/src/test/org/apache/lucene/facet/search/TestCategoryListCache.java",0,0.992424242424242,1,1,2
"lucene/facet/src/test/org/apache/lucene/facet/search/TestFacetArrays.java",0,0.980769230769231,1,1,2
"lucene/facet/src/test/org/apache/lucene/facet/search/TestFacetsAccumulatorWithComplement.java",0,0.974842767295597,2,1,3
"lucene/facet/src/test/org/apache/lucene/facet/search/TestMultipleCategoryLists.java",0,0.881266490765171,3,2,5
"lucene/facet/src/test/org/apache/lucene/facet/search/TestScoredDocIdCollector.java",0,0.994285714285714,1,1,2
"lucene/facet/src/test/org/apache/lucene/facet/search/TestTopKInEachNodeResultHandler.java",0,0.973134328358209,4,1,5
"lucene/facet/src/test/org/apache/lucene/facet/search/TestTopKResultsHandler.java",0,0.995850622406639,1,1,2
"lucene/facet/src/test/org/apache/lucene/facet/search/TestTopKResultsHandlerRandom.java",0,0.992857142857143,1,1,2
"lucene/facet/src/test/org/apache/lucene/facet/search/TestTotalFacetCounts.java",0,0.982758620689655,2,1,3
"lucene/facet/src/test/org/apache/lucene/facet/search/TestTotalFacetCountsCache.java",0,0.96045197740113,4,1,5
"lucene/facet/src/test/org/apache/lucene/facet/search/association/AssociationsFacetRequestTest.java",0,0.951612903225806,3,1,4
"lucene/facet/src/test/org/apache/lucene/facet/search/params/FacetRequestTest.java",0,0.9375,3,1,4
"lucene/facet/src/test/org/apache/lucene/facet/search/params/FacetSearchParamsTest.java",0,0.911392405063291,1,2,3
"lucene/facet/src/test/org/apache/lucene/facet/search/params/MultiIteratorsPerCLParamsTest.java",0,0.973880597014925,3,1,4
"lucene/facet/src/test/org/apache/lucene/facet/search/sampling/BaseSampleTestTopK.java",0,0.6,2,2,4
"lucene/facet/src/test/org/apache/lucene/facet/search/sampling/SamplingAccumulatorTest.java",0,0.971428571428571,1,1,2
"lucene/facet/src/test/org/apache/lucene/facet/taxonomy/TestCategoryPath.java",0,0.99889012208657,1,1,2
"lucene/facet/src/test/org/apache/lucene/facet/taxonomy/TestTaxonomyCombined.java",0,0.957038391224863,2,1,3
"lucene/facet/src/test/org/apache/lucene/facet/taxonomy/directory/TestAddTaxonomy.java",0,0.995884773662551,1,1,2
"lucene/facet/src/test/org/apache/lucene/facet/taxonomy/directory/TestDirectoryTaxonomyReader.java",0,0.514563106796116,2,2,4
"lucene/facet/src/test/org/apache/lucene/facet/taxonomy/directory/TestDirectoryTaxonomyWriter.java",0,0.798136645962733,2,2,4
"lucene/facet/src/test/org/apache/lucene/facet/taxonomy/writercache/cl2o/TestCharBlockArray.java",0,0.923913043478261,1,2,3
"lucene/facet/src/test/org/apache/lucene/facet/taxonomy/writercache/cl2o/TestCompactLabelToOrdinal.java",0,0.967479674796748,2,1,3
"lucene/facet/src/test/org/apache/lucene/facet/util/TestScoredDocIDsUtils.java",0,0.896265560165975,5,1,6
"lucene/facet/src/test/org/apache/lucene/util/SlowRAMDirectory.java",0,0.89375,3,2,5
"lucene/facet/src/test/org/apache/lucene/util/UnsafeByteArrayInputStreamTest.java",0,0.992805755395683,1,1,2
"lucene/facet/src/test/org/apache/lucene/util/UnsafeByteArrayOutputStreamTest.java",0,0.995260663507109,1,1,2
"lucene/facet/src/test/org/apache/lucene/util/Vint8Test.java",0,0.99290780141844,1,1,2
"lucene/facet/src/test/org/apache/lucene/util/collections/ArrayHashMapTest.java",0,0.992565055762082,2,1,3
"lucene/facet/src/test/org/apache/lucene/util/collections/FloatToObjectMapTest.java",0,0.99250936329588,2,1,3
"lucene/facet/src/test/org/apache/lucene/util/collections/IntArrayTest.java",0,0.992063492063492,1,1,2
"lucene/facet/src/test/org/apache/lucene/util/collections/IntHashSetTest.java",0,0.942477876106195,1,2,3
"lucene/facet/src/test/org/apache/lucene/util/collections/IntToDoubleMapTest.java",0,0.992647058823529,2,1,3
"lucene/facet/src/test/org/apache/lucene/util/collections/IntToIntMapTest.java",0,0.992647058823529,2,1,3
"lucene/facet/src/test/org/apache/lucene/util/collections/IntToObjectMapTest.java",0,0.992537313432836,2,1,3
"lucene/facet/src/test/org/apache/lucene/util/collections/ObjectToFloatMapTest.java",0,0.992857142857143,2,1,3
"lucene/facet/src/test/org/apache/lucene/util/collections/ObjectToIntMapTest.java",0,0.992805755395683,2,1,3
"lucene/facet/src/test/org/apache/lucene/util/collections/TestLRUHashMap.java",0,0.983606557377049,1,1,2
"lucene/facet/src/test/org/apache/lucene/util/encoding/EncodingSpeed.java",0,0.998482549317147,1,1,2
"lucene/facet/src/test/org/apache/lucene/util/encoding/EncodingTest.java",0,0.997641509433962,1,1,2
"lucene/grouping/src/java/org/apache/lucene/search/grouping/AbstractAllGroupHeadsCollector.java",0,0.994444444444444,1,1,2
"lucene/grouping/src/java/org/apache/lucene/search/grouping/AbstractAllGroupsCollector.java",0,1,0,1,1
"lucene/grouping/src/java/org/apache/lucene/search/grouping/AbstractDistinctValuesCollector.java",0,1,0,1,1
"lucene/grouping/src/java/org/apache/lucene/search/grouping/AbstractFirstPassGroupingCollector.java",0,0.946327683615819,4,1,5
"lucene/grouping/src/java/org/apache/lucene/search/grouping/AbstractGroupFacetCollector.java",0,1,0,1,1
"lucene/grouping/src/java/org/apache/lucene/search/grouping/AbstractSecondPassGroupingCollector.java",0,0.95625,3,1,4
"lucene/grouping/src/java/org/apache/lucene/search/grouping/BlockGroupingCollector.java",0,0.957115009746589,4,1,5
"lucene/grouping/src/java/org/apache/lucene/search/grouping/CollectedSearchGroup.java",0,0.958333333333333,1,1,2
"lucene/grouping/src/java/org/apache/lucene/search/grouping/GroupDocs.java",0,0.983870967741935,1,1,2
"lucene/grouping/src/java/org/apache/lucene/search/grouping/GroupingSearch.java",0,0.982978723404255,1,1,2
"lucene/grouping/src/java/org/apache/lucene/search/grouping/SearchGroup.java",0,0.896755162241888,2,2,4
"lucene/grouping/src/java/org/apache/lucene/search/grouping/TopGroups.java",0,0.857142857142857,1,2,3
"lucene/grouping/src/java/org/apache/lucene/search/grouping/dv/DVAllGroupHeadsCollector.java",0,0.9,1,2,3
"lucene/grouping/src/java/org/apache/lucene/search/grouping/dv/DVAllGroupsCollector.java",0,0.865384615384615,3,2,5
"lucene/grouping/src/java/org/apache/lucene/search/grouping/dv/DVDistinctValuesCollector.java",0,1,0,1,1
"lucene/grouping/src/java/org/apache/lucene/search/grouping/dv/DVFirstPassGroupingCollector.java",0,0.873873873873874,1,2,3
"lucene/grouping/src/java/org/apache/lucene/search/grouping/dv/DVGroupFacetCollector.java",0,1,0,1,1
"lucene/grouping/src/java/org/apache/lucene/search/grouping/dv/DVSecondPassGroupingCollector.java",0,0.873913043478261,2,2,4
"lucene/grouping/src/java/org/apache/lucene/search/grouping/function/FunctionAllGroupHeadsCollector.java",0,0.920529801324503,3,1,4
"lucene/grouping/src/java/org/apache/lucene/search/grouping/function/FunctionAllGroupsCollector.java",0,0.941860465116279,2,1,3
"lucene/grouping/src/java/org/apache/lucene/search/grouping/function/FunctionDistinctValuesCollector.java",0,0.955056179775281,1,1,2
"lucene/grouping/src/java/org/apache/lucene/search/grouping/function/FunctionFirstPassGroupingCollector.java",0,0.954022988505747,2,1,3
"lucene/grouping/src/java/org/apache/lucene/search/grouping/function/FunctionSecondPassGroupingCollector.java",0,0.952941176470588,2,1,3
"lucene/grouping/src/java/org/apache/lucene/search/grouping/term/TermAllGroupHeadsCollector.java",0,0.976058931860037,2,1,3
"lucene/grouping/src/java/org/apache/lucene/search/grouping/term/TermAllGroupsCollector.java",0,0.947368421052632,4,1,5
"lucene/grouping/src/java/org/apache/lucene/search/grouping/term/TermDistinctValuesCollector.java",0,0.971223021582734,1,1,2
"lucene/grouping/src/java/org/apache/lucene/search/grouping/term/TermFirstPassGroupingCollector.java",0,0.906976744186046,4,1,5
"lucene/grouping/src/java/org/apache/lucene/search/grouping/term/TermGroupFacetCollector.java",0,1,0,1,1
"lucene/grouping/src/java/org/apache/lucene/search/grouping/term/TermSecondPassGroupingCollector.java",0,0.873417721518987,4,2,6
"lucene/grouping/src/test/org/apache/lucene/search/grouping/AbstractGroupingTestCase.java",0,0.948717948717949,0,2,2
"lucene/grouping/src/test/org/apache/lucene/search/grouping/AllGroupHeadsCollectorTest.java",0,0.8147512864494,2,3,5
"lucene/grouping/src/test/org/apache/lucene/search/grouping/AllGroupsCollectorTest.java",0,0.563758389261745,3,2,5
"lucene/grouping/src/test/org/apache/lucene/search/grouping/DistinctValuesCollectorTest.java",0,0.938492063492063,1,2,3
"lucene/grouping/src/test/org/apache/lucene/search/grouping/GroupFacetCollectorTest.java",0,0.976816074188563,2,1,3
"lucene/grouping/src/test/org/apache/lucene/search/grouping/GroupingSearchTest.java",0,0.914414414414414,1,2,3
"lucene/grouping/src/test/org/apache/lucene/search/grouping/TestGrouping.java",0,0.656928838951311,7,2,9
"lucene/highlighter/src/java/org/apache/lucene/search/highlight/DefaultEncoder.java",0,0.96875,1,1,2
"lucene/highlighter/src/java/org/apache/lucene/search/highlight/Encoder.java",0,0.931034482758621,2,1,3
"lucene/highlighter/src/java/org/apache/lucene/search/highlight/Formatter.java",0,0.606060606060606,1,3,4
"lucene/highlighter/src/java/org/apache/lucene/search/highlight/Fragmenter.java",0,0.5,1,3,4
"lucene/highlighter/src/java/org/apache/lucene/search/highlight/GradientFormatter.java",0,0.933920704845815,5,1,6
"lucene/highlighter/src/java/org/apache/lucene/search/highlight/Highlighter.java",0,0.553308823529412,8,3,11
"lucene/highlighter/src/java/org/apache/lucene/search/highlight/InvalidTokenOffsetsException.java",0,0.967741935483871,1,1,2
"lucene/highlighter/src/java/org/apache/lucene/search/highlight/NullFragmenter.java",0,0.666666666666667,1,3,4
"lucene/highlighter/src/java/org/apache/lucene/search/highlight/OffsetLimitTokenFilter.java",0,0.982456140350877,1,1,2
"lucene/highlighter/src/java/org/apache/lucene/search/highlight/PositionSpan.java",0,0.967741935483871,1,1,2
"lucene/highlighter/src/java/org/apache/lucene/search/highlight/QueryScorer.java",0,0.884057971014493,7,1,8
"lucene/highlighter/src/java/org/apache/lucene/search/highlight/QueryTermExtractor.java",0,0.572289156626506,4,3,7
"lucene/highlighter/src/java/org/apache/lucene/search/highlight/QueryTermScorer.java",0,0.932098765432099,3,1,4
"lucene/highlighter/src/java/org/apache/lucene/search/highlight/Scorer.java",0,0.656716417910448,1,3,4
"lucene/highlighter/src/java/org/apache/lucene/search/highlight/SimpleFragmenter.java",0,0.5875,2,3,5
"lucene/highlighter/src/java/org/apache/lucene/search/highlight/SimpleHTMLEncoder.java",0,0.975308641975309,2,1,3
"lucene/highlighter/src/java/org/apache/lucene/search/highlight/SimpleHTMLFormatter.java",0,0.423728813559322,2,4,6
"lucene/highlighter/src/java/org/apache/lucene/search/highlight/SimpleSpanFragmenter.java",0,0.638888888888889,3,2,5
"lucene/highlighter/src/java/org/apache/lucene/search/highlight/SpanGradientFormatter.java",0,0.858974358974359,4,2,6
"lucene/highlighter/src/java/org/apache/lucene/search/highlight/TextFragment.java",0,0.728395061728395,2,4,6
"lucene/highlighter/src/java/org/apache/lucene/search/highlight/TokenGroup.java",0,0.681818181818182,4,2,6
"lucene/highlighter/src/java/org/apache/lucene/search/highlight/TokenSources.java",0,0.461538461538462,5,4,9
"lucene/highlighter/src/java/org/apache/lucene/search/highlight/TokenStreamFromTermPositionVector.java",0,0.656,1,4,5
"lucene/highlighter/src/java/org/apache/lucene/search/highlight/WeightedSpanTerm.java",0,0.894736842105263,2,2,4
"lucene/highlighter/src/java/org/apache/lucene/search/highlight/WeightedSpanTermExtractor.java",0,0.839788732394366,4,2,6
"lucene/highlighter/src/java/org/apache/lucene/search/highlight/WeightedTerm.java",0,0.875,2,2,4
"lucene/highlighter/src/java/org/apache/lucene/search/vectorhighlight/BaseFragListBuilder.java",0,0.989583333333333,1,1,2
"lucene/highlighter/src/java/org/apache/lucene/search/vectorhighlight/BaseFragmentsBuilder.java",0,0.488372093023256,3,2,5
"lucene/highlighter/src/java/org/apache/lucene/search/vectorhighlight/BoundaryScanner.java",0,0.975,1,1,2
"lucene/highlighter/src/java/org/apache/lucene/search/vectorhighlight/BreakIteratorBoundaryScanner.java",0,0.938775510204082,2,1,3
"lucene/highlighter/src/java/org/apache/lucene/search/vectorhighlight/FastVectorHighlighter.java",0,0.531531531531532,3,2,5
"lucene/highlighter/src/java/org/apache/lucene/search/vectorhighlight/FieldFragList.java",0,0.603053435114504,2,2,4
"lucene/highlighter/src/java/org/apache/lucene/search/vectorhighlight/FieldPhraseList.java",0,0.638132295719844,2,2,4
"lucene/highlighter/src/java/org/apache/lucene/search/vectorhighlight/FieldQuery.java",0,0.876168224299065,4,2,6
"lucene/highlighter/src/java/org/apache/lucene/search/vectorhighlight/FieldTermStack.java",0,0.605128205128205,3,3,6
"lucene/highlighter/src/java/org/apache/lucene/search/vectorhighlight/FragListBuilder.java",0,0.970588235294118,1,1,2
"lucene/highlighter/src/java/org/apache/lucene/search/vectorhighlight/FragmentsBuilder.java",0,0.568421052631579,1,2,3
"lucene/highlighter/src/java/org/apache/lucene/search/vectorhighlight/ScoreOrderFragmentsBuilder.java",0,0.807692307692308,2,2,4
"lucene/highlighter/src/java/org/apache/lucene/search/vectorhighlight/SimpleBoundaryScanner.java",0,0.988235294117647,1,1,2
"lucene/highlighter/src/java/org/apache/lucene/search/vectorhighlight/SimpleFieldFragList.java",0,0.962962962962963,2,1,3
"lucene/highlighter/src/java/org/apache/lucene/search/vectorhighlight/SimpleFragListBuilder.java",0,0.634146341463415,1,2,3
"lucene/highlighter/src/java/org/apache/lucene/search/vectorhighlight/SimpleFragmentsBuilder.java",0,0.838709677419355,2,2,4
"lucene/highlighter/src/java/org/apache/lucene/search/vectorhighlight/SingleFragListBuilder.java",0,0.982758620689655,1,1,2
"lucene/highlighter/src/java/org/apache/lucene/search/vectorhighlight/WeightedFieldFragList.java",0,1,0,1,1
"lucene/highlighter/src/java/org/apache/lucene/search/vectorhighlight/WeightedFragListBuilder.java",0,1,0,1,1
"lucene/highlighter/src/test/org/apache/lucene/search/highlight/HighlighterPhraseTest.java",0,0.549597855227882,4,3,7
"lucene/highlighter/src/test/org/apache/lucene/search/highlight/HighlighterTest.java",0,0.471327967806841,10,4,14
"lucene/highlighter/src/test/org/apache/lucene/search/highlight/OffsetLimitTokenFilterTest.java",0,0.903225806451613,1,2,3
"lucene/highlighter/src/test/org/apache/lucene/search/highlight/TokenSourcesTest.java",0,0.740601503759398,2,2,4
"lucene/highlighter/src/test/org/apache/lucene/search/highlight/custom/HighlightCustomQueryTest.java",0,0.983870967741935,2,1,3
"lucene/highlighter/src/test/org/apache/lucene/search/vectorhighlight/AbstractTestCase.java",0,0.697033898305085,5,3,8
"lucene/highlighter/src/test/org/apache/lucene/search/vectorhighlight/BreakIteratorBoundaryScannerTest.java",0,0.989010989010989,1,1,2
"lucene/highlighter/src/test/org/apache/lucene/search/vectorhighlight/FieldPhraseListTest.java",0,0.855203619909502,1,2,3
"lucene/highlighter/src/test/org/apache/lucene/search/vectorhighlight/FieldQueryTest.java",0,0.835903083700441,2,3,5
"lucene/highlighter/src/test/org/apache/lucene/search/vectorhighlight/FieldTermStackTest.java",0,0.903409090909091,1,2,3
"lucene/highlighter/src/test/org/apache/lucene/search/vectorhighlight/IndexTimeSynonymTest.java",0,0.919254658385093,5,1,6
"lucene/highlighter/src/test/org/apache/lucene/search/vectorhighlight/ScoreOrderFragmentsBuilderTest.java",0,0.72,1,3,4
"lucene/highlighter/src/test/org/apache/lucene/search/vectorhighlight/SimpleBoundaryScannerTest.java",0,0.983050847457627,1,1,2
"lucene/highlighter/src/test/org/apache/lucene/search/vectorhighlight/SimpleFragListBuilderTest.java",0,0.518134715025907,2,3,5
"lucene/highlighter/src/test/org/apache/lucene/search/vectorhighlight/SimpleFragmentsBuilderTest.java",0,0.528089887640449,2,4,6
"lucene/highlighter/src/test/org/apache/lucene/search/vectorhighlight/SingleFragListBuilderTest.java",0,0.867924528301887,1,2,3
"lucene/highlighter/src/test/org/apache/lucene/search/vectorhighlight/WeightedFragListBuilderTest.java",0,1,0,1,1
"lucene/join/src/java/org/apache/lucene/search/join/JoinUtil.java",0,0.989130434782609,1,1,2
"lucene/join/src/java/org/apache/lucene/search/join/ScoreMode.java",0,1,0,1,1
"lucene/join/src/java/org/apache/lucene/search/join/TermsCollector.java",0,0.951219512195122,2,1,3
"lucene/join/src/java/org/apache/lucene/search/join/TermsIncludingScoreQuery.java",0,1,0,1,1
"lucene/join/src/java/org/apache/lucene/search/join/TermsQuery.java",0,1,0,1,1
"lucene/join/src/java/org/apache/lucene/search/join/TermsWithScoreCollector.java",0,1,0,1,1
"lucene/join/src/java/org/apache/lucene/search/join/ToChildBlockJoinQuery.java",0,0.988338192419825,3,1,4
"lucene/join/src/java/org/apache/lucene/search/join/ToParentBlockJoinCollector.java",0,0.934782608695652,4,1,5
"lucene/join/src/java/org/apache/lucene/search/join/ToParentBlockJoinQuery.java",0,0.910284463894967,5,1,6
"lucene/join/src/test/org/apache/lucene/search/join/TestBlockJoin.java",0,0.86839481555334,5,2,7
"lucene/join/src/test/org/apache/lucene/search/join/TestJoinUtil.java",0,0.924302788844621,2,2,4
"lucene/memory/src/java/org/apache/lucene/index/memory/MemoryIndex.java",0,0.345454545454545,7,5,12
"lucene/memory/src/java/org/apache/lucene/index/memory/MemoryIndexNormDocValues.java",0,0.979020979020979,2,1,3
"lucene/memory/src/test/org/apache/lucene/index/memory/MemoryIndexTest.java",0,0.520446096654275,4,6,10
"lucene/misc/src/java/org/apache/lucene/document/LazyDocument.java",0,1,0,1,1
"lucene/misc/src/java/org/apache/lucene/index/BalancedSegmentMergePolicy.java",0,0.943661971830986,3,1,4
"lucene/misc/src/java/org/apache/lucene/index/CompoundFileExtractor.java",0,0.962121212121212,2,1,3
"lucene/misc/src/java/org/apache/lucene/index/IndexSplitter.java",0,0.900584795321637,4,2,6
"lucene/misc/src/java/org/apache/lucene/index/MultiPassIndexSplitter.java",0,0.65891472868217,3,3,6
"lucene/misc/src/java/org/apache/lucene/index/PKIndexSplitter.java",0,0.502890173410405,1,3,4
"lucene/misc/src/java/org/apache/lucene/misc/GetTermInfo.java",0,0.919354838709677,3,1,4
"lucene/misc/src/java/org/apache/lucene/misc/HighFreqTerms.java",0,0.622568093385214,3,4,7
"lucene/misc/src/java/org/apache/lucene/misc/IndexMergeTool.java",0,0.706896551724138,3,3,6
"lucene/misc/src/java/org/apache/lucene/misc/SweetSpotSimilarity.java",0,0.818181818181818,4,3,7
"lucene/misc/src/java/org/apache/lucene/misc/TermStats.java",0,0.773584905660377,1,3,4
"lucene/misc/src/java/org/apache/lucene/store/NativePosixUtil.java",0,0.905660377358491,1,2,3
"lucene/misc/src/java/org/apache/lucene/store/NativeUnixDirectory.java",0,0.981609195402299,4,1,5
"lucene/misc/src/java/org/apache/lucene/store/WindowsDirectory.java",0,0.880281690140845,4,2,6
"lucene/misc/src/test/org/apache/lucene/index/TestBalancedSegmentMergePolicy.java",0,0.977011494252874,2,1,3
"lucene/misc/src/test/org/apache/lucene/index/TestIndexSplitter.java",0,0.631578947368421,4,3,7
"lucene/misc/src/test/org/apache/lucene/index/TestMultiPassIndexSplitter.java",0,0.539568345323741,4,3,7
"lucene/misc/src/test/org/apache/lucene/index/TestPKIndexSplitter.java",0,0.584745762711864,4,2,6
"lucene/misc/src/test/org/apache/lucene/misc/SweetSpotSimilarityTest.java",0,0.537634408602151,1,4,5
"lucene/misc/src/test/org/apache/lucene/misc/TestHighFreqTerms.java",0,0.879003558718861,3,2,5
"lucene/queries/src/java/org/apache/lucene/queries/BooleanFilter.java",0,0.458823529411765,2,3,5
"lucene/queries/src/java/org/apache/lucene/queries/BoostingQuery.java",0,0.556390977443609,3,4,7
"lucene/queries/src/java/org/apache/lucene/queries/ChainedFilter.java",0,0.716535433070866,4,4,8
"lucene/queries/src/java/org/apache/lucene/queries/CustomScoreProvider.java",0,0.932515337423313,4,1,5
"lucene/queries/src/java/org/apache/lucene/queries/CustomScoreQuery.java",0,0.514745308310992,7,5,12
"lucene/queries/src/java/org/apache/lucene/queries/FilterClause.java",0,0.634146341463415,2,2,4
"lucene/queries/src/java/org/apache/lucene/queries/TermsFilter.java",0,0.567796610169492,4,3,7
"lucene/queries/src/java/org/apache/lucene/queries/function/BoostedQuery.java",0,0.754807692307692,7,2,9
"lucene/queries/src/java/org/apache/lucene/queries/function/FunctionQuery.java",0,0.820388349514563,8,2,10
"lucene/queries/src/java/org/apache/lucene/queries/function/FunctionValues.java",0,0.868686868686869,5,2,7
"lucene/queries/src/java/org/apache/lucene/queries/function/ValueSource.java",0,0.417910447761194,4,4,8
"lucene/queries/src/java/org/apache/lucene/queries/function/ValueSourceScorer.java",0,0.894117647058824,4,1,5
"lucene/queries/src/java/org/apache/lucene/queries/function/docvalues/BoolDocValues.java",0,0.755102040816326,1,3,4
"lucene/queries/src/java/org/apache/lucene/queries/function/docvalues/DocTermsIndexDocValues.java",0,0.81437125748503,6,2,8
"lucene/queries/src/java/org/apache/lucene/queries/function/docvalues/DoubleDocValues.java",0,0.76530612244898,2,2,4
"lucene/queries/src/java/org/apache/lucene/queries/function/docvalues/FloatDocValues.java",0,0.75,2,2,4
"lucene/queries/src/java/org/apache/lucene/queries/function/docvalues/IntDocValues.java",0,0.741935483870968,1,3,4
"lucene/queries/src/java/org/apache/lucene/queries/function/docvalues/LongDocValues.java",0,0.755102040816326,1,3,4
"lucene/queries/src/java/org/apache/lucene/queries/function/docvalues/StrDocValues.java",0,0.651515151515151,1,3,4
"lucene/queries/src/java/org/apache/lucene/queries/function/valuesource/BoolFunction.java",0,0.84,1,2,3
"lucene/queries/src/java/org/apache/lucene/queries/function/valuesource/ByteFieldSource.java",0,0.563025210084034,6,4,10
"lucene/queries/src/java/org/apache/lucene/queries/function/valuesource/BytesRefFieldSource.java",0,0.929824561403509,1,2,3
"lucene/queries/src/java/org/apache/lucene/queries/function/valuesource/ConstNumberSource.java",0,0.875,1,2,3
"lucene/queries/src/java/org/apache/lucene/queries/function/valuesource/ConstValueSource.java",0,0.873949579831933,3,2,5
"lucene/queries/src/java/org/apache/lucene/queries/function/valuesource/DefFunction.java",0,0.928571428571429,4,1,5
"lucene/queries/src/java/org/apache/lucene/queries/function/valuesource/DivFloatFunction.java",0,0.813953488372093,1,3,4
"lucene/queries/src/java/org/apache/lucene/queries/function/valuesource/DocFreqValueSource.java",0,0.819767441860465,5,2,7
"lucene/queries/src/java/org/apache/lucene/queries/function/valuesource/DoubleConstValueSource.java",0,0.872,3,2,5
"lucene/queries/src/java/org/apache/lucene/queries/function/valuesource/DoubleFieldSource.java",0,0.505952380952381,7,3,10
"lucene/queries/src/java/org/apache/lucene/queries/function/valuesource/DualFloatFunction.java",0,0.797752808988764,4,2,6
"lucene/queries/src/java/org/apache/lucene/queries/function/valuesource/FieldCacheSource.java",0,0.777777777777778,5,2,7
"lucene/queries/src/java/org/apache/lucene/queries/function/valuesource/FloatFieldSource.java",0,0.607142857142857,6,3,9
"lucene/queries/src/java/org/apache/lucene/queries/function/valuesource/IDFValueSource.java",0,0.575757575757576,3,2,5
"lucene/queries/src/java/org/apache/lucene/queries/function/valuesource/IfFunction.java",0,0.913333333333333,5,1,6
"lucene/queries/src/java/org/apache/lucene/queries/function/valuesource/IntFieldSource.java",0,0.715909090909091,6,3,9
"lucene/queries/src/java/org/apache/lucene/queries/function/valuesource/JoinDocFreqValueSource.java",0,0.842696629213483,7,1,8
"lucene/queries/src/java/org/apache/lucene/queries/function/valuesource/LinearFloatFunction.java",0,0.8,5,2,7
"lucene/queries/src/java/org/apache/lucene/queries/function/valuesource/LiteralValueSource.java",0,0.722222222222222,5,2,7
"lucene/queries/src/java/org/apache/lucene/queries/function/valuesource/LongFieldSource.java",0,0.447204968944099,7,4,11
"lucene/queries/src/java/org/apache/lucene/queries/function/valuesource/MaxDocValueSource.java",0,0.824561403508772,3,3,6
"lucene/queries/src/java/org/apache/lucene/queries/function/valuesource/MaxFloatFunction.java",0,0.94,0,2,2
"lucene/queries/src/java/org/apache/lucene/queries/function/valuesource/MinFloatFunction.java",0,0.94,0,2,2
"lucene/queries/src/java/org/apache/lucene/queries/function/valuesource/MultiBoolFunction.java",0,0.916666666666667,4,1,5
"lucene/queries/src/java/org/apache/lucene/queries/function/valuesource/MultiFloatFunction.java",0,0.818181818181818,6,2,8
"lucene/queries/src/java/org/apache/lucene/queries/function/valuesource/MultiFunction.java",0,0.903225806451613,3,2,5
"lucene/queries/src/java/org/apache/lucene/queries/function/valuesource/MultiValueSource.java",0,0.896551724137931,1,2,3
"lucene/queries/src/java/org/apache/lucene/queries/function/valuesource/NormValueSource.java",0,0.732558139534884,5,2,7
"lucene/queries/src/java/org/apache/lucene/queries/function/valuesource/NumDocsValueSource.java",0,0.846153846153846,3,2,5
"lucene/queries/src/java/org/apache/lucene/queries/function/valuesource/NumericIndexDocValueSource.java",0,0.855932203389831,3,2,5
"lucene/queries/src/java/org/apache/lucene/queries/function/valuesource/OrdFieldSource.java",0,0.744186046511628,4,3,7
"lucene/queries/src/java/org/apache/lucene/queries/function/valuesource/PowFloatFunction.java",0,0.822222222222222,1,3,4
"lucene/queries/src/java/org/apache/lucene/queries/function/valuesource/ProductFloatFunction.java",0,0.795454545454545,1,3,4
"lucene/queries/src/java/org/apache/lucene/queries/function/valuesource/QueryValueSource.java",0,0.816733067729084,5,2,7
"lucene/queries/src/java/org/apache/lucene/queries/function/valuesource/RangeMapFloatFunction.java",0,0.725490196078431,5,3,8
"lucene/queries/src/java/org/apache/lucene/queries/function/valuesource/ReciprocalFloatFunction.java",0,0.824074074074074,5,2,7
"lucene/queries/src/java/org/apache/lucene/queries/function/valuesource/ReverseOrdFieldSource.java",0,0.71,6,3,9
"lucene/queries/src/java/org/apache/lucene/queries/function/valuesource/ScaleFloatFunction.java",0,0.849673202614379,5,2,7
"lucene/queries/src/java/org/apache/lucene/queries/function/valuesource/ShortFieldSource.java",0,0.603603603603604,5,3,8
"lucene/queries/src/java/org/apache/lucene/queries/function/valuesource/SimpleBoolFunction.java",0,0.896103896103896,4,1,5
"lucene/queries/src/java/org/apache/lucene/queries/function/valuesource/SimpleFloatFunction.java",0,0.784313725490196,2,3,5
"lucene/queries/src/java/org/apache/lucene/queries/function/valuesource/SingleFunction.java",0,0.864406779661017,3,2,5
"lucene/queries/src/java/org/apache/lucene/queries/function/valuesource/SumFloatFunction.java",0,0.795454545454545,2,3,5
"lucene/queries/src/java/org/apache/lucene/queries/function/valuesource/SumTotalTermFreqValueSource.java",0,0.806451612903226,4,2,6
"lucene/queries/src/java/org/apache/lucene/queries/function/valuesource/TFValueSource.java",0,0.532467532467532,2,3,5
"lucene/queries/src/java/org/apache/lucene/queries/function/valuesource/TermFreqValueSource.java",0,0.671140939597315,2,3,5
"lucene/queries/src/java/org/apache/lucene/queries/function/valuesource/TotalTermFreqValueSource.java",0,0.806451612903226,3,2,5
"lucene/queries/src/java/org/apache/lucene/queries/function/valuesource/VectorValueSource.java",0,0.660633484162896,6,3,9
"lucene/queries/src/java/org/apache/lucene/queries/mlt/MoreLikeThis.java",0,0.773420479302832,8,2,10
"lucene/queries/src/java/org/apache/lucene/queries/mlt/MoreLikeThisQuery.java",0,0.735099337748344,3,2,5
"lucene/queries/src/test/org/apache/lucene/queries/BooleanFilterTest.java",0,0.624260355029586,4,3,7
"lucene/queries/src/test/org/apache/lucene/queries/BoostingQueryTest.java",0,0.848484848484849,1,3,4
"lucene/queries/src/test/org/apache/lucene/queries/ChainedFilterTest.java",0,0.43778801843318,4,5,9
"lucene/queries/src/test/org/apache/lucene/queries/TermsFilterTest.java",0,0.387096774193548,4,4,8
"lucene/queries/src/test/org/apache/lucene/queries/TestCustomScoreQuery.java",0,0.350974930362117,2,5,7
"lucene/queries/src/test/org/apache/lucene/queries/function/FunctionTestSetup.java",0,0.864406779661017,1,2,3
"lucene/queries/src/test/org/apache/lucene/queries/function/TestBoostedQuery.java",0,0.979591836734694,2,1,3
"lucene/queries/src/test/org/apache/lucene/queries/function/TestFieldScoreQuery.java",0,0.932885906040268,2,2,4
"lucene/queries/src/test/org/apache/lucene/queries/function/TestOrdValues.java",0,0.414473684210526,4,4,8
"lucene/queries/src/test/org/apache/lucene/queries/function/TestValueSources.java",0,0.973190348525469,2,1,3
"lucene/queries/src/test/org/apache/lucene/queries/mlt/TestMoreLikeThis.java",0,0.635036496350365,2,3,5
"lucene/queryparser/src/java/org/apache/lucene/queryparser/analyzing/AnalyzingQueryParser.java",0,0.63323782234957,6,3,9
"lucene/queryparser/src/java/org/apache/lucene/queryparser/classic/CharStream.java",0,0.964285714285714,1,1,2
"lucene/queryparser/src/java/org/apache/lucene/queryparser/classic/FastCharStream.java",0,0.983870967741935,2,1,3
"lucene/queryparser/src/java/org/apache/lucene/queryparser/classic/MultiFieldQueryParser.java",0,0.524355300859599,7,4,11
"lucene/queryparser/src/java/org/apache/lucene/queryparser/classic/ParseException.java",0,0.933333333333333,0,2,2
"lucene/queryparser/src/java/org/apache/lucene/queryparser/classic/QueryParser.java",0,0.860742705570292,3,2,5
"lucene/queryparser/src/java/org/apache/lucene/queryparser/classic/QueryParserBase.java",0,0.964196502914238,3,1,4
"lucene/queryparser/src/java/org/apache/lucene/queryparser/classic/QueryParserConstants.java",0,0.766666666666667,2,2,4
"lucene/queryparser/src/java/org/apache/lucene/queryparser/classic/QueryParserTokenManager.java",0,0.723818350324374,3,2,5
"lucene/queryparser/src/java/org/apache/lucene/queryparser/classic/Token.java",0,0.983870967741935,1,1,2
"lucene/queryparser/src/java/org/apache/lucene/queryparser/classic/TokenMgrError.java",0,0.985815602836879,1,1,2
"lucene/queryparser/src/java/org/apache/lucene/queryparser/complexPhrase/ComplexPhraseQueryParser.java",0,0.875311720698254,7,1,8
"lucene/queryparser/src/java/org/apache/lucene/queryparser/ext/ExtendableQueryParser.java",0,0.950704225352113,3,1,4
"lucene/queryparser/src/java/org/apache/lucene/queryparser/ext/ExtensionQuery.java",0,0.96,2,1,3
"lucene/queryparser/src/java/org/apache/lucene/queryparser/ext/Extensions.java",0,0.972602739726027,3,1,4
"lucene/queryparser/src/java/org/apache/lucene/queryparser/ext/ParserExtension.java",0,0.886792452830189,1,2,3
"lucene/queryparser/src/java/org/apache/lucene/queryparser/flexible/core/QueryNodeError.java",0,0.917808219178082,2,2,4
"lucene/queryparser/src/java/org/apache/lucene/queryparser/flexible/core/QueryNodeException.java",0,0.875,4,1,5
"lucene/queryparser/src/java/org/apache/lucene/queryparser/flexible/core/QueryNodeParseException.java",0,0.932773109243697,3,1,4
"lucene/queryparser/src/java/org/apache/lucene/queryparser/flexible/core/QueryParserHelper.java",0,0.965648854961832,2,1,3
"lucene/queryparser/src/java/org/apache/lucene/queryparser/flexible/core/builders/QueryBuilder.java",0,0.886363636363636,1,2,3
"lucene/queryparser/src/java/org/apache/lucene/queryparser/flexible/core/builders/QueryTreeBuilder.java",0,0.874439461883408,3,2,5
"lucene/queryparser/src/java/org/apache/lucene/queryparser/flexible/core/config/AbstractQueryConfig.java",0,0.983050847457627,2,1,3
"lucene/queryparser/src/java/org/apache/lucene/queryparser/flexible/core/config/ConfigurationKey.java",0,0.523809523809524,2,2,4
"lucene/queryparser/src/java/org/apache/lucene/queryparser/flexible/core/config/FieldConfig.java",0,0.741379310344828,3,2,5
"lucene/queryparser/src/java/org/apache/lucene/queryparser/flexible/core/config/FieldConfigListener.java",0,0.5,3,2,5
"lucene/queryparser/src/java/org/apache/lucene/queryparser/flexible/core/config/QueryConfigHandler.java",0,0.8625,2,2,4
"lucene/queryparser/src/java/org/apache/lucene/queryparser/flexible/core/messages/QueryParserMessages.java",0,0.864406779661017,4,2,6
"lucene/queryparser/src/java/org/apache/lucene/queryparser/flexible/core/nodes/AndQueryNode.java",0,0.923076923076923,3,1,4
"lucene/queryparser/src/java/org/apache/lucene/queryparser/flexible/core/nodes/AnyQueryNode.java",0,0.951724137931034,3,1,4
"lucene/queryparser/src/java/org/apache/lucene/queryparser/flexible/core/nodes/BooleanQueryNode.java",0,0.928571428571429,3,1,4
"lucene/queryparser/src/java/org/apache/lucene/queryparser/flexible/core/nodes/BoostQueryNode.java",0,0.909836065573771,4,1,5
"lucene/queryparser/src/java/org/apache/lucene/queryparser/flexible/core/nodes/DeletedQueryNode.java",0,0.865384615384615,2,2,4
"lucene/queryparser/src/java/org/apache/lucene/queryparser/flexible/core/nodes/FieldQueryNode.java",0,0.91578947368421,4,1,5
"lucene/queryparser/src/java/org/apache/lucene/queryparser/flexible/core/nodes/FieldValuePairQueryNode.java",0,0.933333333333333,2,1,3
"lucene/queryparser/src/java/org/apache/lucene/queryparser/flexible/core/nodes/FieldableNode.java",0,0.955555555555556,2,1,3
"lucene/queryparser/src/java/org/apache/lucene/queryparser/flexible/core/nodes/FuzzyQueryNode.java",0,0.939393939393939,3,1,4
"lucene/queryparser/src/java/org/apache/lucene/queryparser/flexible/core/nodes/GroupQueryNode.java",0,0.891566265060241,4,1,5
"lucene/queryparser/src/java/org/apache/lucene/queryparser/flexible/core/nodes/MatchAllDocsQueryNode.java",0,0.877551020408163,2,2,4
"lucene/queryparser/src/java/org/apache/lucene/queryparser/flexible/core/nodes/MatchNoDocsQueryNode.java",0,0.916666666666667,3,1,4
"lucene/queryparser/src/java/org/apache/lucene/queryparser/flexible/core/nodes/ModifierQueryNode.java",0,0.89873417721519,4,1,5
"lucene/queryparser/src/java/org/apache/lucene/queryparser/flexible/core/nodes/NoTokenFoundQueryNode.java",0,0.88,2,2,4
"lucene/queryparser/src/java/org/apache/lucene/queryparser/flexible/core/nodes/OpaqueQueryNode.java",0,0.9375,3,1,4
"lucene/queryparser/src/java/org/apache/lucene/queryparser/flexible/core/nodes/OrQueryNode.java",0,0.935897435897436,3,1,4
"lucene/queryparser/src/java/org/apache/lucene/queryparser/flexible/core/nodes/PathQueryNode.java",0,0.903669724770642,3,2,5
"lucene/queryparser/src/java/org/apache/lucene/queryparser/flexible/core/nodes/PhraseSlopQueryNode.java",0,0.889908256880734,3,2,5
"lucene/queryparser/src/java/org/apache/lucene/queryparser/flexible/core/nodes/ProximityQueryNode.java",0,0.895397489539749,4,2,6
"lucene/queryparser/src/java/org/apache/lucene/queryparser/flexible/core/nodes/QueryNode.java",0,0.81,3,2,5
"lucene/queryparser/src/java/org/apache/lucene/queryparser/flexible/core/nodes/QueryNodeImpl.java",0,0.853448275862069,5,2,7
"lucene/queryparser/src/java/org/apache/lucene/queryparser/flexible/core/nodes/QuotedFieldQueryNode.java",0,0.907692307692308,3,1,4
"lucene/queryparser/src/java/org/apache/lucene/queryparser/flexible/core/nodes/RangeQueryNode.java",0,0.972222222222222,1,1,2
"lucene/queryparser/src/java/org/apache/lucene/queryparser/flexible/core/nodes/SlopQueryNode.java",0,0.913793103448276,4,1,5
"lucene/queryparser/src/java/org/apache/lucene/queryparser/flexible/core/nodes/TextableQueryNode.java",0,0.827586206896552,1,2,3
"lucene/queryparser/src/java/org/apache/lucene/queryparser/flexible/core/nodes/TokenizedPhraseQueryNode.java",0,0.942307692307692,3,1,4
"lucene/queryparser/src/java/org/apache/lucene/queryparser/flexible/core/nodes/ValueQueryNode.java",0,0.933333333333333,2,1,3
"lucene/queryparser/src/java/org/apache/lucene/queryparser/flexible/core/parser/EscapeQuerySyntax.java",0,0.951219512195122,2,1,3
"lucene/queryparser/src/java/org/apache/lucene/queryparser/flexible/core/parser/SyntaxParser.java",0,0.888888888888889,1,2,3
"lucene/queryparser/src/java/org/apache/lucene/queryparser/flexible/core/processors/NoChildOptimizationQueryNodeProcessor.java",0,0.919540229885057,3,1,4
"lucene/queryparser/src/java/org/apache/lucene/queryparser/flexible/core/processors/QueryNodeProcessor.java",0,0.936708860759494,1,2,3
"lucene/queryparser/src/java/org/apache/lucene/queryparser/flexible/core/processors/QueryNodeProcessorImpl.java",0,0.97609561752988,2,1,3
"lucene/queryparser/src/java/org/apache/lucene/queryparser/flexible/core/processors/QueryNodeProcessorPipeline.java",0,0.654605263157895,2,2,4
"lucene/queryparser/src/java/org/apache/lucene/queryparser/flexible/core/processors/RemoveDeletedQueryNodesProcessor.java",0,0.911504424778761,3,1,4
"lucene/queryparser/src/java/org/apache/lucene/queryparser/flexible/core/util/QueryNodeOperation.java",0,0.936842105263158,1,2,3
"lucene/queryparser/src/java/org/apache/lucene/queryparser/flexible/core/util/StringUtils.java",0,0.939393939393939,2,1,3
"lucene/queryparser/src/java/org/apache/lucene/queryparser/flexible/core/util/UnescapedCharSequence.java",0,0.968152866242038,4,1,5
"lucene/queryparser/src/java/org/apache/lucene/queryparser/flexible/messages/Message.java",0,0.944444444444444,2,1,3
"lucene/queryparser/src/java/org/apache/lucene/queryparser/flexible/messages/MessageImpl.java",0,0.985714285714286,1,1,2
"lucene/queryparser/src/java/org/apache/lucene/queryparser/flexible/messages/NLS.java",0,0.951456310679612,2,1,3
"lucene/queryparser/src/java/org/apache/lucene/queryparser/flexible/messages/NLSException.java",0,0.970588235294118,1,1,2
"lucene/queryparser/src/java/org/apache/lucene/queryparser/flexible/precedence/PrecedenceQueryParser.java",0,0.631578947368421,2,3,5
"lucene/queryparser/src/java/org/apache/lucene/queryparser/flexible/precedence/processors/BooleanModifiersQueryNodeProcessor.java",0,0.851851851851852,2,2,4
"lucene/queryparser/src/java/org/apache/lucene/queryparser/flexible/precedence/processors/PrecedenceQueryNodeProcessorPipeline.java",0,0.898305084745763,1,2,3
"lucene/queryparser/src/java/org/apache/lucene/queryparser/flexible/standard/QueryParserUtil.java",0,0.888349514563107,4,2,6
"lucene/queryparser/src/java/org/apache/lucene/queryparser/flexible/standard/StandardQueryParser.java",0,0.523346303501946,4,3,7
"lucene/queryparser/src/java/org/apache/lucene/queryparser/flexible/standard/builders/AnyQueryNodeBuilder.java",0,0.883116883116883,3,2,5
"lucene/queryparser/src/java/org/apache/lucene/queryparser/flexible/standard/builders/BooleanQueryNodeBuilder.java",0,0.881818181818182,3,2,5
"lucene/queryparser/src/java/org/apache/lucene/queryparser/flexible/standard/builders/BoostQueryNodeBuilder.java",0,0.87037037037037,2,2,4
"lucene/queryparser/src/java/org/apache/lucene/queryparser/flexible/standard/builders/DummyQueryNodeBuilder.java",0,0.901960784313726,1,2,3
"lucene/queryparser/src/java/org/apache/lucene/queryparser/flexible/standard/builders/FieldQueryNodeBuilder.java",0,0.86046511627907,2,2,4
"lucene/queryparser/src/java/org/apache/lucene/queryparser/flexible/standard/builders/FuzzyQueryNodeBuilder.java",0,0.75,2,3,5
"lucene/queryparser/src/java/org/apache/lucene/queryparser/flexible/standard/builders/GroupQueryNodeBuilder.java",0,0.844444444444444,2,2,4
"lucene/queryparser/src/java/org/apache/lucene/queryparser/flexible/standard/builders/MatchAllDocsQueryNodeBuilder.java",0,0.788461538461538,2,3,5
"lucene/queryparser/src/java/org/apache/lucene/queryparser/flexible/standard/builders/MatchNoDocsQueryNodeBuilder.java",0,0.788461538461538,2,3,5
"lucene/queryparser/src/java/org/apache/lucene/queryparser/flexible/standard/builders/ModifierQueryNodeBuilder.java",0,0.844444444444444,2,2,4
"lucene/queryparser/src/java/org/apache/lucene/queryparser/flexible/standard/builders/MultiPhraseQueryNodeBuilder.java",0,0.904761904761905,2,2,4
"lucene/queryparser/src/java/org/apache/lucene/queryparser/flexible/standard/builders/NumericRangeQueryNodeBuilder.java",0,0.846153846153846,3,2,5
"lucene/queryparser/src/java/org/apache/lucene/queryparser/flexible/standard/builders/PhraseQueryNodeBuilder.java",0,0.875,2,2,4
"lucene/queryparser/src/java/org/apache/lucene/queryparser/flexible/standard/builders/PrefixWildcardQueryNodeBuilder.java",0,0.830188679245283,3,2,5
"lucene/queryparser/src/java/org/apache/lucene/queryparser/flexible/standard/builders/RegexpQueryNodeBuilder.java",0,0.865384615384615,2,2,4
"lucene/queryparser/src/java/org/apache/lucene/queryparser/flexible/standard/builders/SlopQueryNodeBuilder.java",0,0.87719298245614,2,2,4
"lucene/queryparser/src/java/org/apache/lucene/queryparser/flexible/standard/builders/StandardBooleanQueryNodeBuilder.java",0,0.834862385321101,4,2,6
"lucene/queryparser/src/java/org/apache/lucene/queryparser/flexible/standard/builders/StandardQueryBuilder.java",0,0.810810810810811,2,2,4
"lucene/queryparser/src/java/org/apache/lucene/queryparser/flexible/standard/builders/StandardQueryTreeBuilder.java",0,0.529411764705882,3,4,7
"lucene/queryparser/src/java/org/apache/lucene/queryparser/flexible/standard/builders/TermRangeQueryNodeBuilder.java",0,0.72463768115942,1,3,4
"lucene/queryparser/src/java/org/apache/lucene/queryparser/flexible/standard/builders/WildcardQueryNodeBuilder.java",0,0.788461538461538,2,3,5
"lucene/queryparser/src/java/org/apache/lucene/queryparser/flexible/standard/config/FieldBoostMapFCListener.java",0,0.677966101694915,1,3,4
"lucene/queryparser/src/java/org/apache/lucene/queryparser/flexible/standard/config/FieldDateResolutionFCListener.java",0,0.641791044776119,2,3,5
"lucene/queryparser/src/java/org/apache/lucene/queryparser/flexible/standard/config/FuzzyConfig.java",0,0.521739130434783,2,2,4
"lucene/queryparser/src/java/org/apache/lucene/queryparser/flexible/standard/config/NumberDateFormat.java",0,0.971830985915493,2,1,3
"lucene/queryparser/src/java/org/apache/lucene/queryparser/flexible/standard/config/NumericConfig.java",0,0.949685534591195,3,1,4
"lucene/queryparser/src/java/org/apache/lucene/queryparser/flexible/standard/config/NumericFieldConfigListener.java",0,0.917808219178082,1,2,3
"lucene/queryparser/src/java/org/apache/lucene/queryparser/flexible/standard/config/StandardQueryConfigHandler.java",0,0.70048309178744,3,3,6
"lucene/queryparser/src/java/org/apache/lucene/queryparser/flexible/standard/nodes/AbstractRangeQueryNode.java",0,0.901785714285714,2,2,4
"lucene/queryparser/src/java/org/apache/lucene/queryparser/flexible/standard/nodes/BooleanModifierNode.java",0,0.864864864864865,1,2,3
"lucene/queryparser/src/java/org/apache/lucene/queryparser/flexible/standard/nodes/MultiPhraseQueryNode.java",0,0.925925925925926,3,1,4
"lucene/queryparser/src/java/org/apache/lucene/queryparser/flexible/standard/nodes/NumericQueryNode.java",0,0.959183673469388,2,1,3
"lucene/queryparser/src/java/org/apache/lucene/queryparser/flexible/standard/nodes/NumericRangeQueryNode.java",0,0.901315789473684,2,2,4
"lucene/queryparser/src/java/org/apache/lucene/queryparser/flexible/standard/nodes/PrefixWildcardQueryNode.java",0,0.920634920634921,3,1,4
"lucene/queryparser/src/java/org/apache/lucene/queryparser/flexible/standard/nodes/RegexpQueryNode.java",0,0.934065934065934,1,2,3
"lucene/queryparser/src/java/org/apache/lucene/queryparser/flexible/standard/nodes/StandardBooleanQueryNode.java",0,0.830188679245283,2,3,5
"lucene/queryparser/src/java/org/apache/lucene/queryparser/flexible/standard/nodes/TermRangeQueryNode.java",0,0.933333333333333,2,1,3
"lucene/queryparser/src/java/org/apache/lucene/queryparser/flexible/standard/nodes/WildcardQueryNode.java",0,0.873239436619718,2,2,4
"lucene/queryparser/src/java/org/apache/lucene/queryparser/flexible/standard/parser/EscapeQuerySyntaxImpl.java",0,0.966216216216216,4,1,5
"lucene/queryparser/src/java/org/apache/lucene/queryparser/flexible/standard/parser/JavaCharStream.java",0,0.993506493506494,3,1,4
"lucene/queryparser/src/java/org/apache/lucene/queryparser/flexible/standard/parser/ParseException.java",0,0.974489795918367,3,1,4
"lucene/queryparser/src/java/org/apache/lucene/queryparser/flexible/standard/parser/StandardSyntaxParser.java",0,0.691423519009726,4,2,6
"lucene/queryparser/src/java/org/apache/lucene/queryparser/flexible/standard/parser/StandardSyntaxParserConstants.java",0,0.715447154471545,3,2,5
"lucene/queryparser/src/java/org/apache/lucene/queryparser/flexible/standard/parser/StandardSyntaxParserTokenManager.java",0,0.81340206185567,4,2,6
"lucene/queryparser/src/java/org/apache/lucene/queryparser/flexible/standard/parser/Token.java",0,0.983870967741935,2,1,3
"lucene/queryparser/src/java/org/apache/lucene/queryparser/flexible/standard/parser/TokenMgrError.java",0,0.985815602836879,2,1,3
"lucene/queryparser/src/java/org/apache/lucene/queryparser/flexible/standard/processors/AllowLeadingWildcardProcessor.java",0,0.771428571428571,3,3,6
"lucene/queryparser/src/java/org/apache/lucene/queryparser/flexible/standard/processors/AnalyzerQueryNodeProcessor.java",0,0.823008849557522,5,3,8
"lucene/queryparser/src/java/org/apache/lucene/queryparser/flexible/standard/processors/BooleanSingleChildOptimizationQueryNodeProcessor.java",0,0.868131868131868,2,2,4
"lucene/queryparser/src/java/org/apache/lucene/queryparser/flexible/standard/processors/BoostQueryNodeProcessor.java",0,0.772727272727273,1,3,4
"lucene/queryparser/src/java/org/apache/lucene/queryparser/flexible/standard/processors/DefaultPhraseSlopQueryNodeProcessor.java",0,0.822033898305085,2,3,5
"lucene/queryparser/src/java/org/apache/lucene/queryparser/flexible/standard/processors/FuzzyQueryNodeProcessor.java",0,0.755813953488372,1,3,4
"lucene/queryparser/src/java/org/apache/lucene/queryparser/flexible/standard/processors/GroupQueryNodeProcessor.java",0,0.894495412844037,2,2,4
"lucene/queryparser/src/java/org/apache/lucene/queryparser/flexible/standard/processors/LowercaseExpandedTermsQueryNodeProcessor.java",0,0.666666666666667,3,4,7
"lucene/queryparser/src/java/org/apache/lucene/queryparser/flexible/standard/processors/MatchAllDocsQueryNodeProcessor.java",0,0.857142857142857,2,2,4
"lucene/queryparser/src/java/org/apache/lucene/queryparser/flexible/standard/processors/MultiFieldQueryNodeProcessor.java",0,0.857142857142857,3,2,5
"lucene/queryparser/src/java/org/apache/lucene/queryparser/flexible/standard/processors/MultiTermRewriteMethodProcessor.java",0,0.527027027027027,2,4,6
"lucene/queryparser/src/java/org/apache/lucene/queryparser/flexible/standard/processors/NumericQueryNodeProcessor.java",0,0.718954248366013,1,3,4
"lucene/queryparser/src/java/org/apache/lucene/queryparser/flexible/standard/processors/NumericRangeQueryNodeProcessor.java",0,0.715976331360947,1,3,4
"lucene/queryparser/src/java/org/apache/lucene/queryparser/flexible/standard/processors/OpenRangeQueryNodeProcessor.java",0,0.697368421052632,2,3,5
"lucene/queryparser/src/java/org/apache/lucene/queryparser/flexible/standard/processors/PhraseSlopQueryNodeProcessor.java",0,0.851351351351351,2,2,4
"lucene/queryparser/src/java/org/apache/lucene/queryparser/flexible/standard/processors/RemoveEmptyNonLeafQueryNodeProcessor.java",0,0.896551724137931,2,2,4
"lucene/queryparser/src/java/org/apache/lucene/queryparser/flexible/standard/processors/StandardQueryNodeProcessorPipeline.java",0,0.493150684931507,2,5,7
"lucene/queryparser/src/java/org/apache/lucene/queryparser/flexible/standard/processors/TermRangeQueryNodeProcessor.java",0,0.391025641025641,2,4,6
"lucene/queryparser/src/java/org/apache/lucene/queryparser/flexible/standard/processors/WildcardQueryNodeProcessor.java",0,0.870503597122302,3,2,5
"lucene/queryparser/src/java/org/apache/lucene/queryparser/surround/parser/CharStream.java",0,0.830357142857143,2,2,4
"lucene/queryparser/src/java/org/apache/lucene/queryparser/surround/parser/FastCharStream.java",0,0.933884297520661,3,1,4
"lucene/queryparser/src/java/org/apache/lucene/queryparser/surround/parser/ParseException.java",0,0.924242424242424,2,2,4
"lucene/queryparser/src/java/org/apache/lucene/queryparser/surround/parser/QueryParser.java",0,0.880794701986755,3,2,5
"lucene/queryparser/src/java/org/apache/lucene/queryparser/surround/parser/QueryParserConstants.java",0,0.648351648351648,1,2,3
"lucene/queryparser/src/java/org/apache/lucene/queryparser/surround/parser/QueryParserTokenManager.java",0,0.858543417366947,2,2,4
"lucene/queryparser/src/java/org/apache/lucene/queryparser/surround/parser/Token.java",0,0.548387096774194,2,2,4
"lucene/queryparser/src/java/org/apache/lucene/queryparser/surround/parser/TokenMgrError.java",0,0.858156028368794,2,2,4
"lucene/queryparser/src/java/org/apache/lucene/queryparser/surround/query/AndQuery.java",0,0.705882352941177,4,2,6
"lucene/queryparser/src/java/org/apache/lucene/queryparser/surround/query/BasicQueryFactory.java",0,0.91304347826087,2,2,4
"lucene/queryparser/src/java/org/apache/lucene/queryparser/surround/query/ComposedQuery.java",0,0.859504132231405,4,2,6
"lucene/queryparser/src/java/org/apache/lucene/queryparser/surround/query/DistanceQuery.java",0,0.899082568807339,3,2,5
"lucene/queryparser/src/java/org/apache/lucene/queryparser/surround/query/DistanceRewriteQuery.java",0,0.973684210526316,1,1,2
"lucene/queryparser/src/java/org/apache/lucene/queryparser/surround/query/DistanceSubQuery.java",0,0.741935483870968,2,2,4
"lucene/queryparser/src/java/org/apache/lucene/queryparser/surround/query/FieldsQuery.java",0,0.75,4,3,7
"lucene/queryparser/src/java/org/apache/lucene/queryparser/surround/query/NotQuery.java",0,0.692307692307692,3,3,6
"lucene/queryparser/src/java/org/apache/lucene/queryparser/surround/query/OrQuery.java",0,0.836065573770492,4,2,6
"lucene/queryparser/src/java/org/apache/lucene/queryparser/surround/query/RewriteQuery.java",0,0.975308641975309,2,1,3
"lucene/queryparser/src/java/org/apache/lucene/queryparser/surround/query/SimpleTerm.java",0,0.822916666666667,5,2,7
"lucene/queryparser/src/java/org/apache/lucene/queryparser/surround/query/SimpleTermRewriteQuery.java",0,0.980769230769231,1,1,2
"lucene/queryparser/src/java/org/apache/lucene/queryparser/surround/query/SpanNearClauseFactory.java",0,0.8515625,4,2,6
"lucene/queryparser/src/java/org/apache/lucene/queryparser/surround/query/SrndBooleanQuery.java",0,0.755555555555556,2,3,5
"lucene/queryparser/src/java/org/apache/lucene/queryparser/surround/query/SrndPrefixQuery.java",0,0.505376344086022,5,3,8
"lucene/queryparser/src/java/org/apache/lucene/queryparser/surround/query/SrndQuery.java",0,0.84070796460177,6,2,8
"lucene/queryparser/src/java/org/apache/lucene/queryparser/surround/query/SrndTermQuery.java",0,0.646153846153846,5,3,8
"lucene/queryparser/src/java/org/apache/lucene/queryparser/surround/query/SrndTruncQuery.java",0,0.634920634920635,6,2,8
"lucene/queryparser/src/java/org/apache/lucene/queryparser/surround/query/TooManyBasicQueries.java",0,0.703703703703704,2,2,4
"lucene/queryparser/src/java/org/apache/lucene/queryparser/xml/CoreParser.java",0,0.815286624203822,2,2,4
"lucene/queryparser/src/java/org/apache/lucene/queryparser/xml/CorePlusExtensionsParser.java",0,0.573770491803279,0,3,3
"lucene/queryparser/src/java/org/apache/lucene/queryparser/xml/DOMUtils.java",0,0.867579908675799,1,2,3
"lucene/queryparser/src/java/org/apache/lucene/queryparser/xml/FilterBuilder.java",0,0.806451612903226,0,3,3
"lucene/queryparser/src/java/org/apache/lucene/queryparser/xml/FilterBuilderFactory.java",0,0.510204081632653,0,3,3
"lucene/queryparser/src/java/org/apache/lucene/queryparser/xml/ParserException.java",0,0.854545454545454,0,3,3
"lucene/queryparser/src/java/org/apache/lucene/queryparser/xml/QueryBuilder.java",0,0.928571428571429,2,1,3
"lucene/queryparser/src/java/org/apache/lucene/queryparser/xml/QueryBuilderFactory.java",0,0.5,0,3,3
"lucene/queryparser/src/java/org/apache/lucene/queryparser/xml/QueryTemplateManager.java",0,0.840796019900497,1,2,3
"lucene/queryparser/src/java/org/apache/lucene/queryparser/xml/builders/BooleanFilterBuilder.java",0,0.484375,1,2,3
"lucene/queryparser/src/java/org/apache/lucene/queryparser/xml/builders/BooleanQueryBuilder.java",0,0.622222222222222,1,2,3
"lucene/queryparser/src/java/org/apache/lucene/queryparser/xml/builders/BoostingQueryBuilder.java",0,0.490909090909091,0,3,3
"lucene/queryparser/src/java/org/apache/lucene/queryparser/xml/builders/BoostingTermBuilder.java",0,0.547619047619048,1,3,4
"lucene/queryparser/src/java/org/apache/lucene/queryparser/xml/builders/CachedFilterBuilder.java",0,0.695652173913043,1,2,3
"lucene/queryparser/src/java/org/apache/lucene/queryparser/xml/builders/ConstantScoreQueryBuilder.java",0,0.543478260869565,0,3,3
"lucene/queryparser/src/java/org/apache/lucene/queryparser/xml/builders/DisjunctionMaxQueryBuilder.java",0,0.983333333333333,1,1,2
"lucene/queryparser/src/java/org/apache/lucene/queryparser/xml/builders/DuplicateFilterBuilder.java",0,0.5,0,3,3
"lucene/queryparser/src/java/org/apache/lucene/queryparser/xml/builders/FilteredQueryBuilder.java",0,0.476190476190476,1,2,3
"lucene/queryparser/src/java/org/apache/lucene/queryparser/xml/builders/FuzzyLikeThisQueryBuilder.java",0,0.53030303030303,1,3,4
"lucene/queryparser/src/java/org/apache/lucene/queryparser/xml/builders/LikeThisQueryBuilder.java",0,0.611111111111111,2,2,4
"lucene/queryparser/src/java/org/apache/lucene/queryparser/xml/builders/MatchAllDocsQueryBuilder.java",0,0.606060606060606,0,3,3
"lucene/queryparser/src/java/org/apache/lucene/queryparser/xml/builders/NumericRangeFilterBuilder.java",0,0.573170731707317,2,2,4
"lucene/queryparser/src/java/org/apache/lucene/queryparser/xml/builders/NumericRangeQueryBuilder.java",0,0.68,1,2,3
"lucene/queryparser/src/java/org/apache/lucene/queryparser/xml/builders/RangeFilterBuilder.java",0,0.622222222222222,1,3,4
"lucene/queryparser/src/java/org/apache/lucene/queryparser/xml/builders/SpanBuilderBase.java",0,0.625,0,3,3
"lucene/queryparser/src/java/org/apache/lucene/queryparser/xml/builders/SpanFirstBuilder.java",0,0.468085106382979,0,3,3
"lucene/queryparser/src/java/org/apache/lucene/queryparser/xml/builders/SpanNearBuilder.java",0,0.518518518518518,0,3,3
"lucene/queryparser/src/java/org/apache/lucene/queryparser/xml/builders/SpanNotBuilder.java",0,0.545454545454545,0,3,3
"lucene/queryparser/src/java/org/apache/lucene/queryparser/xml/builders/SpanOrBuilder.java",0,0.5,0,3,3
"lucene/queryparser/src/java/org/apache/lucene/queryparser/xml/builders/SpanOrTermsBuilder.java",0,0.552631578947368,0,4,4
"lucene/queryparser/src/java/org/apache/lucene/queryparser/xml/builders/SpanQueryBuilder.java",0,0.807692307692308,1,2,3
"lucene/queryparser/src/java/org/apache/lucene/queryparser/xml/builders/SpanQueryBuilderFactory.java",0,0.48,0,3,3
"lucene/queryparser/src/java/org/apache/lucene/queryparser/xml/builders/SpanTermBuilder.java",0,0.575,0,3,3
"lucene/queryparser/src/java/org/apache/lucene/queryparser/xml/builders/TermQueryBuilder.java",0,0.625,0,3,3
"lucene/queryparser/src/java/org/apache/lucene/queryparser/xml/builders/TermsFilterBuilder.java",0,0.58974358974359,1,3,4
"lucene/queryparser/src/java/org/apache/lucene/queryparser/xml/builders/TermsQueryBuilder.java",0,0.473684210526316,1,3,4
"lucene/queryparser/src/java/org/apache/lucene/queryparser/xml/builders/UserInputQueryBuilder.java",0,0.634408602150538,1,2,3
"lucene/queryparser/src/test/org/apache/lucene/queryparser/analyzing/TestAnalyzingQueryParser.java",0,0.570422535211268,4,3,7
"lucene/queryparser/src/test/org/apache/lucene/queryparser/classic/TestMultiAnalyzer.java",0,0.453531598513011,4,5,9
"lucene/queryparser/src/test/org/apache/lucene/queryparser/classic/TestMultiFieldQueryParser.java",0,0.577639751552795,7,4,11
"lucene/queryparser/src/test/org/apache/lucene/queryparser/classic/TestMultiPhraseQueryParsing.java",0,0.973451327433628,1,1,2
"lucene/queryparser/src/test/org/apache/lucene/queryparser/classic/TestQueryParser.java",0,0.236842105263158,3,7,10
"lucene/queryparser/src/test/org/apache/lucene/queryparser/complexPhrase/TestComplexPhraseQuery.java",0,0.781456953642384,5,2,7
"lucene/queryparser/src/test/org/apache/lucene/queryparser/ext/ExtensionStub.java",0,0.878787878787879,1,2,3
"lucene/queryparser/src/test/org/apache/lucene/queryparser/ext/TestExtendableQueryParser.java",0,0.865671641791045,4,2,6
"lucene/queryparser/src/test/org/apache/lucene/queryparser/ext/TestExtensions.java",0,0.949367088607595,3,1,4
"lucene/queryparser/src/test/org/apache/lucene/queryparser/flexible/core/builders/TestQueryTreeBuilder.java",0,0.541666666666667,1,3,4
"lucene/queryparser/src/test/org/apache/lucene/queryparser/flexible/core/nodes/TestQueryNode.java",0,0.702127659574468,2,2,4
"lucene/queryparser/src/test/org/apache/lucene/queryparser/flexible/messages/MessagesTestBundle.java",0,0.975,1,1,2
"lucene/queryparser/src/test/org/apache/lucene/queryparser/flexible/messages/TestNLS.java",0,0.669811320754717,1,2,3
"lucene/queryparser/src/test/org/apache/lucene/queryparser/flexible/precedence/TestPrecedenceQueryParser.java",0,0.487616099071207,8,2,10
"lucene/queryparser/src/test/org/apache/lucene/queryparser/flexible/spans/SpanOrQueryNodeBuilder.java",0,0.857142857142857,2,2,4
"lucene/queryparser/src/test/org/apache/lucene/queryparser/flexible/spans/SpanTermQueryNodeBuilder.java",0,0.829268292682927,2,2,4
"lucene/queryparser/src/test/org/apache/lucene/queryparser/flexible/spans/SpansQueryConfigHandler.java",0,0.782608695652174,1,3,4
"lucene/queryparser/src/test/org/apache/lucene/queryparser/flexible/spans/SpansQueryTreeBuilder.java",0,0.807692307692308,3,2,5
"lucene/queryparser/src/test/org/apache/lucene/queryparser/flexible/spans/SpansValidatorQueryNodeProcessor.java",0,0.847222222222222,2,2,4
"lucene/queryparser/src/test/org/apache/lucene/queryparser/flexible/spans/TestSpanQueryParser.java",0,0.891304347826087,6,1,7
"lucene/queryparser/src/test/org/apache/lucene/queryparser/flexible/spans/TestSpanQueryParserSimpleSample.java",0,0.86231884057971,5,2,7
"lucene/queryparser/src/test/org/apache/lucene/queryparser/flexible/spans/UniqueFieldAttribute.java",0,0.914285714285714,1,2,3
"lucene/queryparser/src/test/org/apache/lucene/queryparser/flexible/spans/UniqueFieldAttributeImpl.java",0,0.967032967032967,2,1,3
"lucene/queryparser/src/test/org/apache/lucene/queryparser/flexible/spans/UniqueFieldQueryNodeProcessor.java",0,0.890243902439024,2,2,4
"lucene/queryparser/src/test/org/apache/lucene/queryparser/flexible/standard/TestMultiAnalyzerQPHelper.java",0,0.835341365461847,3,3,6
"lucene/queryparser/src/test/org/apache/lucene/queryparser/flexible/standard/TestMultiFieldQPHelper.java",0,0.828254847645429,5,3,8
"lucene/queryparser/src/test/org/apache/lucene/queryparser/flexible/standard/TestNumericQueryParser.java",0,0.611320754716981,4,3,7
"lucene/queryparser/src/test/org/apache/lucene/queryparser/flexible/standard/TestQPHelper.java",0,0.649546827794562,6,3,9
"lucene/queryparser/src/test/org/apache/lucene/queryparser/surround/query/BooleanQueryTst.java",0,0.547445255474453,4,4,8
"lucene/queryparser/src/test/org/apache/lucene/queryparser/surround/query/ExceptionQueryTst.java",0,0.590909090909091,3,3,6
"lucene/queryparser/src/test/org/apache/lucene/queryparser/surround/query/SingleFieldTestDb.java",0,0.451612903225806,2,4,6
"lucene/queryparser/src/test/org/apache/lucene/queryparser/surround/query/SrndQueryTest.java",0,1,0,1,1
"lucene/queryparser/src/test/org/apache/lucene/queryparser/surround/query/Test01Exceptions.java",0,0.671428571428571,4,2,6
"lucene/queryparser/src/test/org/apache/lucene/queryparser/surround/query/Test02Boolean.java",0,0.78740157480315,5,2,7
"lucene/queryparser/src/test/org/apache/lucene/queryparser/surround/query/Test03Distance.java",0,0.726190476190476,5,3,8
"lucene/queryparser/src/test/org/apache/lucene/queryparser/util/QueryParserTestBase.java",0,0.952346041055719,5,1,6
"lucene/queryparser/src/test/org/apache/lucene/queryparser/xml/TestParser.java",0,0.729166666666667,5,3,8
"lucene/queryparser/src/test/org/apache/lucene/queryparser/xml/TestQueryTemplateManager.java",0,0.708333333333333,3,4,7
"lucene/queryparser/src/test/org/apache/lucene/queryparser/xml/builders/TestNumericRangeFilterBuilder.java",0,0.813953488372093,3,2,5
"lucene/queryparser/src/test/org/apache/lucene/queryparser/xml/builders/TestNumericRangeQueryBuilder.java",0,0.825842696629214,2,2,4
"lucene/sandbox/src/java/org/apache/lucene/sandbox/queries/DuplicateFilter.java",0,0.647058823529412,3,4,7
"lucene/sandbox/src/java/org/apache/lucene/sandbox/queries/FuzzyLikeThisQuery.java",0,0.56020942408377,4,4,8
"lucene/sandbox/src/java/org/apache/lucene/sandbox/queries/SlowCollatedStringComparator.java",0,0.736842105263158,3,2,5
"lucene/sandbox/src/java/org/apache/lucene/sandbox/queries/SlowCollatedTermRangeFilter.java",0,0.959459459459459,2,1,3
"lucene/sandbox/src/java/org/apache/lucene/sandbox/queries/SlowCollatedTermRangeQuery.java",0,0.98876404494382,2,1,3
"lucene/sandbox/src/java/org/apache/lucene/sandbox/queries/SlowCollatedTermRangeTermsEnum.java",0,0.970873786407767,3,1,4
"lucene/sandbox/src/java/org/apache/lucene/sandbox/queries/SlowFuzzyQuery.java",0,0.995098039215686,1,1,2
"lucene/sandbox/src/java/org/apache/lucene/sandbox/queries/SlowFuzzyTermsEnum.java",0,0.995983935742972,1,1,2
"lucene/sandbox/src/java/org/apache/lucene/sandbox/queries/regex/JakartaRegexpCapabilities.java",0,0.364197530864198,3,5,8
"lucene/sandbox/src/java/org/apache/lucene/sandbox/queries/regex/JavaUtilRegexCapabilities.java",0,0.286885245901639,4,4,8
"lucene/sandbox/src/java/org/apache/lucene/sandbox/queries/regex/RegexCapabilities.java",0,0.5,2,3,5
"lucene/sandbox/src/java/org/apache/lucene/sandbox/queries/regex/RegexQuery.java",0,0.393700787401575,3,4,7
"lucene/sandbox/src/java/org/apache/lucene/sandbox/queries/regex/RegexQueryCapable.java",0,0.678571428571429,1,3,4
"lucene/sandbox/src/java/org/apache/lucene/sandbox/queries/regex/RegexTermsEnum.java",0,0.507692307692308,2,5,7
"lucene/sandbox/src/test/org/apache/lucene/sandbox/queries/DuplicateFilterTest.java",0,0.704545454545455,4,3,7
"lucene/sandbox/src/test/org/apache/lucene/sandbox/queries/FuzzyLikeThisQueryTest.java",0,0.674074074074074,6,2,8
"lucene/sandbox/src/test/org/apache/lucene/sandbox/queries/TestSlowCollationMethods.java",0,0.78343949044586,3,3,6
"lucene/sandbox/src/test/org/apache/lucene/sandbox/queries/TestSlowFuzzyQuery.java",0,0.993589743589744,2,1,3
"lucene/sandbox/src/test/org/apache/lucene/sandbox/queries/TestSlowFuzzyQuery2.java",0,0.659340659340659,2,3,5
"lucene/sandbox/src/test/org/apache/lucene/sandbox/queries/regex/TestJakartaRegexpCapabilities.java",0,0.680851063829787,2,2,4
"lucene/sandbox/src/test/org/apache/lucene/sandbox/queries/regex/TestRegexQuery.java",0,0.451851851851852,6,3,9
"lucene/sandbox/src/test/org/apache/lucene/sandbox/queries/regex/TestSpanRegexQuery.java",0,0.317073170731707,4,5,9
"lucene/spatial/src/java/org/apache/lucene/spatial/SimpleSpatialFieldInfo.java",0,1,0,1,1
"lucene/spatial/src/java/org/apache/lucene/spatial/SpatialFieldInfo.java",0,1,0,1,1
"lucene/spatial/src/java/org/apache/lucene/spatial/SpatialStrategy.java",0,1,0,1,1
"lucene/spatial/src/java/org/apache/lucene/spatial/package-info.java",0,1,0,1,1
"lucene/spatial/src/java/org/apache/lucene/spatial/prefix/PointPrefixTreeFieldCacheProvider.java",0,0.976744186046512,1,1,2
"lucene/spatial/src/java/org/apache/lucene/spatial/prefix/PrefixCellsTokenizer.java",0,1,0,1,1
"lucene/spatial/src/java/org/apache/lucene/spatial/prefix/PrefixTreeStrategy.java",0,0.959770114942529,2,1,3
"lucene/spatial/src/java/org/apache/lucene/spatial/prefix/RecursivePrefixTreeFilter.java",0,1,0,1,1
"lucene/spatial/src/java/org/apache/lucene/spatial/prefix/RecursivePrefixTreeStrategy.java",0,0.947368421052632,0,2,2
"lucene/spatial/src/java/org/apache/lucene/spatial/prefix/TermQueryPrefixTreeStrategy.java",0,0.935483870967742,0,2,2
"lucene/spatial/src/java/org/apache/lucene/spatial/prefix/package-info.java",0,1,0,1,1
"lucene/spatial/src/java/org/apache/lucene/spatial/prefix/tree/GeohashPrefixTree.java",0,0.993288590604027,1,1,2
"lucene/spatial/src/java/org/apache/lucene/spatial/prefix/tree/Node.java",0,0.990566037735849,1,1,2
"lucene/spatial/src/java/org/apache/lucene/spatial/prefix/tree/QuadPrefixTree.java",0,0.993311036789298,1,1,2
"lucene/spatial/src/java/org/apache/lucene/spatial/prefix/tree/SpatialPrefixTree.java",0,0.995934959349594,1,1,2
"lucene/spatial/src/java/org/apache/lucene/spatial/prefix/tree/SpatialPrefixTreeFactory.java",0,0.989130434782609,1,1,2
"lucene/spatial/src/java/org/apache/lucene/spatial/prefix/tree/package-info.java",0,0.964285714285714,1,1,2
"lucene/spatial/src/java/org/apache/lucene/spatial/util/CachedDistanceValueSource.java",0,1,0,1,1
"lucene/spatial/src/java/org/apache/lucene/spatial/util/CachingDoubleValueSource.java",0,1,0,1,1
"lucene/spatial/src/java/org/apache/lucene/spatial/util/NumericFieldInfo.java",0,0.979166666666667,1,1,2
"lucene/spatial/src/java/org/apache/lucene/spatial/util/ShapeFieldCache.java",0,1,0,1,1
"lucene/spatial/src/java/org/apache/lucene/spatial/util/ShapeFieldCacheProvider.java",0,1,0,1,1
"lucene/spatial/src/java/org/apache/lucene/spatial/util/StringListTokenizer.java",0,1,0,1,1
"lucene/spatial/src/java/org/apache/lucene/spatial/util/TruncateFilter.java",0,1,0,1,1
"lucene/spatial/src/java/org/apache/lucene/spatial/util/ValueSourceFilter.java",0,1,0,1,1
"lucene/spatial/src/java/org/apache/lucene/spatial/vector/DistanceValueSource.java",0,1,0,1,1
"lucene/spatial/src/java/org/apache/lucene/spatial/vector/TwoDoublesFieldInfo.java",0,1,0,1,1
"lucene/spatial/src/java/org/apache/lucene/spatial/vector/TwoDoublesStrategy.java",0,0.951327433628319,1,1,2
"lucene/spatial/src/test/org/apache/lucene/spatial/SpatialMatchConcern.java",0,1,0,1,1
"lucene/spatial/src/test/org/apache/lucene/spatial/SpatialTestCase.java",0,0.992,1,1,2
"lucene/spatial/src/test/org/apache/lucene/spatial/SpatialTestQuery.java",0,0.954022988505747,1,1,2
"lucene/spatial/src/test/org/apache/lucene/spatial/StrategyTestCase.java",0,0.952380952380952,2,1,3
"lucene/spatial/src/test/org/apache/lucene/spatial/TestTestFramework.java",0,0.875,1,2,3
"lucene/spatial/src/test/org/apache/lucene/spatial/prefix/TestRecursivePrefixTreeStrategy.java",0,0.994623655913978,1,1,2
"lucene/spatial/src/test/org/apache/lucene/spatial/prefix/TestSpatialPrefixField.java",0,0.971014492753623,1,1,2
"lucene/spatial/src/test/org/apache/lucene/spatial/prefix/TestTermQueryPrefixGridStrategy.java",0,0.90625,1,2,3
"lucene/spatial/src/test/org/apache/lucene/spatial/prefix/tree/SpatialPrefixTreeTest.java",0,0.915254237288136,1,2,3
"lucene/spatial/src/test/org/apache/lucene/spatial/vector/TestTwoDoublesStrategy.java",0,0.978723404255319,1,1,2
"lucene/suggest/src/java/org/apache/lucene/search/spell/CombineSuggestion.java",0,0.972972972972973,1,1,2
"lucene/suggest/src/java/org/apache/lucene/search/spell/Dictionary.java",0,0.485714285714286,2,5,7
"lucene/suggest/src/java/org/apache/lucene/search/spell/DirectSpellChecker.java",0,0.958932238193018,4,1,5
"lucene/suggest/src/java/org/apache/lucene/search/spell/HighFrequencyDictionary.java",0,0.543689320388349,3,3,6
"lucene/suggest/src/java/org/apache/lucene/search/spell/JaroWinklerDistance.java",0,0.789855072463768,2,2,4
"lucene/suggest/src/java/org/apache/lucene/search/spell/LevensteinDistance.java",0,0.464,2,4,6
"lucene/suggest/src/java/org/apache/lucene/search/spell/LuceneDictionary.java",0,0.352941176470588,3,6,9
"lucene/suggest/src/java/org/apache/lucene/search/spell/LuceneLevenshteinDistance.java",0,0.991071428571429,1,1,2
"lucene/suggest/src/java/org/apache/lucene/search/spell/NGramDistance.java",0,0.882716049382716,1,2,3
"lucene/suggest/src/java/org/apache/lucene/search/spell/PlainTextDictionary.java",0,0.378947368421053,1,6,7
"lucene/suggest/src/java/org/apache/lucene/search/spell/SpellChecker.java",0,0.313953488372093,8,5,13
"lucene/suggest/src/java/org/apache/lucene/search/spell/StringDistance.java",0,0.942857142857143,2,1,3
"lucene/suggest/src/java/org/apache/lucene/search/spell/SuggestMode.java",0,0.976190476190476,1,1,2
"lucene/suggest/src/java/org/apache/lucene/search/spell/SuggestWord.java",0,0.355555555555556,2,4,6
"lucene/suggest/src/java/org/apache/lucene/search/spell/SuggestWordFrequencyComparator.java",0,0.936170212765957,2,1,3
"lucene/suggest/src/java/org/apache/lucene/search/spell/SuggestWordQueue.java",0,0.428571428571429,4,4,8
"lucene/suggest/src/java/org/apache/lucene/search/spell/SuggestWordScoreComparator.java",0,0.936170212765957,2,1,3
"lucene/suggest/src/java/org/apache/lucene/search/spell/TermFreqIterator.java",0,0.421052631578947,1,3,4
"lucene/suggest/src/java/org/apache/lucene/search/spell/WordBreakSpellChecker.java",0,0.99800796812749,1,1,2
"lucene/suggest/src/java/org/apache/lucene/search/suggest/BufferingTermFreqIteratorWrapper.java",0,0.528571428571429,1,3,4
"lucene/suggest/src/java/org/apache/lucene/search/suggest/BytesRefList.java",0,0.946601941747573,2,1,3
"lucene/suggest/src/java/org/apache/lucene/search/suggest/FileDictionary.java",0,0.588235294117647,2,2,4
"lucene/suggest/src/java/org/apache/lucene/search/suggest/Lookup.java",0,0.444444444444444,2,3,5
"lucene/suggest/src/java/org/apache/lucene/search/suggest/SortedTermFreqIteratorWrapper.java",0,0.857142857142857,2,2,4
"lucene/suggest/src/java/org/apache/lucene/search/suggest/UnsortedTermFreqIteratorWrapper.java",0,0.523809523809524,1,3,4
"lucene/suggest/src/java/org/apache/lucene/search/suggest/fst/BytesRefSorter.java",0,0.509803921568627,1,3,4
"lucene/suggest/src/java/org/apache/lucene/search/suggest/fst/ExternalRefSorter.java",0,0.457142857142857,1,3,4
"lucene/suggest/src/java/org/apache/lucene/search/suggest/fst/FSTCompletion.java",0,0.905940594059406,4,1,5
"lucene/suggest/src/java/org/apache/lucene/search/suggest/fst/FSTCompletionBuilder.java",0,0.87890625,3,2,5
"lucene/suggest/src/java/org/apache/lucene/search/suggest/fst/FSTCompletionLookup.java",0,0.740350877192982,1,3,4
"lucene/suggest/src/java/org/apache/lucene/search/suggest/fst/InMemorySorter.java",0,0.357142857142857,1,3,4
"lucene/suggest/src/java/org/apache/lucene/search/suggest/fst/Sort.java",0,0.80276134122288,2,2,4
"lucene/suggest/src/java/org/apache/lucene/search/suggest/fst/WFSTCompletionLookup.java",0,0.670289855072464,1,2,3
"lucene/suggest/src/java/org/apache/lucene/search/suggest/jaspell/JaspellLookup.java",0,0.563157894736842,1,3,4
"lucene/suggest/src/java/org/apache/lucene/search/suggest/jaspell/JaspellTernarySearchTrie.java",0,0.952436194895592,2,1,3
"lucene/suggest/src/java/org/apache/lucene/search/suggest/tst/TSTAutocomplete.java",0,0.829268292682927,2,2,4
"lucene/suggest/src/java/org/apache/lucene/search/suggest/tst/TSTLookup.java",0,0.558252427184466,1,3,4
"lucene/suggest/src/java/org/apache/lucene/search/suggest/tst/TernaryTreeNode.java",0,0.738095238095238,1,2,3
"lucene/suggest/src/test/org/apache/lucene/search/spell/TestDirectSpellChecker.java",0,0.910112359550562,3,1,4
"lucene/suggest/src/test/org/apache/lucene/search/spell/TestJaroWinklerDistance.java",0,0.938775510204082,2,1,3
"lucene/suggest/src/test/org/apache/lucene/search/spell/TestLevenshteinDistance.java",0,0.685185185185185,2,3,5
"lucene/suggest/src/test/org/apache/lucene/search/spell/TestLuceneDictionary.java",0,0.697916666666667,4,3,7
"lucene/suggest/src/test/org/apache/lucene/search/spell/TestNGramDistance.java",0,0.977272727272727,2,1,3
"lucene/suggest/src/test/org/apache/lucene/search/spell/TestPlainTextDictionary.java",0,0.808510638297872,1,2,3
"lucene/suggest/src/test/org/apache/lucene/search/spell/TestSpellChecker.java",0,0.335820895522388,7,5,12
"lucene/suggest/src/test/org/apache/lucene/search/spell/TestWordBreakSpellChecker.java",0,0.97609561752988,2,1,3
"lucene/suggest/src/test/org/apache/lucene/search/suggest/Average.java",0,0.728571428571429,1,2,3
"lucene/suggest/src/test/org/apache/lucene/search/suggest/LookupBenchmarkTest.java",0,0.786290322580645,3,2,5
"lucene/suggest/src/test/org/apache/lucene/search/suggest/PersistenceTest.java",0,0.479591836734694,1,4,5
"lucene/suggest/src/test/org/apache/lucene/search/suggest/TermFreq.java",0,0.323529411764706,1,4,5
"lucene/suggest/src/test/org/apache/lucene/search/suggest/TermFreqArrayIterator.java",0,0.393939393939394,1,4,5
"lucene/suggest/src/test/org/apache/lucene/search/suggest/TestBytesRefList.java",0,0.94392523364486,2,1,3
"lucene/suggest/src/test/org/apache/lucene/search/suggest/TestHighFrequencyDictionary.java",0,0.930232558139535,3,1,4
"lucene/suggest/src/test/org/apache/lucene/search/suggest/TestTermFreqIterator.java",0,0.485294117647059,2,2,4
"lucene/suggest/src/test/org/apache/lucene/search/suggest/fst/BytesRefSortersTest.java",0,0.564516129032258,1,3,4
"lucene/suggest/src/test/org/apache/lucene/search/suggest/fst/FSTCompletionTest.java",0,0.874045801526718,2,2,4
"lucene/suggest/src/test/org/apache/lucene/search/suggest/fst/LargeInputFST.java",0,0.716666666666667,1,2,3
"lucene/suggest/src/test/org/apache/lucene/search/suggest/fst/TestSort.java",0,0.626373626373626,2,3,5
"lucene/suggest/src/test/org/apache/lucene/search/suggest/fst/WFSTCompletionTest.java",0,0.839160839160839,2,2,4
"lucene/test-framework/src/java/org/apache/lucene/analysis/BaseTokenStreamTestCase.java",0,0.358225108225108,2,5,7
"lucene/test-framework/src/java/org/apache/lucene/analysis/CannedTokenStream.java",0,0.919354838709677,1,2,3
"lucene/test-framework/src/java/org/apache/lucene/analysis/CollationTestBase.java",0,0.634375,4,2,6
"lucene/test-framework/src/java/org/apache/lucene/analysis/EmptyTokenizer.java",0,0.972222222222222,1,1,2
"lucene/test-framework/src/java/org/apache/lucene/analysis/LookaheadTokenFilter.java",0,0.996415770609319,1,1,2
"lucene/test-framework/src/java/org/apache/lucene/analysis/MockAnalyzer.java",0,0.821656050955414,5,2,7
"lucene/test-framework/src/java/org/apache/lucene/analysis/MockCharFilter.java",0,0.972477064220184,2,1,3
"lucene/test-framework/src/java/org/apache/lucene/analysis/MockFixedLengthPayloadFilter.java",0,0.927272727272727,1,2,3
"lucene/test-framework/src/java/org/apache/lucene/analysis/MockGraphTokenFilter.java",0,0.991228070175439,1,1,2
"lucene/test-framework/src/java/org/apache/lucene/analysis/MockHoleInjectingTokenFilter.java",0,0.9875,1,1,2
"lucene/test-framework/src/java/org/apache/lucene/analysis/MockPayloadAnalyzer.java",0,0.903225806451613,5,1,6
"lucene/test-framework/src/java/org/apache/lucene/analysis/MockRandomLookaheadTokenFilter.java",0,0.898989898989899,1,2,3
"lucene/test-framework/src/java/org/apache/lucene/analysis/MockReaderWrapper.java",0,0.989795918367347,1,1,2
"lucene/test-framework/src/java/org/apache/lucene/analysis/MockTokenFilter.java",0,0.990825688073395,1,1,2
"lucene/test-framework/src/java/org/apache/lucene/analysis/MockTokenizer.java",0,0.918181818181818,1,2,3
"lucene/test-framework/src/java/org/apache/lucene/analysis/MockVariableLengthPayloadFilter.java",0,0.907407407407407,1,2,3
"lucene/test-framework/src/java/org/apache/lucene/analysis/TokenStreamToDot.java",0,0.987421383647799,2,1,3
"lucene/test-framework/src/java/org/apache/lucene/analysis/ValidatingTokenFilter.java",0,0.888198757763975,1,2,3
"lucene/test-framework/src/java/org/apache/lucene/analysis/VocabularyAssert.java",0,0.987951807228916,1,1,2
"lucene/test-framework/src/java/org/apache/lucene/codecs/lucene3x/PreFlexRWCodec.java",0,0.735849056603774,1,2,3
"lucene/test-framework/src/java/org/apache/lucene/codecs/lucene3x/PreFlexRWFieldInfosFormat.java",0,0.902439024390244,1,2,3
"lucene/test-framework/src/java/org/apache/lucene/codecs/lucene3x/PreFlexRWFieldInfosReader.java",0,0.928571428571429,1,2,3
"lucene/test-framework/src/java/org/apache/lucene/codecs/lucene3x/PreFlexRWFieldInfosWriter.java",0,0.836734693877551,1,2,3
"lucene/test-framework/src/java/org/apache/lucene/codecs/lucene3x/PreFlexRWFieldsWriter.java",0,0.794642857142857,3,2,5
"lucene/test-framework/src/java/org/apache/lucene/codecs/lucene3x/PreFlexRWNormsConsumer.java",0,0.976430976430976,3,1,4
"lucene/test-framework/src/java/org/apache/lucene/codecs/lucene3x/PreFlexRWNormsFormat.java",0,0.628571428571429,2,2,4
"lucene/test-framework/src/java/org/apache/lucene/codecs/lucene3x/PreFlexRWPostingsFormat.java",0,0.567567567567568,2,2,4
"lucene/test-framework/src/java/org/apache/lucene/codecs/lucene3x/PreFlexRWSegmentInfoFormat.java",0,0.78125,3,2,5
"lucene/test-framework/src/java/org/apache/lucene/codecs/lucene3x/PreFlexRWSegmentInfoWriter.java",0,0.688888888888889,1,3,4
"lucene/test-framework/src/java/org/apache/lucene/codecs/lucene3x/PreFlexRWSkipListWriter.java",0,0.992125984251969,1,1,2
"lucene/test-framework/src/java/org/apache/lucene/codecs/lucene3x/PreFlexRWStoredFieldsFormat.java",0,0.878787878787879,1,2,3
"lucene/test-framework/src/java/org/apache/lucene/codecs/lucene3x/PreFlexRWStoredFieldsWriter.java",0,0.987179487179487,1,1,2
"lucene/test-framework/src/java/org/apache/lucene/codecs/lucene3x/PreFlexRWTermVectorsFormat.java",0,0.983870967741935,1,1,2
"lucene/test-framework/src/java/org/apache/lucene/codecs/lucene3x/PreFlexRWTermVectorsWriter.java",0,0.995475113122172,1,1,2
"lucene/test-framework/src/java/org/apache/lucene/codecs/lucene3x/TermInfosWriter.java",0,0.633451957295374,2,3,5
"lucene/test-framework/src/java/org/apache/lucene/codecs/lucene40ords/Lucene40WithOrds.java",0,0.533333333333333,2,3,5
"lucene/test-framework/src/java/org/apache/lucene/codecs/mockintblock/MockFixedIntBlockPostingsFormat.java",0,0.415,2,4,6
"lucene/test-framework/src/java/org/apache/lucene/codecs/mockintblock/MockVariableIntBlockPostingsFormat.java",0,0.68609865470852,2,3,5
"lucene/test-framework/src/java/org/apache/lucene/codecs/mockrandom/MockRandomPostingsFormat.java",0,0.817518248175182,3,2,5
"lucene/test-framework/src/java/org/apache/lucene/codecs/mocksep/MockSepDocValuesFormat.java",0,0.978260869565217,1,1,2
"lucene/test-framework/src/java/org/apache/lucene/codecs/mocksep/MockSepPostingsFormat.java",0,0.645669291338583,2,3,5
"lucene/test-framework/src/java/org/apache/lucene/codecs/mocksep/MockSingleIntFactory.java",0,0.710526315789474,2,3,5
"lucene/test-framework/src/java/org/apache/lucene/codecs/mocksep/MockSingleIntIndexInput.java",0,0.833333333333333,3,3,6
"lucene/test-framework/src/java/org/apache/lucene/codecs/mocksep/MockSingleIntIndexOutput.java",0,0.701923076923077,2,4,6
"lucene/test-framework/src/java/org/apache/lucene/codecs/nestedpulsing/NestedPulsingPostingsFormat.java",0,0.927835051546392,1,2,3
"lucene/test-framework/src/java/org/apache/lucene/codecs/ramonly/RAMOnlyPostingsFormat.java",0,0.942372881355932,3,2,5
"lucene/test-framework/src/java/org/apache/lucene/index/AlcoholicMergePolicy.java",0,0.918604651162791,0,2,2
"lucene/test-framework/src/java/org/apache/lucene/index/DocHelper.java",0,0.322884012539185,5,6,11
"lucene/test-framework/src/java/org/apache/lucene/index/FieldFilterAtomicReader.java",0,0.91566265060241,3,1,4
"lucene/test-framework/src/java/org/apache/lucene/index/MockIndexInput.java",0,0.9,2,2,4
"lucene/test-framework/src/java/org/apache/lucene/index/MockRandomMergePolicy.java",0,0.947368421052632,3,1,4
"lucene/test-framework/src/java/org/apache/lucene/index/RandomCodec.java",0,0.7578125,3,2,5
"lucene/test-framework/src/java/org/apache/lucene/index/RandomDocumentsWriterPerThreadPool.java",0,0.955555555555556,3,1,4
"lucene/test-framework/src/java/org/apache/lucene/index/RandomIndexWriter.java",0,0.590308370044053,2,3,5
"lucene/test-framework/src/java/org/apache/lucene/index/ThreadedIndexingAndSearchingTestCase.java",0,0.958904109589041,4,1,5
"lucene/test-framework/src/java/org/apache/lucene/search/AssertingIndexSearcher.java",0,0.844827586206897,1,2,3
"lucene/test-framework/src/java/org/apache/lucene/search/CheckHits.java",0,0.299047619047619,6,6,12
"lucene/test-framework/src/java/org/apache/lucene/search/QueryUtils.java",0,0.252232142857143,2,5,7
"lucene/test-framework/src/java/org/apache/lucene/search/RandomSimilarityProvider.java",0,0.993975903614458,1,1,2
"lucene/test-framework/src/java/org/apache/lucene/search/SearchEquivalenceTestBase.java",0,0.947368421052632,3,1,4
"lucene/test-framework/src/java/org/apache/lucene/search/ShardSearchingTestBase.java",0,0.916393442622951,4,2,6
"lucene/test-framework/src/java/org/apache/lucene/store/MockDirectoryWrapper.java",0,0.543922984356197,3,4,7
"lucene/test-framework/src/java/org/apache/lucene/store/MockIndexInputWrapper.java",0,0.574585635359116,4,3,7
"lucene/test-framework/src/java/org/apache/lucene/store/MockIndexOutputWrapper.java",0,0.511904761904762,1,4,5
"lucene/test-framework/src/java/org/apache/lucene/store/MockLockFactoryWrapper.java",0,0.945054945054945,2,1,3
"lucene/test-framework/src/java/org/apache/lucene/store/_TestHelper.java",0,0.984615384615385,1,1,2
"lucene/test-framework/src/java/org/apache/lucene/util/AbstractBeforeAfterRule.java",0,0.73015873015873,1,2,3
"lucene/test-framework/src/java/org/apache/lucene/util/CloseableDirectory.java",0,0.981481481481482,1,1,2
"lucene/test-framework/src/java/org/apache/lucene/util/CloseableFile.java",0,0.979166666666667,1,1,2
"lucene/test-framework/src/java/org/apache/lucene/util/English.java",0,0.713513513513514,4,2,6
"lucene/test-framework/src/java/org/apache/lucene/util/FailOnNonBulkMergesInfoStream.java",0,0.58974358974359,1,2,3
"lucene/test-framework/src/java/org/apache/lucene/util/LineFileDocs.java",0,0.714285714285714,3,2,5
"lucene/test-framework/src/java/org/apache/lucene/util/LuceneJUnit3MethodProvider.java",0,0.98,1,1,2
"lucene/test-framework/src/java/org/apache/lucene/util/LuceneTestCase.java",0,0.414893617021277,5,4,9
"lucene/test-framework/src/java/org/apache/lucene/util/NullInfoStream.java",0,0.568181818181818,2,2,4
"lucene/test-framework/src/java/org/apache/lucene/util/Rethrow.java",0,0.911111111111111,3,1,4
"lucene/test-framework/src/java/org/apache/lucene/util/RollingBuffer.java",0,0.992307692307692,1,1,2
"lucene/test-framework/src/java/org/apache/lucene/util/RunListenerPrintReproduceInfo.java",0,0.989189189189189,2,1,3
"lucene/test-framework/src/java/org/apache/lucene/util/TestRuleAssertionsRequired.java",0,0.98,1,1,2
"lucene/test-framework/src/java/org/apache/lucene/util/TestRuleFieldCacheSanity.java",0,0.721311475409836,1,2,3
"lucene/test-framework/src/java/org/apache/lucene/util/TestRuleIcuHack.java",0,0.690909090909091,1,2,3
"lucene/test-framework/src/java/org/apache/lucene/util/TestRuleIgnoreTestSuites.java",0,0.985074626865672,1,1,2
"lucene/test-framework/src/java/org/apache/lucene/util/TestRuleMarkFailure.java",0,0.990476190476191,1,1,2
"lucene/test-framework/src/java/org/apache/lucene/util/TestRuleNoInstanceHooksOverrides.java",0,0.990566037735849,1,1,2
"lucene/test-framework/src/java/org/apache/lucene/util/TestRuleNoStaticHooksShadowing.java",0,0.98936170212766,1,1,2
"lucene/test-framework/src/java/org/apache/lucene/util/TestRuleReportUncaughtExceptions.java",0,0.863636363636364,1,2,3
"lucene/test-framework/src/java/org/apache/lucene/util/TestRuleSetupAndRestoreClassEnv.java",0,0.824175824175824,2,2,4
"lucene/test-framework/src/java/org/apache/lucene/util/TestRuleSetupAndRestoreInstanceEnv.java",0,0.972222222222222,1,1,2
"lucene/test-framework/src/java/org/apache/lucene/util/TestRuleSetupTeardownChained.java",0,0.984126984126984,1,1,2
"lucene/test-framework/src/java/org/apache/lucene/util/TestRuleStoreClassName.java",0,0.696428571428571,1,2,3
"lucene/test-framework/src/java/org/apache/lucene/util/TestRuleThreadAndTestName.java",0,0.696428571428571,1,2,3
"lucene/test-framework/src/java/org/apache/lucene/util/ThrottledIndexOutput.java",0,0.940789473684211,3,1,4
"lucene/test-framework/src/java/org/apache/lucene/util/_TestUtil.java",0,0.41879468845761,8,5,13
"lucene/test-framework/src/java/org/apache/lucene/util/automaton/AutomatonTestUtil.java",0,0.763157894736842,1,2,3
"lucene/test-framework/src/java/org/apache/lucene/util/automaton/DaciukMihovAutomatonBuilder.java",0,0.991689750692521,2,1,3
"lucene/tools/src/java/org/apache/lucene/validation/LicenseCheckTask.java",0,0.624113475177305,0,3,3
"lucene/tools/src/java/org/apache/lucene/validation/LicenseType.java",0,0.763157894736842,2,2,4
"solr/contrib/analysis-extras/src/java/org/apache/solr/analysis/ICUCollationKeyFilterFactory.java",0,0.979381443298969,2,1,3
"solr/contrib/analysis-extras/src/java/org/apache/solr/analysis/ICUFoldingFilterFactory.java",0,0.756756756756757,1,3,4
"solr/contrib/analysis-extras/src/java/org/apache/solr/analysis/ICUNormalizer2FilterFactory.java",0,0.897727272727273,2,2,4
"solr/contrib/analysis-extras/src/java/org/apache/solr/analysis/ICUTokenizerFactory.java",0,0.909090909090909,1,2,3
"solr/contrib/analysis-extras/src/java/org/apache/solr/analysis/ICUTransformFilterFactory.java",0,0.918918918918919,1,2,3
"solr/contrib/analysis-extras/src/java/org/apache/solr/analysis/MorfologikFilterFactory.java",0,0.963414634146341,2,1,3
"solr/contrib/analysis-extras/src/java/org/apache/solr/analysis/SmartChineseSentenceTokenizerFactory.java",0,0.911764705882353,1,2,3
"solr/contrib/analysis-extras/src/java/org/apache/solr/analysis/SmartChineseWordTokenFilterFactory.java",0,0.921052631578947,1,2,3
"solr/contrib/analysis-extras/src/java/org/apache/solr/analysis/StempelPolishStemFilterFactory.java",0,0.9,1,2,3
"solr/contrib/analysis-extras/src/java/org/apache/solr/schema/ICUCollationField.java",0,0.963898916967509,3,1,4
"solr/contrib/analysis-extras/src/test/org/apache/solr/analysis/TestFoldingMultitermExtrasQuery.java",0,0.902439024390244,0,2,2
"solr/contrib/analysis-extras/src/test/org/apache/solr/analysis/TestICUCollationKeyFilterFactory.java",0,0.989208633093525,2,1,3
"solr/contrib/analysis-extras/src/test/org/apache/solr/analysis/TestICUCollationKeyRangeQueries.java",0,0.988095238095238,1,1,2
"solr/contrib/analysis-extras/src/test/org/apache/solr/analysis/TestICUFoldingFilterFactory.java",0,0.875,1,2,3
"solr/contrib/analysis-extras/src/test/org/apache/solr/analysis/TestICUNormalizer2FilterFactory.java",0,0.804347826086957,1,2,3
"solr/contrib/analysis-extras/src/test/org/apache/solr/analysis/TestICUTokenizerFactory.java",0,0.916666666666667,1,2,3
"solr/contrib/analysis-extras/src/test/org/apache/solr/analysis/TestICUTransformFilterFactory.java",0,0.907692307692308,1,2,3
"solr/contrib/analysis-extras/src/test/org/apache/solr/analysis/TestMorfologikFilterFactory.java",0,0.888888888888889,1,2,3
"solr/contrib/analysis-extras/src/test/org/apache/solr/analysis/TestSmartChineseFactories.java",0,0.913793103448276,2,2,4
"solr/contrib/analysis-extras/src/test/org/apache/solr/analysis/TestStempelPolishStemFilterFactory.java",0,0.897435897435897,1,2,3
"solr/contrib/analysis-extras/src/test/org/apache/solr/schema/TestICUCollationField.java",0,0.983870967741935,2,1,3
"solr/contrib/analysis-extras/src/test/org/apache/solr/schema/TestICUCollationFieldOptions.java",0,0.991452991452991,1,1,2
"solr/contrib/clustering/src/java/org/apache/solr/handler/clustering/ClusteringComponent.java",0,0.655172413793103,3,2,5
"solr/contrib/clustering/src/java/org/apache/solr/handler/clustering/ClusteringEngine.java",0,0.6,1,2,3
"solr/contrib/clustering/src/java/org/apache/solr/handler/clustering/ClusteringParams.java",0,0.972972972972973,1,1,2
"solr/contrib/clustering/src/java/org/apache/solr/handler/clustering/DocumentClusteringEngine.java",0,0.980392156862745,1,1,2
"solr/contrib/clustering/src/java/org/apache/solr/handler/clustering/SearchClusteringEngine.java",0,0.483333333333333,2,2,4
"solr/contrib/clustering/src/java/org/apache/solr/handler/clustering/carrot2/CarrotClusteringEngine.java",0,0.477272727272727,3,5,8
"solr/contrib/clustering/src/java/org/apache/solr/handler/clustering/carrot2/CarrotParams.java",0,0.608695652173913,2,2,4
"solr/contrib/clustering/src/java/org/apache/solr/handler/clustering/carrot2/LuceneCarrot2StemmerFactory.java",0,0.995850622406639,1,1,2
"solr/contrib/clustering/src/java/org/apache/solr/handler/clustering/carrot2/LuceneCarrot2TokenizerFactory.java",0,0.993589743589744,1,1,2
"solr/contrib/clustering/src/java/org/apache/solr/handler/clustering/carrot2/SolrStopwordsCarrot2LexicalDataFactory.java",0,0.985714285714286,2,1,3
"solr/contrib/clustering/src/test/org/apache/solr/handler/clustering/AbstractClusteringTestCase.java",0,0.384937238493724,3,3,6
"solr/contrib/clustering/src/test/org/apache/solr/handler/clustering/ClusteringComponentTest.java",0,0.759036144578313,3,2,5
"solr/contrib/clustering/src/test/org/apache/solr/handler/clustering/DistributedClusteringComponentTest.java",0,0.961538461538462,2,1,3
"solr/contrib/clustering/src/test/org/apache/solr/handler/clustering/MockDocumentClusteringEngine.java",0,0.487179487179487,1,3,4
"solr/contrib/clustering/src/test/org/apache/solr/handler/clustering/carrot2/CarrotClusteringEngineTest.java",0,0.66798418972332,3,3,6
"solr/contrib/clustering/src/test/org/apache/solr/handler/clustering/carrot2/DuplicatingStemmerFactory.java",0,0.970588235294118,1,1,2
"solr/contrib/clustering/src/test/org/apache/solr/handler/clustering/carrot2/DuplicatingTokenizerFactory.java",0,0.980769230769231,1,1,2
"solr/contrib/clustering/src/test/org/apache/solr/handler/clustering/carrot2/EchoClusteringAlgorithm.java",0,0.987179487179487,1,1,2
"solr/contrib/clustering/src/test/org/apache/solr/handler/clustering/carrot2/EchoStemsClusteringAlgorithm.java",0,0.986666666666667,1,1,2
"solr/contrib/clustering/src/test/org/apache/solr/handler/clustering/carrot2/EchoTokensClusteringAlgorithm.java",0,0.985507246376812,1,1,2
"solr/contrib/clustering/src/test/org/apache/solr/handler/clustering/carrot2/LexicalResourcesCheckClusteringAlgorithm.java",0,0.9875,1,1,2
"solr/contrib/clustering/src/test/org/apache/solr/handler/clustering/carrot2/MockClusteringAlgorithm.java",0,0.655913978494624,1,3,4
"solr/contrib/dataimporthandler-extras/src/java/org/apache/solr/handler/dataimport/MailEntityProcessor.java",0,0.959216965742251,8,1,9
"solr/contrib/dataimporthandler-extras/src/java/org/apache/solr/handler/dataimport/TikaEntityProcessor.java",0,0.857142857142857,5,2,7
"solr/contrib/dataimporthandler-extras/src/test/org/apache/solr/handler/dataimport/TestMailEntityProcessor.java",0,0.839195979899497,3,3,6
"solr/contrib/dataimporthandler-extras/src/test/org/apache/solr/handler/dataimport/TestTikaEntityProcessor.java",0,0.485714285714286,3,2,5
"solr/contrib/dataimporthandler/src/java/org/apache/solr/handler/dataimport/BinContentStreamDataSource.java",0,0.957142857142857,3,1,4
"solr/contrib/dataimporthandler/src/java/org/apache/solr/handler/dataimport/BinFileDataSource.java",0,0.969230769230769,2,1,3
"solr/contrib/dataimporthandler/src/java/org/apache/solr/handler/dataimport/BinURLDataSource.java",0,0.980582524271845,2,1,3
"solr/contrib/dataimporthandler/src/java/org/apache/solr/handler/dataimport/CachePropertyUtil.java",0,0.653061224489796,1,2,3
"solr/contrib/dataimporthandler/src/java/org/apache/solr/handler/dataimport/CachedSqlEntityProcessor.java",0,0.780487804878049,1,2,3
"solr/contrib/dataimporthandler/src/java/org/apache/solr/handler/dataimport/ClobTransformer.java",0,0.964285714285714,3,1,4
"solr/contrib/dataimporthandler/src/java/org/apache/solr/handler/dataimport/ConfigParseUtil.java",0,0.986301369863014,1,1,2
"solr/contrib/dataimporthandler/src/java/org/apache/solr/handler/dataimport/ContentStreamDataSource.java",0,0.927536231884058,3,1,4
"solr/contrib/dataimporthandler/src/java/org/apache/solr/handler/dataimport/Context.java",0,0.937219730941704,1,2,3
"solr/contrib/dataimporthandler/src/java/org/apache/solr/handler/dataimport/ContextImpl.java",0,0.6640625,1,5,6
"solr/contrib/dataimporthandler/src/java/org/apache/solr/handler/dataimport/DIHCache.java",0,0.833333333333333,0,2,2
"solr/contrib/dataimporthandler/src/java/org/apache/solr/handler/dataimport/DIHCacheSupport.java",0,0.815384615384615,1,3,4
"solr/contrib/dataimporthandler/src/java/org/apache/solr/handler/dataimport/DIHLogLevels.java",0,0.727272727272727,1,2,3
"solr/contrib/dataimporthandler/src/java/org/apache/solr/handler/dataimport/DIHPropertiesWriter.java",0,0.625,1,2,3
"solr/contrib/dataimporthandler/src/java/org/apache/solr/handler/dataimport/DIHWriter.java",0,0.819047619047619,3,2,5
"solr/contrib/dataimporthandler/src/java/org/apache/solr/handler/dataimport/DIHWriterBase.java",0,0.622222222222222,1,2,3
"solr/contrib/dataimporthandler/src/java/org/apache/solr/handler/dataimport/DataImportHandler.java",0,0.832853025936599,8,3,11
"solr/contrib/dataimporthandler/src/java/org/apache/solr/handler/dataimport/DataImportHandlerException.java",0,0.987012987012987,1,1,2
"solr/contrib/dataimporthandler/src/java/org/apache/solr/handler/dataimport/DataImporter.java",0,0.6484375,9,2,11
"solr/contrib/dataimporthandler/src/java/org/apache/solr/handler/dataimport/DataSource.java",0,0.971830985915493,2,1,3
"solr/contrib/dataimporthandler/src/java/org/apache/solr/handler/dataimport/DateFormatTransformer.java",0,0.82,4,2,6
"solr/contrib/dataimporthandler/src/java/org/apache/solr/handler/dataimport/DebugInfo.java",0,0.972972972972973,1,1,2
"solr/contrib/dataimporthandler/src/java/org/apache/solr/handler/dataimport/DebugLogger.java",0,0.775438596491228,2,3,5
"solr/contrib/dataimporthandler/src/java/org/apache/solr/handler/dataimport/DocBuilder.java",0,0.580882352941177,7,3,10
"solr/contrib/dataimporthandler/src/java/org/apache/solr/handler/dataimport/EntityProcessor.java",0,0.96551724137931,2,1,3
"solr/contrib/dataimporthandler/src/java/org/apache/solr/handler/dataimport/EntityProcessorBase.java",0,0.60377358490566,4,2,6
"solr/contrib/dataimporthandler/src/java/org/apache/solr/handler/dataimport/EntityProcessorWrapper.java",0,0.7217125382263,3,3,6
"solr/contrib/dataimporthandler/src/java/org/apache/solr/handler/dataimport/Evaluator.java",0,0.934782608695652,2,1,3
"solr/contrib/dataimporthandler/src/java/org/apache/solr/handler/dataimport/EvaluatorBag.java",0,0.878980891719745,5,1,6
"solr/contrib/dataimporthandler/src/java/org/apache/solr/handler/dataimport/EventListener.java",0,0.971428571428571,1,1,2
"solr/contrib/dataimporthandler/src/java/org/apache/solr/handler/dataimport/FieldReaderDataSource.java",0,0.823529411764706,3,3,6
"solr/contrib/dataimporthandler/src/java/org/apache/solr/handler/dataimport/FieldStreamDataSource.java",0,0.938144329896907,3,1,4
"solr/contrib/dataimporthandler/src/java/org/apache/solr/handler/dataimport/FileDataSource.java",0,0.855072463768116,3,2,5
"solr/contrib/dataimporthandler/src/java/org/apache/solr/handler/dataimport/FileListEntityProcessor.java",0,0.948979591836735,5,1,6
"solr/contrib/dataimporthandler/src/java/org/apache/solr/handler/dataimport/HTMLStripTransformer.java",0,0.947916666666667,4,1,5
"solr/contrib/dataimporthandler/src/java/org/apache/solr/handler/dataimport/HttpDataSource.java",0,0.974358974358974,1,1,2
"solr/contrib/dataimporthandler/src/java/org/apache/solr/handler/dataimport/JdbcDataSource.java",0,0.935406698564593,4,1,5
"solr/contrib/dataimporthandler/src/java/org/apache/solr/handler/dataimport/LineEntityProcessor.java",0,0.936708860759494,4,1,5
"solr/contrib/dataimporthandler/src/java/org/apache/solr/handler/dataimport/LogTransformer.java",0,0.833333333333333,3,2,5
"solr/contrib/dataimporthandler/src/java/org/apache/solr/handler/dataimport/MockDataSource.java",0,0.934426229508197,2,1,3
"solr/contrib/dataimporthandler/src/java/org/apache/solr/handler/dataimport/NumberFormatTransformer.java",0,0.835714285714286,4,2,6
"solr/contrib/dataimporthandler/src/java/org/apache/solr/handler/dataimport/PlainTextEntityProcessor.java",0,0.875,3,2,5
"solr/contrib/dataimporthandler/src/java/org/apache/solr/handler/dataimport/RegexTransformer.java",0,0.925373134328358,5,1,6
"solr/contrib/dataimporthandler/src/java/org/apache/solr/handler/dataimport/RequestInfo.java",0,0.99390243902439,1,1,2
"solr/contrib/dataimporthandler/src/java/org/apache/solr/handler/dataimport/ScriptTransformer.java",0,0.58252427184466,3,3,6
"solr/contrib/dataimporthandler/src/java/org/apache/solr/handler/dataimport/SimplePropertiesWriter.java",0,0.991869918699187,1,1,2
"solr/contrib/dataimporthandler/src/java/org/apache/solr/handler/dataimport/SolrEntityProcessor.java",0,0.961089494163424,3,1,4
"solr/contrib/dataimporthandler/src/java/org/apache/solr/handler/dataimport/SolrWriter.java",0,0.715151515151515,5,3,8
"solr/contrib/dataimporthandler/src/java/org/apache/solr/handler/dataimport/SortedMapBackedCache.java",0,0.864628820960699,1,3,4
"solr/contrib/dataimporthandler/src/java/org/apache/solr/handler/dataimport/SqlEntityProcessor.java",0,0.842105263157895,5,2,7
"solr/contrib/dataimporthandler/src/java/org/apache/solr/handler/dataimport/TemplateString.java",0,0.982608695652174,2,1,3
"solr/contrib/dataimporthandler/src/java/org/apache/solr/handler/dataimport/TemplateTransformer.java",0,0.771428571428571,5,2,7
"solr/contrib/dataimporthandler/src/java/org/apache/solr/handler/dataimport/Transformer.java",0,0.923076923076923,3,1,4
"solr/contrib/dataimporthandler/src/java/org/apache/solr/handler/dataimport/URLDataSource.java",0,0.802631578947368,4,2,6
"solr/contrib/dataimporthandler/src/java/org/apache/solr/handler/dataimport/VariableResolver.java",0,0.962264150943396,2,1,3
"solr/contrib/dataimporthandler/src/java/org/apache/solr/handler/dataimport/VariableResolverImpl.java",0,0.836734693877551,3,2,5
"solr/contrib/dataimporthandler/src/java/org/apache/solr/handler/dataimport/XPathEntityProcessor.java",0,0.752293577981651,8,2,10
"solr/contrib/dataimporthandler/src/java/org/apache/solr/handler/dataimport/XPathRecordReader.java",0,0.582181259600614,5,2,7
"solr/contrib/dataimporthandler/src/java/org/apache/solr/handler/dataimport/ZKPropertiesWriter.java",0,0.989473684210526,1,1,2
"solr/contrib/dataimporthandler/src/java/org/apache/solr/handler/dataimport/config/ConfigNameConstants.java",0,0.983333333333333,1,1,2
"solr/contrib/dataimporthandler/src/java/org/apache/solr/handler/dataimport/config/ConfigParseUtil.java",0,0.991803278688525,1,1,2
"solr/contrib/dataimporthandler/src/java/org/apache/solr/handler/dataimport/config/DIHConfiguration.java",0,0.98989898989899,1,1,2
"solr/contrib/dataimporthandler/src/java/org/apache/solr/handler/dataimport/config/Document.java",0,0.98989898989899,1,1,2
"solr/contrib/dataimporthandler/src/java/org/apache/solr/handler/dataimport/config/Entity.java",0,0.995454545454545,1,1,2
"solr/contrib/dataimporthandler/src/java/org/apache/solr/handler/dataimport/config/EntityField.java",0,0.990825688073395,1,1,2
"solr/contrib/dataimporthandler/src/java/org/apache/solr/handler/dataimport/config/Field.java",0,0.990825688073395,1,1,2
"solr/contrib/dataimporthandler/src/java/org/apache/solr/handler/dataimport/config/Script.java",0,0.976190476190476,1,1,2
"solr/contrib/dataimporthandler/src/test/org/apache/solr/handler/dataimport/AbstractDIHCacheTestCase.java",0,0.923076923076923,2,2,4
"solr/contrib/dataimporthandler/src/test/org/apache/solr/handler/dataimport/AbstractDIHJdbcTestCase.java",0,0.994117647058824,1,1,2
"solr/contrib/dataimporthandler/src/test/org/apache/solr/handler/dataimport/AbstractDataImportHandlerTestCase.java",0,0.565789473684211,6,3,9
"solr/contrib/dataimporthandler/src/test/org/apache/solr/handler/dataimport/DestroyCountCache.java",0,0.973684210526316,1,1,2
"solr/contrib/dataimporthandler/src/test/org/apache/solr/handler/dataimport/MockInitialContextFactory.java",0,0.983870967741935,1,1,2
"solr/contrib/dataimporthandler/src/test/org/apache/solr/handler/dataimport/MockSolrEntityProcessor.java",0,0.710144927536232,0,2,2
"solr/contrib/dataimporthandler/src/test/org/apache/solr/handler/dataimport/TestCachedSqlEntityProcessor.java",0,0.742307692307692,4,2,6
"solr/contrib/dataimporthandler/src/test/org/apache/solr/handler/dataimport/TestClobTransformer.java",0,0.918032786885246,3,1,4
"solr/contrib/dataimporthandler/src/test/org/apache/solr/handler/dataimport/TestContentStreamDataSource.java",0,0.670157068062827,6,3,9
"solr/contrib/dataimporthandler/src/test/org/apache/solr/handler/dataimport/TestContextImpl.java",0,0.914285714285714,0,2,2
"solr/contrib/dataimporthandler/src/test/org/apache/solr/handler/dataimport/TestDIHEndToEnd.java",0,0.982758620689655,1,1,2
"solr/contrib/dataimporthandler/src/test/org/apache/solr/handler/dataimport/TestDataConfig.java",0,0.779220779220779,3,3,6
"solr/contrib/dataimporthandler/src/test/org/apache/solr/handler/dataimport/TestDateFormatTransformer.java",0,0.863636363636364,2,2,4
"solr/contrib/dataimporthandler/src/test/org/apache/solr/handler/dataimport/TestDocBuilder.java",0,0.427350427350427,4,3,7
"solr/contrib/dataimporthandler/src/test/org/apache/solr/handler/dataimport/TestDocBuilder2.java",0,0.867924528301887,4,2,6
"solr/contrib/dataimporthandler/src/test/org/apache/solr/handler/dataimport/TestEntityProcessorBase.java",0,0.857142857142857,3,2,5
"solr/contrib/dataimporthandler/src/test/org/apache/solr/handler/dataimport/TestEphemeralCache.java",0,0.753521126760563,2,2,4
"solr/contrib/dataimporthandler/src/test/org/apache/solr/handler/dataimport/TestErrorHandling.java",0,0.7,3,3,6
"solr/contrib/dataimporthandler/src/test/org/apache/solr/handler/dataimport/TestEvaluatorBag.java",0,0.673202614379085,3,3,6
"solr/contrib/dataimporthandler/src/test/org/apache/solr/handler/dataimport/TestFieldReader.java",0,0.920634920634921,4,1,5
"solr/contrib/dataimporthandler/src/test/org/apache/solr/handler/dataimport/TestFileListEntityProcessor.java",0,0.735449735449735,2,3,5
"solr/contrib/dataimporthandler/src/test/org/apache/solr/handler/dataimport/TestJdbcDataSource.java",0,0.471794871794872,2,4,6
"solr/contrib/dataimporthandler/src/test/org/apache/solr/handler/dataimport/TestLineEntityProcessor.java",0,0.904761904761905,2,2,4
"solr/contrib/dataimporthandler/src/test/org/apache/solr/handler/dataimport/TestNumberFormatTransformer.java",0,0.76875,2,2,4
"solr/contrib/dataimporthandler/src/test/org/apache/solr/handler/dataimport/TestPlainTextEntityProcessor.java",0,0.871428571428571,3,2,5
"solr/contrib/dataimporthandler/src/test/org/apache/solr/handler/dataimport/TestRegexTransformer.java",0,0.772020725388601,2,3,5
"solr/contrib/dataimporthandler/src/test/org/apache/solr/handler/dataimport/TestScriptTransformer.java",0,0.519480519480519,3,3,6
"solr/contrib/dataimporthandler/src/test/org/apache/solr/handler/dataimport/TestSolrEntityProcessorEndToEnd.java",0,0.852941176470588,1,3,4
"solr/contrib/dataimporthandler/src/test/org/apache/solr/handler/dataimport/TestSolrEntityProcessorUnit.java",0,0.541666666666667,1,2,3
"solr/contrib/dataimporthandler/src/test/org/apache/solr/handler/dataimport/TestSortedMapBackedCache.java",0,0.893081761006289,1,2,3
"solr/contrib/dataimporthandler/src/test/org/apache/solr/handler/dataimport/TestSqlEntityProcessor.java",0,0.854748603351955,3,2,5
"solr/contrib/dataimporthandler/src/test/org/apache/solr/handler/dataimport/TestSqlEntityProcessor2.java",0,0.820833333333333,3,3,6
"solr/contrib/dataimporthandler/src/test/org/apache/solr/handler/dataimport/TestSqlEntityProcessorDelta.java",0,0.730994152046784,2,4,6
"solr/contrib/dataimporthandler/src/test/org/apache/solr/handler/dataimport/TestSqlEntityProcessorDelta2.java",0,0.867132867132867,2,3,5
"solr/contrib/dataimporthandler/src/test/org/apache/solr/handler/dataimport/TestSqlEntityProcessorDelta3.java",0,0.995726495726496,1,1,2
"solr/contrib/dataimporthandler/src/test/org/apache/solr/handler/dataimport/TestSqlEntityProcessorDeltaPrefixedPk.java",0,0.986206896551724,2,1,3
"solr/contrib/dataimporthandler/src/test/org/apache/solr/handler/dataimport/TestTemplateString.java",0,0.862745098039216,2,2,4
"solr/contrib/dataimporthandler/src/test/org/apache/solr/handler/dataimport/TestTemplateTransformer.java",0,0.684931506849315,3,3,6
"solr/contrib/dataimporthandler/src/test/org/apache/solr/handler/dataimport/TestURLDataSource.java",0,0.911111111111111,1,2,3
"solr/contrib/dataimporthandler/src/test/org/apache/solr/handler/dataimport/TestVariableResolver.java",0,0.57396449704142,3,4,7
"solr/contrib/dataimporthandler/src/test/org/apache/solr/handler/dataimport/TestXPathEntityProcessor.java",0,0.578947368421053,3,3,6
"solr/contrib/dataimporthandler/src/test/org/apache/solr/handler/dataimport/TestXPathRecordReader.java",0,0.488333333333333,2,4,6
"solr/contrib/extraction/src/java/org/apache/solr/handler/extraction/ExtractingDocumentLoader.java",0,0.679012345679012,6,3,9
"solr/contrib/extraction/src/java/org/apache/solr/handler/extraction/ExtractingMetadataConstants.java",0,0.517241379310345,1,2,3
"solr/contrib/extraction/src/java/org/apache/solr/handler/extraction/ExtractingParams.java",0,0.741496598639456,2,3,5
"solr/contrib/extraction/src/java/org/apache/solr/handler/extraction/ExtractingRequestHandler.java",0,0.916030534351145,4,1,5
"solr/contrib/extraction/src/java/org/apache/solr/handler/extraction/SolrContentHandler.java",0,0.677325581395349,3,2,5
"solr/contrib/extraction/src/java/org/apache/solr/handler/extraction/SolrContentHandlerFactory.java",0,0.609756097560976,1,2,3
"solr/contrib/extraction/src/test/org/apache/solr/handler/extraction/ExtractingRequestHandlerTest.java",0,0.565874730021598,3,5,8
"solr/contrib/langid/src/java/org/apache/solr/update/processor/DetectedLanguage.java",0,0.978723404255319,1,1,2
"solr/contrib/langid/src/java/org/apache/solr/update/processor/LangDetectLanguageIdentifierUpdateProcessor.java",0,0.984848484848485,1,1,2
"solr/contrib/langid/src/java/org/apache/solr/update/processor/LangDetectLanguageIdentifierUpdateProcessorFactory.java",0,0.62043795620438,1,2,3
"solr/contrib/langid/src/java/org/apache/solr/update/processor/LangIdParams.java",0,0.981132075471698,1,1,2
"solr/contrib/langid/src/java/org/apache/solr/update/processor/LanguageIdentifierUpdateProcessor.java",0,0.984168865435356,2,1,3
"solr/contrib/langid/src/java/org/apache/solr/update/processor/TikaLanguageIdentifierUpdateProcessor.java",0,0.983333333333333,1,1,2
"solr/contrib/langid/src/java/org/apache/solr/update/processor/TikaLanguageIdentifierUpdateProcessorFactory.java",0,0.956989247311828,2,1,3
"solr/contrib/langid/src/test/org/apache/solr/update/processor/LangDetectLanguageIdentifierUpdateProcessorFactoryTest.java",0,0.983870967741935,1,1,2
"solr/contrib/langid/src/test/org/apache/solr/update/processor/LanguageIdentifierUpdateProcessorFactoryTestCase.java",0,0.977678571428571,2,1,3
"solr/contrib/langid/src/test/org/apache/solr/update/processor/TikaLanguageIdentifierUpdateProcessorFactoryTest.java",0,0.962962962962963,1,1,2
"solr/contrib/uima/src/java/org/apache/solr/uima/analysis/UIMAAnnotationsTokenizerFactory.java",0,0.5,0,3,3
"solr/contrib/uima/src/java/org/apache/solr/uima/analysis/UIMATypeAwareAnnotationsTokenizerFactory.java",0,0.9375,0,2,2
"solr/contrib/uima/src/java/org/apache/solr/uima/processor/SolrUIMAConfiguration.java",0,0.521367521367521,2,2,4
"solr/contrib/uima/src/java/org/apache/solr/uima/processor/SolrUIMAConfigurationReader.java",0,0.495726495726496,2,2,4
"solr/contrib/uima/src/java/org/apache/solr/uima/processor/UIMAToSolrMapper.java",0,0.793103448275862,2,2,4
"solr/contrib/uima/src/java/org/apache/solr/uima/processor/UIMAUpdateRequestProcessor.java",0,0.616766467065868,2,3,5
"solr/contrib/uima/src/java/org/apache/solr/uima/processor/UIMAUpdateRequestProcessorFactory.java",0,0.729166666666667,2,2,4
"solr/contrib/uima/src/java/org/apache/solr/uima/processor/exception/FieldMappingException.java",0,1,0,1,1
"solr/contrib/uima/src/test/org/apache/solr/uima/analysis/UIMAAnnotationsTokenizerFactoryTest.java",0,1,0,1,1
"solr/contrib/uima/src/test/org/apache/solr/uima/analysis/UIMATypeAwareAnnotationsTokenizerFactoryTest.java",0,1,0,1,1
"solr/contrib/uima/src/test/org/apache/solr/uima/processor/UIMAUpdateRequestProcessorTest.java",0,0.551724137931034,4,2,6
"solr/contrib/uima/src/test/org/apache/solr/uima/processor/an/DummyEntityAnnotator.java",0,0.854166666666667,1,2,3
"solr/contrib/uima/src/test/org/apache/solr/uima/processor/an/DummyExceptionAnnotator.java",0,0.967741935483871,1,1,2
"solr/contrib/uima/src/test/org/apache/solr/uima/processor/an/DummySentimentAnnotator.java",0,0.983606557377049,1,1,2
"solr/contrib/uima/src/test/org/apache/solr/uima/ts/EntityAnnotation.java",0,0.591836734693878,0,2,2
"solr/contrib/uima/src/test/org/apache/solr/uima/ts/EntityAnnotation_Type.java",0,0.524752475247525,0,2,2
"solr/contrib/uima/src/test/org/apache/solr/uima/ts/SentimentAnnotation.java",0,1,0,1,1
"solr/contrib/uima/src/test/org/apache/solr/uima/ts/SentimentAnnotation_Type.java",0,1,0,1,1
"solr/contrib/velocity/src/java/org/apache/solr/response/PageTool.java",0,0.863157894736842,4,2,6
"solr/contrib/velocity/src/java/org/apache/solr/response/SolrParamResourceLoader.java",0,0.815789473684211,2,3,5
"solr/contrib/velocity/src/java/org/apache/solr/response/SolrVelocityResourceLoader.java",0,0.62962962962963,1,3,4
"solr/contrib/velocity/src/java/org/apache/solr/response/VelocityResponseWriter.java",0,0.905759162303665,3,2,5
"solr/contrib/velocity/src/test/org/apache/solr/velocity/VelocityResponseWriterTest.java",0,0.701754385964912,1,2,3
"solr/core/src/java/org/apache/solr/SolrLogFormatter.java",0,0.908695652173913,2,2,4
"solr/core/src/java/org/apache/solr/analysis/ASCIIFoldingFilterFactory.java",0,0.510204081632653,1,5,6
"solr/core/src/java/org/apache/solr/analysis/ArabicLetterTokenizerFactory.java",0,0.574468085106383,2,3,5
"solr/core/src/java/org/apache/solr/analysis/ArabicNormalizationFilterFactory.java",0,0.553191489361702,2,4,6
"solr/core/src/java/org/apache/solr/analysis/ArabicStemFilterFactory.java",0,0.642857142857143,4,2,6
"solr/core/src/java/org/apache/solr/analysis/BeiderMorseFilterFactory.java",0,0.961038961038961,2,1,3
"solr/core/src/java/org/apache/solr/analysis/BrazilianStemFilterFactory.java",0,0.604651162790698,1,4,5
"solr/core/src/java/org/apache/solr/analysis/BulgarianStemFilterFactory.java",0,0.675,2,3,5
"solr/core/src/java/org/apache/solr/analysis/CJKBigramFilterFactory.java",0,0.953846153846154,2,1,3
"solr/core/src/java/org/apache/solr/analysis/CJKTokenizerFactory.java",0,0.604651162790698,0,4,4
"solr/core/src/java/org/apache/solr/analysis/CJKWidthFilterFactory.java",0,0.88,1,2,3
"solr/core/src/java/org/apache/solr/analysis/CapitalizationFilterFactory.java",0,0.421428571428571,3,4,7
"solr/core/src/java/org/apache/solr/analysis/ChineseFilterFactory.java",0,0.520833333333333,0,3,3
"solr/core/src/java/org/apache/solr/analysis/ChineseTokenizerFactory.java",0,0.530612244897959,0,3,3
"solr/core/src/java/org/apache/solr/analysis/ClassicFilterFactory.java",0,0.682926829268293,4,2,6
"solr/core/src/java/org/apache/solr/analysis/ClassicTokenizerFactory.java",0,0.771929824561403,2,3,5
"solr/core/src/java/org/apache/solr/analysis/CollationKeyFilterFactory.java",0,0.845714285714286,2,3,5
"solr/core/src/java/org/apache/solr/analysis/CommonGramsFilterFactory.java",0,0.719512195121951,4,3,7
"solr/core/src/java/org/apache/solr/analysis/CommonGramsQueryFilterFactory.java",0,0.655913978494624,4,3,7
"solr/core/src/java/org/apache/solr/analysis/CzechStemFilterFactory.java",0,0.692307692307692,1,3,4
"solr/core/src/java/org/apache/solr/analysis/DelimitedPayloadTokenFilterFactory.java",0,0.771084337349398,2,3,5
"solr/core/src/java/org/apache/solr/analysis/DictionaryCompoundWordTokenFilterFactory.java",0,0.694444444444444,1,4,5
"solr/core/src/java/org/apache/solr/analysis/DoubleMetaphoneFilterFactory.java",0,0.733333333333333,5,2,7
"solr/core/src/java/org/apache/solr/analysis/EdgeNGramFilterFactory.java",0,0.825396825396825,3,2,5
"solr/core/src/java/org/apache/solr/analysis/EdgeNGramTokenizerFactory.java",0,0.770491803278688,4,2,6
"solr/core/src/java/org/apache/solr/analysis/ElisionFilterFactory.java",0,0.640625,3,3,6
"solr/core/src/java/org/apache/solr/analysis/EnglishMinimalStemFilterFactory.java",0,0.675,2,3,5
"solr/core/src/java/org/apache/solr/analysis/EnglishPossessiveFilterFactory.java",0,0.489795918367347,3,3,6
"solr/core/src/java/org/apache/solr/analysis/FSTSynonymFilterFactory.java",0,0.880952380952381,2,2,4
"solr/core/src/java/org/apache/solr/analysis/FinnishLightStemFilterFactory.java",0,0.675,2,3,5
"solr/core/src/java/org/apache/solr/analysis/FrenchLightStemFilterFactory.java",0,0.682926829268293,3,2,5
"solr/core/src/java/org/apache/solr/analysis/FrenchMinimalStemFilterFactory.java",0,0.682926829268293,3,2,5
"solr/core/src/java/org/apache/solr/analysis/GalicianMinimalStemFilterFactory.java",0,0.925,1,2,3
"solr/core/src/java/org/apache/solr/analysis/GalicianStemFilterFactory.java",0,0.675,2,3,5
"solr/core/src/java/org/apache/solr/analysis/GermanLightStemFilterFactory.java",0,0.675,2,3,5
"solr/core/src/java/org/apache/solr/analysis/GermanMinimalStemFilterFactory.java",0,0.675,2,3,5
"solr/core/src/java/org/apache/solr/analysis/GermanNormalizationFilterFactory.java",0,0.872340425531915,1,2,3
"solr/core/src/java/org/apache/solr/analysis/GermanStemFilterFactory.java",0,0.604651162790698,2,3,5
"solr/core/src/java/org/apache/solr/analysis/GreekLowerCaseFilterFactory.java",0,0.409836065573771,2,5,7
"solr/core/src/java/org/apache/solr/analysis/GreekStemFilterFactory.java",0,0.69047619047619,3,2,5
"solr/core/src/java/org/apache/solr/analysis/HTMLStripCharFilterFactory.java",0,0.464788732394366,4,2,6
"solr/core/src/java/org/apache/solr/analysis/HindiNormalizationFilterFactory.java",0,0.652173913043478,2,3,5
"solr/core/src/java/org/apache/solr/analysis/HindiStemFilterFactory.java",0,0.666666666666667,2,3,5
"solr/core/src/java/org/apache/solr/analysis/HungarianLightStemFilterFactory.java",0,0.675,2,3,5
"solr/core/src/java/org/apache/solr/analysis/HunspellStemFilterFactory.java",0,0.788990825688073,1,2,3
"solr/core/src/java/org/apache/solr/analysis/HyphenatedWordsFilterFactory.java",0,0.641025641025641,2,4,6
"solr/core/src/java/org/apache/solr/analysis/HyphenationCompoundWordTokenFilterFactory.java",0,0.743119266055046,3,3,6
"solr/core/src/java/org/apache/solr/analysis/IndicNormalizationFilterFactory.java",0,0.652173913043478,2,3,5
"solr/core/src/java/org/apache/solr/analysis/IndonesianStemFilterFactory.java",0,0.74,3,2,5
"solr/core/src/java/org/apache/solr/analysis/IrishLowerCaseFilterFactory.java",0,0.877551020408163,1,2,3
"solr/core/src/java/org/apache/solr/analysis/ItalianLightStemFilterFactory.java",0,0.675,2,3,5
"solr/core/src/java/org/apache/solr/analysis/JapaneseBaseFormFilterFactory.java",0,0.804878048780488,2,2,4
"solr/core/src/java/org/apache/solr/analysis/JapaneseKatakanaStemFilterFactory.java",0,0.909090909090909,1,2,3
"solr/core/src/java/org/apache/solr/analysis/JapanesePartOfSpeechStopFilterFactory.java",0,0.857142857142857,2,2,4
"solr/core/src/java/org/apache/solr/analysis/JapaneseReadingFormFilterFactory.java",0,0.941176470588235,2,1,3
"solr/core/src/java/org/apache/solr/analysis/JapaneseTokenizerFactory.java",0,0.811881188118812,1,3,4
"solr/core/src/java/org/apache/solr/analysis/KStemFilterFactory.java",0,0.909090909090909,1,2,3
"solr/core/src/java/org/apache/solr/analysis/KeepWordFilterFactory.java",0,0.463157894736842,5,5,10
"solr/core/src/java/org/apache/solr/analysis/KeywordMarkerFilterFactory.java",0,0.786885245901639,3,2,5
"solr/core/src/java/org/apache/solr/analysis/KeywordTokenizerFactory.java",0,0.564102564102564,2,4,6
"solr/core/src/java/org/apache/solr/analysis/LatvianStemFilterFactory.java",0,0.923076923076923,1,2,3
"solr/core/src/java/org/apache/solr/analysis/LegacyHTMLStripCharFilter.java",0,0.999274836838289,1,1,2
"solr/core/src/java/org/apache/solr/analysis/LegacyHTMLStripCharFilterFactory.java",0,0.949152542372881,2,1,3
"solr/core/src/java/org/apache/solr/analysis/LengthFilterFactory.java",0,0.518518518518518,3,5,8
"solr/core/src/java/org/apache/solr/analysis/LetterTokenizerFactory.java",0,0.531914893617021,4,3,7
"solr/core/src/java/org/apache/solr/analysis/LimitTokenCountFilterFactory.java",0,0.923076923076923,3,1,4
"solr/core/src/java/org/apache/solr/analysis/LowerCaseFilterFactory.java",0,0.444444444444444,3,5,8
"solr/core/src/java/org/apache/solr/analysis/LowerCaseTokenizerFactory.java",0,0.446428571428571,3,5,8
"solr/core/src/java/org/apache/solr/analysis/MappingCharFilterFactory.java",0,0.82089552238806,6,2,8
"solr/core/src/java/org/apache/solr/analysis/NGramFilterFactory.java",0,0.789473684210526,3,2,5
"solr/core/src/java/org/apache/solr/analysis/NGramTokenizerFactory.java",0,0.732142857142857,3,3,6
"solr/core/src/java/org/apache/solr/analysis/NorwegianLightStemFilterFactory.java",0,0.923076923076923,1,2,3
"solr/core/src/java/org/apache/solr/analysis/NorwegianMinimalStemFilterFactory.java",0,0.923076923076923,1,2,3
"solr/core/src/java/org/apache/solr/analysis/NumericPayloadTokenFilterFactory.java",0,0.666666666666667,2,3,5
"solr/core/src/java/org/apache/solr/analysis/PathHierarchyTokenizerFactory.java",0,0.755102040816326,2,3,5
"solr/core/src/java/org/apache/solr/analysis/PatternReplaceCharFilterFactory.java",0,0.841269841269841,3,2,5
"solr/core/src/java/org/apache/solr/analysis/PatternReplaceFilterFactory.java",0,0.746478873239437,3,3,6
"solr/core/src/java/org/apache/solr/analysis/PatternTokenizerFactory.java",0,0.626168224299065,5,3,8
"solr/core/src/java/org/apache/solr/analysis/PersianCharFilterFactory.java",0,0.625,2,4,6
"solr/core/src/java/org/apache/solr/analysis/PersianNormalizationFilterFactory.java",0,0.52,1,4,5
"solr/core/src/java/org/apache/solr/analysis/PhoneticFilterFactory.java",0,0.476510067114094,3,4,7
"solr/core/src/java/org/apache/solr/analysis/PorterStemFilterFactory.java",0,0.625,1,5,6
"solr/core/src/java/org/apache/solr/analysis/PortugueseLightStemFilterFactory.java",0,0.675,2,3,5
"solr/core/src/java/org/apache/solr/analysis/PortugueseMinimalStemFilterFactory.java",0,0.675,2,3,5
"solr/core/src/java/org/apache/solr/analysis/PortugueseStemFilterFactory.java",0,0.675,2,3,5
"solr/core/src/java/org/apache/solr/analysis/PositionFilterFactory.java",0,0.763636363636364,4,2,6
"solr/core/src/java/org/apache/solr/analysis/RemoveDuplicatesTokenFilterFactory.java",0,0.538461538461538,2,4,6
"solr/core/src/java/org/apache/solr/analysis/ReverseStringFilterFactory.java",0,0.674418604651163,4,2,6
"solr/core/src/java/org/apache/solr/analysis/ReversedWildcardFilter.java",0,0.48,1,3,4
"solr/core/src/java/org/apache/solr/analysis/ReversedWildcardFilterFactory.java",0,0.895833333333333,3,2,5
"solr/core/src/java/org/apache/solr/analysis/RussianLetterTokenizerFactory.java",0,0.480769230769231,2,4,6
"solr/core/src/java/org/apache/solr/analysis/RussianLightStemFilterFactory.java",0,0.675,2,3,5
"solr/core/src/java/org/apache/solr/analysis/ShingleFilterFactory.java",0,0.439024390243902,2,4,6
"solr/core/src/java/org/apache/solr/analysis/SlowSynonymFilter.java",0,0.996168582375479,1,1,2
"solr/core/src/java/org/apache/solr/analysis/SlowSynonymFilterFactory.java",0,0.925925925925926,2,2,4
"solr/core/src/java/org/apache/solr/analysis/SlowSynonymMap.java",0,0.98159509202454,2,1,3
"solr/core/src/java/org/apache/solr/analysis/SnowballPorterFilterFactory.java",0,0.5,3,5,8
"solr/core/src/java/org/apache/solr/analysis/SolrAnalyzer.java",0,0.8,3,2,5
"solr/core/src/java/org/apache/solr/analysis/SpanishLightStemFilterFactory.java",0,0.675,2,3,5
"solr/core/src/java/org/apache/solr/analysis/StandardFilterFactory.java",0,0.531914893617021,4,3,7
"solr/core/src/java/org/apache/solr/analysis/StandardTokenizerFactory.java",0,0.482142857142857,4,4,8
"solr/core/src/java/org/apache/solr/analysis/StemmerOverrideFilterFactory.java",0,0.824324324324324,3,2,5
"solr/core/src/java/org/apache/solr/analysis/StopFilterFactory.java",0,0.549450549450549,7,3,10
"solr/core/src/java/org/apache/solr/analysis/SwedishLightStemFilterFactory.java",0,0.675,2,3,5
"solr/core/src/java/org/apache/solr/analysis/SynonymFilterFactory.java",0,0.602739726027397,2,4,6
"solr/core/src/java/org/apache/solr/analysis/ThaiWordFilterFactory.java",0,0.581395348837209,3,3,6
"solr/core/src/java/org/apache/solr/analysis/TokenOffsetPayloadTokenFilterFactory.java",0,0.619047619047619,2,3,5
"solr/core/src/java/org/apache/solr/analysis/TokenizerChain.java",0,0.73394495412844,2,4,6
"solr/core/src/java/org/apache/solr/analysis/TrieTokenizerFactory.java",0,0.331081081081081,3,4,7
"solr/core/src/java/org/apache/solr/analysis/TrimFilterFactory.java",0,0.442622950819672,2,4,6
"solr/core/src/java/org/apache/solr/analysis/TurkishLowerCaseFilterFactory.java",0,0.565217391304348,2,4,6
"solr/core/src/java/org/apache/solr/analysis/TypeAsPayloadTokenFilterFactory.java",0,0.619047619047619,2,3,5
"solr/core/src/java/org/apache/solr/analysis/TypeTokenFilterFactory.java",0,0.811764705882353,1,3,4
"solr/core/src/java/org/apache/solr/analysis/UAX29URLEmailTokenizerFactory.java",0,0.644067796610169,3,3,6
"solr/core/src/java/org/apache/solr/analysis/WhitespaceTokenizerFactory.java",0,0.543478260869565,4,3,7
"solr/core/src/java/org/apache/solr/analysis/WikipediaTokenizerFactory.java",0,0.414634146341463,3,3,6
"solr/core/src/java/org/apache/solr/analysis/WordDelimiterFilterFactory.java",0,0.465,3,5,8
"solr/core/src/java/org/apache/solr/client/solrj/embedded/EmbeddedSolrServer.java",0,0.775280898876405,3,3,6
"solr/core/src/java/org/apache/solr/client/solrj/embedded/JettySolrRunner.java",0,0.568733153638814,5,2,7
"solr/core/src/java/org/apache/solr/cloud/AssignShard.java",0,0.986842105263158,1,1,2
"solr/core/src/java/org/apache/solr/cloud/CloudDescriptor.java",0,0.985915492957746,1,1,2
"solr/core/src/java/org/apache/solr/cloud/CurrentCoreDescriptorProvider.java",0,0.96551724137931,1,1,2
"solr/core/src/java/org/apache/solr/cloud/DistributedQueue.java",0,1,0,1,1
"solr/core/src/java/org/apache/solr/cloud/ElectionContext.java",0,0.92057761732852,1,2,3
"solr/core/src/java/org/apache/solr/cloud/LeaderElector.java",0,0.98943661971831,3,1,4
"solr/core/src/java/org/apache/solr/cloud/Overseer.java",0,0.515439429928741,1,2,3
"solr/core/src/java/org/apache/solr/cloud/RecoveryStrategy.java",0,0.647311827956989,2,2,4
"solr/core/src/java/org/apache/solr/cloud/SolrZkServer.java",0,0.995850622406639,2,1,3
"solr/core/src/java/org/apache/solr/cloud/SyncStrategy.java",0,0.947183098591549,2,1,3
"solr/core/src/java/org/apache/solr/cloud/ZkController.java",0,0.875451263537906,2,3,5
"solr/core/src/java/org/apache/solr/cloud/ZkSolrResourceLoader.java",0,0.968503937007874,2,1,3
"solr/core/src/java/org/apache/solr/common/ResourceLoader.java",0,1,0,1,1
"solr/core/src/java/org/apache/solr/core/AbstractSolrEventListener.java",0,0.533333333333333,2,4,6
"solr/core/src/java/org/apache/solr/core/CachingDirectoryFactory.java",0,0.995475113122172,1,1,2
"solr/core/src/java/org/apache/solr/core/CloseHook.java",0,0.578947368421053,1,2,3
"solr/core/src/java/org/apache/solr/core/CodecFactory.java",0,0.96969696969697,1,1,2
"solr/core/src/java/org/apache/solr/core/Config.java",0,0.414201183431953,8,4,12
"solr/core/src/java/org/apache/solr/core/CoreContainer.java",0,0.484551620195931,7,5,12
"solr/core/src/java/org/apache/solr/core/CoreDescriptor.java",0,0.429292929292929,1,5,6
"solr/core/src/java/org/apache/solr/core/DefaultCodecFactory.java",0,0.983050847457627,1,1,2
"solr/core/src/java/org/apache/solr/core/DirectoryFactory.java",0,0.64367816091954,1,3,4
"solr/core/src/java/org/apache/solr/core/IndexDeletionPolicyWrapper.java",0,0.585365853658537,2,4,6
"solr/core/src/java/org/apache/solr/core/IndexReaderFactory.java",0,0.657142857142857,3,3,6
"solr/core/src/java/org/apache/solr/core/JmxMonitoredMap.java",0,0.822485207100592,4,2,6
"solr/core/src/java/org/apache/solr/core/MMapDirectoryFactory.java",0,0.805970149253731,1,2,3
"solr/core/src/java/org/apache/solr/core/NIOFSDirectoryFactory.java",0,0.891891891891892,1,2,3
"solr/core/src/java/org/apache/solr/core/NRTCachingDirectoryFactory.java",0,0.513513513513513,2,2,4
"solr/core/src/java/org/apache/solr/core/PluginInfo.java",0,0.903508771929825,3,2,5
"solr/core/src/java/org/apache/solr/core/QuerySenderListener.java",0,0.758241758241758,6,2,8
"solr/core/src/java/org/apache/solr/core/RAMDirectoryFactory.java",0,0.528301886792453,2,2,4
"solr/core/src/java/org/apache/solr/core/RequestHandlers.java",0,0.577160493827161,6,4,10
"solr/core/src/java/org/apache/solr/core/RunExecutableListener.java",0,0.795081967213115,2,3,5
"solr/core/src/java/org/apache/solr/core/SimpleFSDirectoryFactory.java",0,0.916666666666667,1,2,3
"solr/core/src/java/org/apache/solr/core/SolrConfig.java",0,0.246835443037975,6,5,11
"solr/core/src/java/org/apache/solr/core/SolrCore.java",0,0.319340329835082,13,7,20
"solr/core/src/java/org/apache/solr/core/SolrDeletionPolicy.java",0,0.631818181818182,5,3,8
"solr/core/src/java/org/apache/solr/core/SolrEventListener.java",0,0.507692307692308,5,2,7
"solr/core/src/java/org/apache/solr/core/SolrInfoMBean.java",0,0.529411764705882,2,2,4
"solr/core/src/java/org/apache/solr/core/SolrResourceLoader.java",0,0.41340782122905,6,5,11
"solr/core/src/java/org/apache/solr/core/SolrXMLSerializer.java",0,0.995192307692308,1,1,2
"solr/core/src/java/org/apache/solr/core/StandardDirectoryFactory.java",0,0.416666666666667,3,3,6
"solr/core/src/java/org/apache/solr/core/StandardIndexReaderFactory.java",0,0.777777777777778,4,2,6
"solr/core/src/java/org/apache/solr/handler/AnalysisRequestHandlerBase.java",0,0.401639344262295,7,3,10
"solr/core/src/java/org/apache/solr/handler/BinaryUpdateRequestHandler.java",0,0.714285714285714,2,3,5
"solr/core/src/java/org/apache/solr/handler/CSVRequestHandler.java",0,0.76,2,2,4
"solr/core/src/java/org/apache/solr/handler/ContentStreamHandlerBase.java",0,0.647727272727273,5,2,7
"solr/core/src/java/org/apache/solr/handler/ContentStreamLoader.java",0,0.96078431372549,2,1,3
"solr/core/src/java/org/apache/solr/handler/DocumentAnalysisRequestHandler.java",0,0.880681818181818,5,2,7
"solr/core/src/java/org/apache/solr/handler/DumpRequestHandler.java",0,0.77027027027027,2,4,6
"solr/core/src/java/org/apache/solr/handler/FieldAnalysisRequestHandler.java",0,0.83982683982684,6,2,8
"solr/core/src/java/org/apache/solr/handler/JsonUpdateRequestHandler.java",0,0.877551020408163,1,2,3
"solr/core/src/java/org/apache/solr/handler/MoreLikeThisHandler.java",0,0.585972850678733,6,5,11
"solr/core/src/java/org/apache/solr/handler/PingRequestHandler.java",0,0.516778523489933,4,3,7
"solr/core/src/java/org/apache/solr/handler/RealTimeGetHandler.java",0,0.983050847457627,1,1,2
"solr/core/src/java/org/apache/solr/handler/ReplicationHandler.java",0,0.549916805324459,10,4,14
"solr/core/src/java/org/apache/solr/handler/RequestHandlerBase.java",0,0.474747474747475,4,4,8
"solr/core/src/java/org/apache/solr/handler/RequestHandlerUtils.java",0,0.67741935483871,2,3,5
"solr/core/src/java/org/apache/solr/handler/SnapPuller.java",0,0.667450980392157,5,5,10
"solr/core/src/java/org/apache/solr/handler/SnapShooter.java",0,0.404761904761905,5,3,8
"solr/core/src/java/org/apache/solr/handler/StandardRequestHandler.java",0,0.527777777777778,1,4,5
"solr/core/src/java/org/apache/solr/handler/UpdateRequestHandler.java",0,0.994011976047904,1,1,2
"solr/core/src/java/org/apache/solr/handler/XmlUpdateRequestHandler.java",0,0.92156862745098,1,2,3
"solr/core/src/java/org/apache/solr/handler/XsltUpdateRequestHandler.java",0,0.854166666666667,1,2,3
"solr/core/src/java/org/apache/solr/handler/admin/AdminHandlers.java",0,0.985507246376812,1,1,2
"solr/core/src/java/org/apache/solr/handler/admin/CoreAdminHandler.java",0,0.448036951501155,11,3,14
"solr/core/src/java/org/apache/solr/handler/admin/LoggingHandler.java",0,0.993421052631579,1,1,2
"solr/core/src/java/org/apache/solr/handler/admin/LukeRequestHandler.java",0,0.383966244725738,10,3,13
"solr/core/src/java/org/apache/solr/handler/admin/PluginInfoHandler.java",0,0.731958762886598,2,2,4
"solr/core/src/java/org/apache/solr/handler/admin/PropertiesRequestHandler.java",0,0.950819672131147,3,1,4
"solr/core/src/java/org/apache/solr/handler/admin/ShowFileRequestHandler.java",0,0.585616438356164,4,3,7
"solr/core/src/java/org/apache/solr/handler/admin/SolrInfoMBeanHandler.java",0,0.677631578947368,0,3,3
"solr/core/src/java/org/apache/solr/handler/admin/SystemInfoHandler.java",0,0.661341853035144,2,4,6
"solr/core/src/java/org/apache/solr/handler/admin/ThreadDumpHandler.java",0,0.934306569343066,4,1,5
"solr/core/src/java/org/apache/solr/handler/component/DebugComponent.java",0,0.496153846153846,3,3,6
"solr/core/src/java/org/apache/solr/handler/component/FacetComponent.java",0,0.526193247962747,4,4,8
"solr/core/src/java/org/apache/solr/handler/component/FieldFacetStats.java",0,0.780645161290323,2,3,5
"solr/core/src/java/org/apache/solr/handler/component/HighlightComponent.java",0,0.429906542056075,5,4,9
"solr/core/src/java/org/apache/solr/handler/component/HttpShardHandler.java",0,0.907928388746803,3,1,4
"solr/core/src/java/org/apache/solr/handler/component/HttpShardHandlerFactory.java",0,0.754385964912281,1,2,3
"solr/core/src/java/org/apache/solr/handler/component/MoreLikeThisComponent.java",0,0.546875,3,2,5
"solr/core/src/java/org/apache/solr/handler/component/PivotFacetHelper.java",0,0.948,3,1,4
"solr/core/src/java/org/apache/solr/handler/component/QueryComponent.java",0,0.445219123505976,12,3,15
"solr/core/src/java/org/apache/solr/handler/component/QueryElevationComponent.java",0,0.479930191972077,10,3,13
"solr/core/src/java/org/apache/solr/handler/component/RealTimeGetComponent.java",0,0.750424448217317,3,2,5
"solr/core/src/java/org/apache/solr/handler/component/ResponseBuilder.java",0,0.384248210023866,6,4,10
"solr/core/src/java/org/apache/solr/handler/component/SearchComponent.java",0,0.613207547169811,2,3,5
"solr/core/src/java/org/apache/solr/handler/component/SearchHandler.java",0,0.401734104046243,5,5,10
"solr/core/src/java/org/apache/solr/handler/component/ShardDoc.java",0,0.825806451612903,4,2,6
"solr/core/src/java/org/apache/solr/handler/component/ShardHandler.java",0,0.964285714285714,1,1,2
"solr/core/src/java/org/apache/solr/handler/component/ShardHandlerFactory.java",0,0.96,1,1,2
"solr/core/src/java/org/apache/solr/handler/component/ShardRequest.java",0,0.895522388059702,5,1,6
"solr/core/src/java/org/apache/solr/handler/component/ShardResponse.java",0,0.727272727272727,3,3,6
"solr/core/src/java/org/apache/solr/handler/component/SpellCheckComponent.java",0,0.396978021978022,11,4,15
"solr/core/src/java/org/apache/solr/handler/component/SpellCheckMergeData.java",0,0.976744186046512,1,1,2
"solr/core/src/java/org/apache/solr/handler/component/StatsComponent.java",0,0.806666666666667,6,2,8
"solr/core/src/java/org/apache/solr/handler/component/StatsValues.java",0,0.6,1,2,3
"solr/core/src/java/org/apache/solr/handler/component/StatsValuesFactory.java",0,0.991341991341991,2,1,3
"solr/core/src/java/org/apache/solr/handler/component/TermVectorComponent.java",0,0.506276150627615,5,4,9
"solr/core/src/java/org/apache/solr/handler/component/TermsComponent.java",0,0.497933884297521,8,3,11
"solr/core/src/java/org/apache/solr/handler/loader/CSVLoader.java",0,0.978260869565217,1,1,2
"solr/core/src/java/org/apache/solr/handler/loader/CSVLoaderBase.java",0,0.99749373433584,1,1,2
"solr/core/src/java/org/apache/solr/handler/loader/ContentStreamLoader.java",0,0.982456140350877,1,1,2
"solr/core/src/java/org/apache/solr/handler/loader/JavabinLoader.java",0,0.992647058823529,1,1,2
"solr/core/src/java/org/apache/solr/handler/loader/JsonLoader.java",0,0.840366972477064,1,2,3
"solr/core/src/java/org/apache/solr/handler/loader/XMLLoader.java",0,0.480093676814988,5,3,8
"solr/core/src/java/org/apache/solr/highlight/BreakIteratorBoundaryScanner.java",0,0.9875,1,1,2
"solr/core/src/java/org/apache/solr/highlight/DefaultEncoder.java",0,0.978723404255319,1,1,2
"solr/core/src/java/org/apache/solr/highlight/DefaultSolrHighlighter.java",0,0.443526170798898,10,4,14
"solr/core/src/java/org/apache/solr/highlight/GapFragmenter.java",0,0.805825242718447,3,2,5
"solr/core/src/java/org/apache/solr/highlight/HighlightingPluginBase.java",0,0.986486486486487,1,1,2
"solr/core/src/java/org/apache/solr/highlight/HtmlEncoder.java",0,0.978723404255319,1,1,2
"solr/core/src/java/org/apache/solr/highlight/HtmlFormatter.java",0,0.903846153846154,2,2,4
"solr/core/src/java/org/apache/solr/highlight/RegexFragmenter.java",0,0.694444444444444,3,3,6
"solr/core/src/java/org/apache/solr/highlight/ScoreOrderFragmentsBuilder.java",0,0.979166666666667,1,1,2
"solr/core/src/java/org/apache/solr/highlight/SimpleBoundaryScanner.java",0,0.980392156862745,1,1,2
"solr/core/src/java/org/apache/solr/highlight/SimpleFragListBuilder.java",0,0.877551020408163,0,2,2
"solr/core/src/java/org/apache/solr/highlight/SimpleFragmentsBuilder.java",0,0.979166666666667,1,1,2
"solr/core/src/java/org/apache/solr/highlight/SingleFragListBuilder.java",0,0.877551020408163,0,2,2
"solr/core/src/java/org/apache/solr/highlight/SolrBoundaryScanner.java",0,0.916666666666667,0,2,2
"solr/core/src/java/org/apache/solr/highlight/SolrEncoder.java",0,0.976744186046512,1,1,2
"solr/core/src/java/org/apache/solr/highlight/SolrFormatter.java",0,0.909090909090909,2,1,3
"solr/core/src/java/org/apache/solr/highlight/SolrFragListBuilder.java",0,0.976190476190476,1,1,2
"solr/core/src/java/org/apache/solr/highlight/SolrFragmenter.java",0,0.909090909090909,2,1,3
"solr/core/src/java/org/apache/solr/highlight/SolrFragmentsBuilder.java",0,0.938271604938272,0,2,2
"solr/core/src/java/org/apache/solr/highlight/SolrHighlighter.java",0,0.525179856115108,1,6,7
"solr/core/src/java/org/apache/solr/highlight/WeightedFragListBuilder.java",0,1,0,1,1
"solr/core/src/java/org/apache/solr/internal/csv/CSVParser.java",0,1,0,1,1
"solr/core/src/java/org/apache/solr/internal/csv/CSVPrinter.java",0,1,0,1,1
"solr/core/src/java/org/apache/solr/internal/csv/CSVStrategy.java",0,1,0,1,1
"solr/core/src/java/org/apache/solr/internal/csv/CSVUtils.java",0,1,0,1,1
"solr/core/src/java/org/apache/solr/internal/csv/CharBuffer.java",0,1,0,1,1
"solr/core/src/java/org/apache/solr/internal/csv/ExtendedBufferedReader.java",0,1,0,1,1
"solr/core/src/java/org/apache/solr/internal/csv/writer/CSVConfig.java",0,1,0,1,1
"solr/core/src/java/org/apache/solr/internal/csv/writer/CSVConfigGuesser.java",0,1,0,1,1
"solr/core/src/java/org/apache/solr/internal/csv/writer/CSVField.java",0,1,0,1,1
"solr/core/src/java/org/apache/solr/internal/csv/writer/CSVWriter.java",0,1,0,1,1
"solr/core/src/java/org/apache/solr/logging/CircularList.java",0,0.993506493506494,1,1,2
"solr/core/src/java/org/apache/solr/logging/ListenerConfig.java",0,0.961538461538462,1,1,2
"solr/core/src/java/org/apache/solr/logging/LogWatcher.java",0,0.990654205607477,1,1,2
"solr/core/src/java/org/apache/solr/logging/LoggerInfo.java",0,0.985294117647059,1,1,2
"solr/core/src/java/org/apache/solr/logging/jul/JulInfo.java",0,0.985714285714286,1,1,2
"solr/core/src/java/org/apache/solr/logging/jul/JulWatcher.java",0,0.994082840236686,1,1,2
"solr/core/src/java/org/apache/solr/logging/jul/RecordHandler.java",0,0.978723404255319,1,1,2
"solr/core/src/java/org/apache/solr/request/LocalSolrQueryRequest.java",0,0.788732394366197,2,3,5
"solr/core/src/java/org/apache/solr/request/PerSegmentSingleValuedFaceting.java",0,0.876456876456876,4,2,6
"solr/core/src/java/org/apache/solr/request/ServletSolrParams.java",0,0.875,3,2,5
"solr/core/src/java/org/apache/solr/request/SimpleFacets.java",0,0.46078431372549,9,3,12
"solr/core/src/java/org/apache/solr/request/SolrQueryRequest.java",0,0.744186046511628,2,2,4
"solr/core/src/java/org/apache/solr/request/SolrQueryRequestBase.java",0,0.8,4,2,6
"solr/core/src/java/org/apache/solr/request/SolrRequestHandler.java",0,0.890625,4,1,5
"solr/core/src/java/org/apache/solr/request/SolrRequestInfo.java",0,0.842857142857143,0,2,2
"solr/core/src/java/org/apache/solr/request/UnInvertedField.java",0,0.692307692307692,6,3,9
"solr/core/src/java/org/apache/solr/response/BinaryQueryResponseWriter.java",0,0.447368421052632,2,3,5
"solr/core/src/java/org/apache/solr/response/BinaryResponseWriter.java",0,0.425531914893617,4,3,7
"solr/core/src/java/org/apache/solr/response/CSVResponseWriter.java",0,0.921443736730361,7,1,8
"solr/core/src/java/org/apache/solr/response/JSONResponseWriter.java",0,0.764895330112721,6,3,9
"solr/core/src/java/org/apache/solr/response/PHPResponseWriter.java",0,0.972477064220184,2,1,3
"solr/core/src/java/org/apache/solr/response/PHPSerializedResponseWriter.java",0,0.690298507462687,3,3,6
"solr/core/src/java/org/apache/solr/response/PythonResponseWriter.java",0,0.91156462585034,3,1,4
"solr/core/src/java/org/apache/solr/response/QueryResponseWriter.java",0,0.528735632183908,3,3,6
"solr/core/src/java/org/apache/solr/response/RawResponseWriter.java",0,0.735042735042735,2,3,5
"solr/core/src/java/org/apache/solr/response/ResultContext.java",0,0.935483870967742,2,1,3
"solr/core/src/java/org/apache/solr/response/RubyResponseWriter.java",0,0.813186813186813,2,3,5
"solr/core/src/java/org/apache/solr/response/SolrQueryResponse.java",0,0.433476394849785,3,5,8
"solr/core/src/java/org/apache/solr/response/TextResponseWriter.java",0,0.641456582633053,6,2,8
"solr/core/src/java/org/apache/solr/response/XMLResponseWriter.java",0,0.782608695652174,1,3,4
"solr/core/src/java/org/apache/solr/response/XMLWriter.java",0,0.740331491712707,7,2,9
"solr/core/src/java/org/apache/solr/response/XSLTResponseWriter.java",0,0.727941176470588,1,3,4
"solr/core/src/java/org/apache/solr/response/transform/BaseEditorialTransformer.java",0,0.903614457831325,0,2,2
"solr/core/src/java/org/apache/solr/response/transform/DocIdAugmenterFactory.java",0,0.96551724137931,2,1,3
"solr/core/src/java/org/apache/solr/response/transform/DocTransformer.java",0,0.578125,2,2,4
"solr/core/src/java/org/apache/solr/response/transform/DocTransformers.java",0,0.95,3,1,4
"solr/core/src/java/org/apache/solr/response/transform/ElevatedMarkerFactory.java",0,1,0,1,1
"solr/core/src/java/org/apache/solr/response/transform/ExcludedMarkerFactory.java",0,1,0,1,1
"solr/core/src/java/org/apache/solr/response/transform/ExplainAugmenterFactory.java",0,0.982456140350877,2,1,3
"solr/core/src/java/org/apache/solr/response/transform/RenameFieldTransformer.java",0,0.945454545454545,3,1,4
"solr/core/src/java/org/apache/solr/response/transform/ScoreAugmenter.java",0,0.92156862745098,4,1,5
"solr/core/src/java/org/apache/solr/response/transform/ShardAugmenterFactory.java",0,0.954545454545455,2,1,3
"solr/core/src/java/org/apache/solr/response/transform/TransformContext.java",0,0.891891891891892,2,2,4
"solr/core/src/java/org/apache/solr/response/transform/TransformerFactory.java",0,0.96,2,1,3
"solr/core/src/java/org/apache/solr/response/transform/TransformerWithContext.java",0,0.9375,2,1,3
"solr/core/src/java/org/apache/solr/response/transform/ValueAugmenterFactory.java",0,0.970873786407767,3,1,4
"solr/core/src/java/org/apache/solr/response/transform/ValueSourceAugmenter.java",0,0.504672897196262,5,3,8
"solr/core/src/java/org/apache/solr/schema/AbstractSubTypeFieldType.java",0,0.975409836065574,2,1,3
"solr/core/src/java/org/apache/solr/schema/BCDIntField.java",0,0.684931506849315,4,4,8
"solr/core/src/java/org/apache/solr/schema/BCDLongField.java",0,0.758620689655172,2,3,5
"solr/core/src/java/org/apache/solr/schema/BCDStrField.java",0,0.666666666666667,2,3,5
"solr/core/src/java/org/apache/solr/schema/BinaryField.java",0,0.568181818181818,3,3,6
"solr/core/src/java/org/apache/solr/schema/BoolField.java",0,0.794759825327511,7,2,9
"solr/core/src/java/org/apache/solr/schema/ByteField.java",0,0.416666666666667,6,3,9
"solr/core/src/java/org/apache/solr/schema/CollationField.java",0,0.960474308300395,3,1,4
"solr/core/src/java/org/apache/solr/schema/CoordinateFieldType.java",0,0.98,1,1,2
"solr/core/src/java/org/apache/solr/schema/CopyField.java",0,0.98780487804878,1,1,2
"solr/core/src/java/org/apache/solr/schema/CurrencyField.java",0,0.984375,3,1,4
"solr/core/src/java/org/apache/solr/schema/DateField.java",0,0.491588785046729,9,2,11
"solr/core/src/java/org/apache/solr/schema/DoubleField.java",0,0.595744680851064,6,3,9
"solr/core/src/java/org/apache/solr/schema/ExchangeRateProvider.java",0,0.956521739130435,2,1,3
"solr/core/src/java/org/apache/solr/schema/ExternalFileField.java",0,0.772277227722772,6,2,8
"solr/core/src/java/org/apache/solr/schema/FieldProperties.java",0,0.767241379310345,5,2,7
"solr/core/src/java/org/apache/solr/schema/FieldType.java",0,0.411666666666667,9,5,14
"solr/core/src/java/org/apache/solr/schema/FieldTypePluginLoader.java",0,0.671122994652406,2,3,5
"solr/core/src/java/org/apache/solr/schema/FloatField.java",0,0.648351648351648,5,3,8
"solr/core/src/java/org/apache/solr/schema/GeoHashField.java",0,0.772727272727273,3,3,6
"solr/core/src/java/org/apache/solr/schema/IndexSchema.java",0,0.352941176470588,9,5,14
"solr/core/src/java/org/apache/solr/schema/IntField.java",0,0.648351648351648,5,3,8
"solr/core/src/java/org/apache/solr/schema/JsonPreAnalyzedParser.java",0,0.982078853046595,2,1,3
"solr/core/src/java/org/apache/solr/schema/LatLonType.java",0,0.673841059602649,9,2,11
"solr/core/src/java/org/apache/solr/schema/LongField.java",0,0.634408602150538,6,3,9
"solr/core/src/java/org/apache/solr/schema/OpenExchangeRatesOrgProvider.java",0,0.988372093023256,2,1,3
"solr/core/src/java/org/apache/solr/schema/PointType.java",0,0.694323144104803,5,2,7
"solr/core/src/java/org/apache/solr/schema/PreAnalyzedField.java",0,0.99604743083004,1,1,2
"solr/core/src/java/org/apache/solr/schema/PrimitiveFieldType.java",0,0.971428571428571,1,1,2
"solr/core/src/java/org/apache/solr/schema/RandomSortField.java",0,0.466321243523316,4,6,10
"solr/core/src/java/org/apache/solr/schema/SchemaAware.java",0,0.974358974358974,1,1,2
"solr/core/src/java/org/apache/solr/schema/SchemaField.java",0,0.512110726643599,5,3,8
"solr/core/src/java/org/apache/solr/schema/ShortField.java",0,0.474747474747475,5,3,8
"solr/core/src/java/org/apache/solr/schema/SimilarityFactory.java",0,0.517241379310345,1,3,4
"solr/core/src/java/org/apache/solr/schema/SimplePreAnalyzedParser.java",0,0.989528795811518,2,1,3
"solr/core/src/java/org/apache/solr/schema/SortableDoubleField.java",0,0.710280373831776,7,3,10
"solr/core/src/java/org/apache/solr/schema/SortableFloatField.java",0,0.705607476635514,7,3,10
"solr/core/src/java/org/apache/solr/schema/SortableIntField.java",0,0.723004694835681,7,3,10
"solr/core/src/java/org/apache/solr/schema/SortableLongField.java",0,0.719047619047619,7,3,10
"solr/core/src/java/org/apache/solr/schema/SpatialQueryable.java",0,0.911764705882353,1,2,3
"solr/core/src/java/org/apache/solr/schema/StrField.java",0,0.759259259259259,5,3,8
"solr/core/src/java/org/apache/solr/schema/StrFieldSource.java",0,0.802469135802469,4,2,6
"solr/core/src/java/org/apache/solr/schema/TextField.java",0,0.484939759036145,10,3,13
"solr/core/src/java/org/apache/solr/schema/TrieDateField.java",0,0.640845070422535,5,2,7
"solr/core/src/java/org/apache/solr/schema/TrieDoubleField.java",0,0.575,0,2,2
"solr/core/src/java/org/apache/solr/schema/TrieField.java",0,0.318255250403877,7,5,12
"solr/core/src/java/org/apache/solr/schema/TrieFloatField.java",0,0.575,0,2,2
"solr/core/src/java/org/apache/solr/schema/TrieIntField.java",0,0.676470588235294,0,2,2
"solr/core/src/java/org/apache/solr/schema/TrieLongField.java",0,0.676470588235294,0,2,2
"solr/core/src/java/org/apache/solr/schema/UUIDField.java",0,0.893617021276596,5,1,6
"solr/core/src/java/org/apache/solr/search/BitDocSet.java",0,0.715189873417722,5,2,7
"solr/core/src/java/org/apache/solr/search/BoostQParserPlugin.java",0,0.703296703296703,2,4,6
"solr/core/src/java/org/apache/solr/search/CacheConfig.java",0,0.798319327731092,3,3,6
"solr/core/src/java/org/apache/solr/search/CacheRegenerator.java",0,0.953488372093023,2,1,3
"solr/core/src/java/org/apache/solr/search/DelegatingCollector.java",0,0.949367088607595,2,1,3
"solr/core/src/java/org/apache/solr/search/DisMaxQParser.java",0,0.788530465949821,5,3,8
"solr/core/src/java/org/apache/solr/search/DisMaxQParserPlugin.java",0,0.959016393442623,4,1,5
"solr/core/src/java/org/apache/solr/search/DocIterator.java",0,0.648148148148148,1,2,3
"solr/core/src/java/org/apache/solr/search/DocList.java",0,0.9,1,2,3
"solr/core/src/java/org/apache/solr/search/DocListAndSet.java",0,0.891891891891892,2,2,4
"solr/core/src/java/org/apache/solr/search/DocSet.java",0,0.805194805194805,2,2,4
"solr/core/src/java/org/apache/solr/search/DocSetBase.java",0,0.995145631067961,1,1,2
"solr/core/src/java/org/apache/solr/search/DocSetCollector.java",0,0.989583333333333,1,1,2
"solr/core/src/java/org/apache/solr/search/DocSetDelegateCollector.java",0,0.988235294117647,1,1,2
"solr/core/src/java/org/apache/solr/search/DocSlice.java",0,0.981707317073171,3,1,4
"solr/core/src/java/org/apache/solr/search/ExtendedDismaxQParserPlugin.java",0,0.627923976608187,6,4,10
"solr/core/src/java/org/apache/solr/search/ExtendedQuery.java",0,0.975,1,1,2
"solr/core/src/java/org/apache/solr/search/ExtendedQueryBase.java",0,0.986486486486487,1,1,2
"solr/core/src/java/org/apache/solr/search/FastLRUCache.java",0,0.623481781376518,3,4,7
"solr/core/src/java/org/apache/solr/search/FieldParams.java",0,0.956521739130435,2,1,3
"solr/core/src/java/org/apache/solr/search/FieldQParserPlugin.java",0,0.962962962962963,2,1,3
"solr/core/src/java/org/apache/solr/search/FunctionQParser.java",0,0.933497536945813,3,2,5
"solr/core/src/java/org/apache/solr/search/FunctionQParserPlugin.java",0,0.973684210526316,1,1,2
"solr/core/src/java/org/apache/solr/search/FunctionRangeQParserPlugin.java",0,0.878048780487805,3,2,5
"solr/core/src/java/org/apache/solr/search/FunctionRangeQuery.java",0,0.985714285714286,1,1,2
"solr/core/src/java/org/apache/solr/search/Grouping.java",0,0.790720631786772,4,2,6
"solr/core/src/java/org/apache/solr/search/HashDocSet.java",0,0.982758620689655,3,1,4
"solr/core/src/java/org/apache/solr/search/JoinQParserPlugin.java",0,0.907504363001745,6,1,7
"solr/core/src/java/org/apache/solr/search/LFUCache.java",0,0.992982456140351,2,1,3
"solr/core/src/java/org/apache/solr/search/LRUCache.java",0,0.785123966942149,3,3,6
"solr/core/src/java/org/apache/solr/search/LuceneQParserPlugin.java",0,0.848484848484849,6,1,7
"solr/core/src/java/org/apache/solr/search/LuceneQueryOptimizer.java",0,0.94017094017094,5,1,6
"solr/core/src/java/org/apache/solr/search/MissingStringLastComparatorSource.java",0,0.85,5,2,7
"solr/core/src/java/org/apache/solr/search/NestedQParserPlugin.java",0,0.888888888888889,2,2,4
"solr/core/src/java/org/apache/solr/search/OldLuceneQParserPlugin.java",0,0.921052631578947,3,1,4
"solr/core/src/java/org/apache/solr/search/PostFilter.java",0,0.978723404255319,1,1,2
"solr/core/src/java/org/apache/solr/search/PrefixQParserPlugin.java",0,0.877551020408163,4,1,5
"solr/core/src/java/org/apache/solr/search/QParser.java",0,0.779329608938548,8,2,10
"solr/core/src/java/org/apache/solr/search/QParserPlugin.java",0,0.901960784313726,2,2,4
"solr/core/src/java/org/apache/solr/search/QueryParsing.java",0,0.572847682119205,9,3,12
"solr/core/src/java/org/apache/solr/search/QueryResultKey.java",0,0.939393939393939,4,1,5
"solr/core/src/java/org/apache/solr/search/QueryUtils.java",0,0.833333333333333,2,3,5
"solr/core/src/java/org/apache/solr/search/RawQParserPlugin.java",0,0.865384615384615,2,2,4
"solr/core/src/java/org/apache/solr/search/ReturnFields.java",0,0.857142857142857,3,2,5
"solr/core/src/java/org/apache/solr/search/SolrCache.java",0,0.654411764705882,4,2,6
"solr/core/src/java/org/apache/solr/search/SolrCacheBase.java",0,0.986577181208054,2,1,3
"solr/core/src/java/org/apache/solr/search/SolrConstantScoreQuery.java",0,0.899563318777293,6,1,7
"solr/core/src/java/org/apache/solr/search/SolrFieldCacheMBean.java",0,0.878048780487805,2,2,4
"solr/core/src/java/org/apache/solr/search/SolrFilter.java",0,0.816326530612245,2,2,4
"solr/core/src/java/org/apache/solr/search/SolrIndexSearcher.java",0,0.758785249457701,14,2,16
"solr/core/src/java/org/apache/solr/search/SolrQueryParser.java",0,0.273092369477912,4,5,9
"solr/core/src/java/org/apache/solr/search/SolrSortField.java",0,0.967741935483871,1,1,2
"solr/core/src/java/org/apache/solr/search/SortSpec.java",0,0.829268292682927,2,2,4
"solr/core/src/java/org/apache/solr/search/SortedIntDocSet.java",0,0.983204134366925,3,1,4
"solr/core/src/java/org/apache/solr/search/Sorting.java",0,0.912280701754386,2,2,4
"solr/core/src/java/org/apache/solr/search/SpatialBoxQParserPlugin.java",0,0.948717948717949,2,1,3
"solr/core/src/java/org/apache/solr/search/SpatialFilterQParser.java",0,0.788461538461538,4,2,6
"solr/core/src/java/org/apache/solr/search/SpatialFilterQParserPlugin.java",0,0.545454545454545,2,2,4
"solr/core/src/java/org/apache/solr/search/SpatialOptions.java",0,0.879310344827586,2,2,4
"solr/core/src/java/org/apache/solr/search/SurroundQParserPlugin.java",0,0.973214285714286,3,1,4
"solr/core/src/java/org/apache/solr/search/TermQParserPlugin.java",0,0.926470588235294,3,1,4
"solr/core/src/java/org/apache/solr/search/ValueSourceParser.java",0,0.697138314785374,6,3,9
"solr/core/src/java/org/apache/solr/search/WrappedQuery.java",0,0.979166666666667,2,1,3
"solr/core/src/java/org/apache/solr/search/function/FileFloatSource.java",0,0.681681681681682,8,2,10
"solr/core/src/java/org/apache/solr/search/function/ValueSourceRangeFilter.java",0,0.843283582089552,4,2,6
"solr/core/src/java/org/apache/solr/search/function/distance/GeohashFunction.java",0,0.88,6,2,8
"solr/core/src/java/org/apache/solr/search/function/distance/GeohashHaversineFunction.java",0,0.781021897810219,6,3,9
"solr/core/src/java/org/apache/solr/search/function/distance/HaversineConstFunction.java",0,0.908396946564885,8,1,9
"solr/core/src/java/org/apache/solr/search/function/distance/HaversineFunction.java",0,0.806451612903226,7,2,9
"solr/core/src/java/org/apache/solr/search/function/distance/SquaredEuclideanFunction.java",0,0.891891891891892,4,2,6
"solr/core/src/java/org/apache/solr/search/function/distance/StringDistanceFunction.java",0,0.730769230769231,4,2,6
"solr/core/src/java/org/apache/solr/search/function/distance/VectorDistanceFunction.java",0,0.877551020408163,7,1,8
"solr/core/src/java/org/apache/solr/search/grouping/Command.java",0,1,0,1,1
"solr/core/src/java/org/apache/solr/search/grouping/CommandHandler.java",0,0.995433789954338,1,1,2
"solr/core/src/java/org/apache/solr/search/grouping/GroupingSpecification.java",0,1,0,1,1
"solr/core/src/java/org/apache/solr/search/grouping/collector/FilterCollector.java",0,1,0,1,1
"solr/core/src/java/org/apache/solr/search/grouping/distributed/ShardRequestFactory.java",0,1,0,1,1
"solr/core/src/java/org/apache/solr/search/grouping/distributed/ShardResponseProcessor.java",0,1,0,1,1
"solr/core/src/java/org/apache/solr/search/grouping/distributed/command/Pair.java",0,1,0,1,1
"solr/core/src/java/org/apache/solr/search/grouping/distributed/command/QueryCommand.java",0,0.993421052631579,1,1,2
"solr/core/src/java/org/apache/solr/search/grouping/distributed/command/QueryCommandResult.java",0,1,0,1,1
"solr/core/src/java/org/apache/solr/search/grouping/distributed/command/SearchGroupsFieldCommand.java",0,1,0,1,1
"solr/core/src/java/org/apache/solr/search/grouping/distributed/command/TopGroupsFieldCommand.java",0,0.993548387096774,1,1,2
"solr/core/src/java/org/apache/solr/search/grouping/distributed/requestfactory/SearchGroupsRequestFactory.java",0,1,0,1,1
"solr/core/src/java/org/apache/solr/search/grouping/distributed/requestfactory/StoredFieldsShardRequestFactory.java",0,1,0,1,1
"solr/core/src/java/org/apache/solr/search/grouping/distributed/requestfactory/TopGroupsShardRequestFactory.java",0,1,0,1,1
"solr/core/src/java/org/apache/solr/search/grouping/distributed/responseprocessor/SearchGroupShardResponseProcessor.java",0,1,0,1,1
"solr/core/src/java/org/apache/solr/search/grouping/distributed/responseprocessor/StoredFieldsShardResponseProcessor.java",0,1,0,1,1
"solr/core/src/java/org/apache/solr/search/grouping/distributed/responseprocessor/TopGroupsShardResponseProcessor.java",0,0.99290780141844,1,1,2
"solr/core/src/java/org/apache/solr/search/grouping/distributed/shardresultserializer/SearchGroupsResultTransformer.java",0,0.976377952755906,1,1,2
"solr/core/src/java/org/apache/solr/search/grouping/distributed/shardresultserializer/ShardResultTransformer.java",0,1,0,1,1
"solr/core/src/java/org/apache/solr/search/grouping/distributed/shardresultserializer/TopGroupsResultTransformer.java",0,0.95985401459854,2,1,3
"solr/core/src/java/org/apache/solr/search/grouping/endresulttransformer/EndResultTransformer.java",0,1,0,1,1
"solr/core/src/java/org/apache/solr/search/grouping/endresulttransformer/GroupedEndResultTransformer.java",0,1,0,1,1
"solr/core/src/java/org/apache/solr/search/grouping/endresulttransformer/MainEndResultTransformer.java",0,1,0,1,1
"solr/core/src/java/org/apache/solr/search/grouping/endresulttransformer/SimpleEndResultTransformer.java",0,1,0,1,1
"solr/core/src/java/org/apache/solr/search/similarities/BM25SimilarityFactory.java",0,0.983870967741935,1,1,2
"solr/core/src/java/org/apache/solr/search/similarities/DFRSimilarityFactory.java",0,0.99492385786802,1,1,2
"solr/core/src/java/org/apache/solr/search/similarities/DefaultSimilarityFactory.java",0,0.981818181818182,1,1,2
"solr/core/src/java/org/apache/solr/search/similarities/IBSimilarityFactory.java",0,0.990990990990991,1,1,2
"solr/core/src/java/org/apache/solr/search/similarities/LMDirichletSimilarityFactory.java",0,0.983333333333333,1,1,2
"solr/core/src/java/org/apache/solr/search/similarities/LMJelinekMercerSimilarityFactory.java",0,0.983050847457627,1,1,2
"solr/core/src/java/org/apache/solr/search/similarities/SchemaSimilarityFactory.java",0,0.982758620689655,1,1,2
"solr/core/src/java/org/apache/solr/servlet/DirectSolrConnection.java",0,0.685534591194969,4,2,6
"solr/core/src/java/org/apache/solr/servlet/LoadAdminUiServlet.java",0,0.98780487804878,1,1,2
"solr/core/src/java/org/apache/solr/servlet/RedirectServlet.java",0,0.985074626865672,1,1,2
"solr/core/src/java/org/apache/solr/servlet/SolrDispatchFilter.java",0,0.358415841584158,7,6,13
"solr/core/src/java/org/apache/solr/servlet/SolrRequestParsers.java",0,0.585956416464891,4,3,7
"solr/core/src/java/org/apache/solr/servlet/ZookeeperInfoServlet.java",0,0.997555012224939,1,1,2
"solr/core/src/java/org/apache/solr/servlet/cache/HttpCacheHeaderUtil.java",0,0.814814814814815,4,2,6
"solr/core/src/java/org/apache/solr/servlet/cache/Method.java",0,0.78125,0,3,3
"solr/core/src/java/org/apache/solr/spelling/AbstractLuceneSpellChecker.java",0,0.72887323943662,8,3,11
"solr/core/src/java/org/apache/solr/spelling/ConjunctionSolrSpellChecker.java",0,0.995535714285714,1,1,2
"solr/core/src/java/org/apache/solr/spelling/DirectSolrSpellChecker.java",0,0.862660944206009,2,2,4
"solr/core/src/java/org/apache/solr/spelling/FileBasedSpellChecker.java",0,0.674074074074074,6,2,8
"solr/core/src/java/org/apache/solr/spelling/IndexBasedSpellChecker.java",0,0.741935483870968,8,2,10
"solr/core/src/java/org/apache/solr/spelling/PossibilityIterator.java",0,0.906759906759907,2,2,4
"solr/core/src/java/org/apache/solr/spelling/QueryConverter.java",0,0.70873786407767,2,2,4
"solr/core/src/java/org/apache/solr/spelling/ResultEntry.java",0,0.982456140350877,1,1,2
"solr/core/src/java/org/apache/solr/spelling/SolrSpellChecker.java",0,0.54950495049505,5,2,7
"solr/core/src/java/org/apache/solr/spelling/SpellCheckCollation.java",0,0.558823529411765,1,2,3
"solr/core/src/java/org/apache/solr/spelling/SpellCheckCollator.java",0,0.403061224489796,4,3,7
"solr/core/src/java/org/apache/solr/spelling/SpellCheckCorrection.java",0,0.474576271186441,1,3,4
"solr/core/src/java/org/apache/solr/spelling/SpellingOptions.java",0,0.642201834862385,1,2,3
"solr/core/src/java/org/apache/solr/spelling/SpellingQueryConverter.java",0,0.378109452736318,5,4,9
"solr/core/src/java/org/apache/solr/spelling/SpellingResult.java",0,0.918367346938776,3,1,4
"solr/core/src/java/org/apache/solr/spelling/SuggestQueryConverter.java",0,0.957446808510638,2,1,3
"solr/core/src/java/org/apache/solr/spelling/WordBreakSolrSpellChecker.java",0,0.997167138810198,1,1,2
"solr/core/src/java/org/apache/solr/spelling/suggest/LookupFactory.java",0,0.466666666666667,2,3,5
"solr/core/src/java/org/apache/solr/spelling/suggest/Suggester.java",0,0.668316831683168,3,4,7
"solr/core/src/java/org/apache/solr/spelling/suggest/fst/FSTLookupFactory.java",0,0.785714285714286,2,2,4
"solr/core/src/java/org/apache/solr/spelling/suggest/fst/WFSTLookupFactory.java",0,0.758620689655172,1,2,3
"solr/core/src/java/org/apache/solr/spelling/suggest/jaspell/JaspellLookupFactory.java",0,0.466666666666667,1,3,4
"solr/core/src/java/org/apache/solr/spelling/suggest/tst/TSTLookupFactory.java",0,0.365853658536585,1,4,5
"solr/core/src/java/org/apache/solr/update/AddUpdateCommand.java",0,0.484126984126984,2,3,5
"solr/core/src/java/org/apache/solr/update/CommitTracker.java",0,0.606299212598425,1,3,4
"solr/core/src/java/org/apache/solr/update/CommitUpdateCommand.java",0,0.610169491525424,5,3,8
"solr/core/src/java/org/apache/solr/update/DefaultSolrCoreState.java",0,0.886904761904762,2,2,4
"solr/core/src/java/org/apache/solr/update/DeleteUpdateCommand.java",0,0.5,4,2,6
"solr/core/src/java/org/apache/solr/update/DirectUpdateHandler2.java",0,0.559490084985836,10,3,13
"solr/core/src/java/org/apache/solr/update/DocumentBuilder.java",0,0.422018348623853,7,3,10
"solr/core/src/java/org/apache/solr/update/MergeIndexesCommand.java",0,0.740740740740741,3,3,6
"solr/core/src/java/org/apache/solr/update/PeerSync.java",0,0.71858407079646,2,2,4
"solr/core/src/java/org/apache/solr/update/RollbackUpdateCommand.java",0,0.634146341463415,2,3,5
"solr/core/src/java/org/apache/solr/update/SolrCmdDistributor.java",0,0.98019801980198,2,1,3
"solr/core/src/java/org/apache/solr/update/SolrCoreState.java",0,0.988636363636364,1,1,2
"solr/core/src/java/org/apache/solr/update/SolrIndexConfig.java",0,0.345291479820628,7,4,11
"solr/core/src/java/org/apache/solr/update/SolrIndexWriter.java",0,0.264150943396226,6,5,11
"solr/core/src/java/org/apache/solr/update/TransactionLog.java",0,0.978436657681941,2,1,3
"solr/core/src/java/org/apache/solr/update/UpdateCommand.java",0,0.625,2,2,4
"solr/core/src/java/org/apache/solr/update/UpdateHandler.java",0,0.488888888888889,3,4,7
"solr/core/src/java/org/apache/solr/update/UpdateLog.java",0,0.791181364392679,2,2,4
"solr/core/src/java/org/apache/solr/update/VersionBucket.java",0,0.96969696969697,1,1,2
"solr/core/src/java/org/apache/solr/update/VersionInfo.java",0,0.988571428571429,2,1,3
"solr/core/src/java/org/apache/solr/update/processor/AbstractDefaultValueUpdateProcessorFactory.java",0,1,0,1,1
"solr/core/src/java/org/apache/solr/update/processor/CloneFieldUpdateProcessorFactory.java",0,0.99622641509434,1,1,2
"solr/core/src/java/org/apache/solr/update/processor/ConcatFieldUpdateProcessorFactory.java",0,0.983870967741935,1,1,2
"solr/core/src/java/org/apache/solr/update/processor/DefaultValueUpdateProcessorFactory.java",0,1,0,1,1
"solr/core/src/java/org/apache/solr/update/processor/DistributedUpdateProcessor.java",0,0.652985074626866,1,3,4
"solr/core/src/java/org/apache/solr/update/processor/DistributedUpdateProcessorFactory.java",0,0.9,0,2,2
"solr/core/src/java/org/apache/solr/update/processor/DistributingUpdateProcessorFactory.java",0,1,0,1,1
"solr/core/src/java/org/apache/solr/update/processor/FieldLengthUpdateProcessorFactory.java",0,1,0,1,1
"solr/core/src/java/org/apache/solr/update/processor/FieldMutatingUpdateProcessor.java",0,0.98,3,1,4
"solr/core/src/java/org/apache/solr/update/processor/FieldMutatingUpdateProcessorFactory.java",0,0.98943661971831,1,1,2
"solr/core/src/java/org/apache/solr/update/processor/FieldValueMutatingUpdateProcessor.java",0,1,0,1,1
"solr/core/src/java/org/apache/solr/update/processor/FieldValueSubsetUpdateProcessorFactory.java",0,1,0,1,1
"solr/core/src/java/org/apache/solr/update/processor/FirstFieldValueUpdateProcessorFactory.java",0,1,0,1,1
"solr/core/src/java/org/apache/solr/update/processor/HTMLStripFieldUpdateProcessorFactory.java",0,1,0,1,1
"solr/core/src/java/org/apache/solr/update/processor/IgnoreFieldUpdateProcessorFactory.java",0,1,0,1,1
"solr/core/src/java/org/apache/solr/update/processor/LastFieldValueUpdateProcessorFactory.java",0,1,0,1,1
"solr/core/src/java/org/apache/solr/update/processor/LogUpdateProcessorFactory.java",0,0.570754716981132,2,3,5
"solr/core/src/java/org/apache/solr/update/processor/Lookup3Signature.java",0,0.513513513513513,1,3,4
"solr/core/src/java/org/apache/solr/update/processor/MD5Signature.java",0,0.683333333333333,1,3,4
"solr/core/src/java/org/apache/solr/update/processor/MaxFieldValueUpdateProcessorFactory.java",0,0.9875,1,1,2
"solr/core/src/java/org/apache/solr/update/processor/MinFieldValueUpdateProcessorFactory.java",0,0.9875,1,1,2
"solr/core/src/java/org/apache/solr/update/processor/NoOpDistributingUpdateProcessorFactory.java",0,1,0,1,1
"solr/core/src/java/org/apache/solr/update/processor/RegexReplaceProcessorFactory.java",0,1,0,1,1
"solr/core/src/java/org/apache/solr/update/processor/RemoveBlankFieldUpdateProcessorFactory.java",0,1,0,1,1
"solr/core/src/java/org/apache/solr/update/processor/RunUpdateProcessorFactory.java",0,0.685185185185185,1,3,4
"solr/core/src/java/org/apache/solr/update/processor/Signature.java",0,0.535714285714286,1,2,3
"solr/core/src/java/org/apache/solr/update/processor/SignatureUpdateProcessorFactory.java",0,0.703125,3,3,6
"solr/core/src/java/org/apache/solr/update/processor/TextProfileSignature.java",0,0.875776397515528,3,2,5
"solr/core/src/java/org/apache/solr/update/processor/TimestampUpdateProcessorFactory.java",0,1,0,1,1
"solr/core/src/java/org/apache/solr/update/processor/TrimFieldUpdateProcessorFactory.java",0,1,0,1,1
"solr/core/src/java/org/apache/solr/update/processor/TruncateFieldUpdateProcessorFactory.java",0,1,0,1,1
"solr/core/src/java/org/apache/solr/update/processor/URLClassifyProcessor.java",0,0.986842105263158,2,1,3
"solr/core/src/java/org/apache/solr/update/processor/URLClassifyProcessorFactory.java",0,0.977272727272727,1,1,2
"solr/core/src/java/org/apache/solr/update/processor/UUIDUpdateProcessorFactory.java",0,1,0,1,1
"solr/core/src/java/org/apache/solr/update/processor/UniqFieldsUpdateProcessorFactory.java",0,0.990740740740741,1,1,2
"solr/core/src/java/org/apache/solr/update/processor/UpdateRequestProcessor.java",0,0.810126582278481,1,2,3
"solr/core/src/java/org/apache/solr/update/processor/UpdateRequestProcessorChain.java",0,0.602272727272727,1,3,4
"solr/core/src/java/org/apache/solr/update/processor/UpdateRequestProcessorFactory.java",0,0.953488372093023,2,1,3
"solr/core/src/java/org/apache/solr/util/BCDUtils.java",0,0.996240601503759,2,1,3
"solr/core/src/java/org/apache/solr/util/BoundedTreeSet.java",0,0.885714285714286,1,2,3
"solr/core/src/java/org/apache/solr/util/ConcurrentLFUCache.java",0,0.99789029535865,1,1,2
"solr/core/src/java/org/apache/solr/util/ConcurrentLRUCache.java",0,0.464454976303318,7,3,10
"solr/core/src/java/org/apache/solr/util/DOMUtil.java",0,0.315789473684211,5,4,9
"solr/core/src/java/org/apache/solr/util/DateMathParser.java",0,0.964809384164223,2,1,3
"solr/core/src/java/org/apache/solr/util/DefaultSolrThreadFactory.java",0,0.979591836734694,1,1,2
"solr/core/src/java/org/apache/solr/util/FastWriter.java",0,0.9609375,2,1,3
"solr/core/src/java/org/apache/solr/util/FileUtils.java",0,0.43298969072165,5,3,8
"solr/core/src/java/org/apache/solr/util/LongPriorityQueue.java",0,0.995744680851064,1,1,2
"solr/core/src/java/org/apache/solr/util/NumberUtils.java",0,0.761194029850746,2,3,5
"solr/core/src/java/org/apache/solr/util/PrimUtils.java",0,0.991869918699187,1,1,2
"solr/core/src/java/org/apache/solr/util/RTimer.java",0,0.961783439490446,2,1,3
"solr/core/src/java/org/apache/solr/util/RefCounted.java",0,0.903225806451613,2,2,4
"solr/core/src/java/org/apache/solr/util/RegexFileFilter.java",0,0.886363636363636,2,2,4
"solr/core/src/java/org/apache/solr/util/SimplePostTool.java",0,0.363128491620112,1,4,5
"solr/core/src/java/org/apache/solr/util/SolrPluginUtils.java",0,0.482456140350877,9,5,14
"solr/core/src/java/org/apache/solr/util/SuggestMissingFactories.java",0,0.990610328638498,2,1,3
"solr/core/src/java/org/apache/solr/util/SystemIdResolver.java",0,0.977272727272727,1,1,2
"solr/core/src/java/org/apache/solr/util/TimeZoneUtils.java",0,0.965116279069767,1,1,2
"solr/core/src/java/org/apache/solr/util/VersionedFile.java",0,0.990825688073395,1,1,2
"solr/core/src/java/org/apache/solr/util/plugin/AbstractPluginLoader.java",0,0.676691729323308,2,3,5
"solr/core/src/java/org/apache/solr/util/plugin/MapInitializedPlugin.java",0,0.9,3,1,4
"solr/core/src/java/org/apache/solr/util/plugin/MapPluginLoader.java",0,0.903846153846154,2,2,4
"solr/core/src/java/org/apache/solr/util/plugin/NamedListInitializedPlugin.java",0,0.933333333333333,2,1,3
"solr/core/src/java/org/apache/solr/util/plugin/NamedListPluginLoader.java",0,0.9,2,2,4
"solr/core/src/java/org/apache/solr/util/plugin/PluginInfoInitialized.java",0,0.935483870967742,2,1,3
"solr/core/src/java/org/apache/solr/util/plugin/ResourceLoaderAware.java",0,1,0,1,1
"solr/core/src/java/org/apache/solr/util/plugin/SolrCoreAware.java",0,0.964285714285714,1,1,2
"solr/core/src/java/org/apache/solr/util/xslt/TransformerProvider.java",0,0.6953125,2,3,5
"solr/core/src/test/org/apache/solr/BasicFunctionalityTest.java",0,0.470238095238095,7,5,12
"solr/core/src/test/org/apache/solr/ConvertedLegacyTest.java",0,0.922205438066465,6,1,7
"solr/core/src/test/org/apache/solr/DisMaxRequestHandlerTest.java",0,0.535353535353535,3,3,6
"solr/core/src/test/org/apache/solr/EchoParamsTest.java",0,0.444444444444444,1,6,7
"solr/core/src/test/org/apache/solr/MinimalSchemaTest.java",0,0.778625954198473,1,3,4
"solr/core/src/test/org/apache/solr/OutputWriterTest.java",0,0.48,0,7,7
"solr/core/src/test/org/apache/solr/SampleTest.java",0,0.793388429752066,1,3,4
"solr/core/src/test/org/apache/solr/SolrInfoMBeanTest.java",0,0.915966386554622,2,2,4
"solr/core/src/test/org/apache/solr/TestDistributedGrouping.java",0,1,0,1,1
"solr/core/src/test/org/apache/solr/TestDistributedSearch.java",0,0.450765864332604,6,3,9
"solr/core/src/test/org/apache/solr/TestGroupingSearch.java",0,0.603351955307263,3,2,5
"solr/core/src/test/org/apache/solr/TestJoin.java",0,0.840579710144927,1,2,3
"solr/core/src/test/org/apache/solr/TestPluginEnable.java",0,0.390243902439024,2,3,5
"solr/core/src/test/org/apache/solr/TestRandomFaceting.java",0,0.992063492063492,2,1,3
"solr/core/src/test/org/apache/solr/TestSolrCoreProperties.java",0,0.881118881118881,4,2,6
"solr/core/src/test/org/apache/solr/TestTrie.java",0,0.627177700348432,2,3,5
"solr/core/src/test/org/apache/solr/analysis/CommonGramsFilterFactoryTest.java",0,0.509433962264151,1,4,5
"solr/core/src/test/org/apache/solr/analysis/CommonGramsQueryFilterFactoryTest.java",0,0.504761904761905,1,4,5
"solr/core/src/test/org/apache/solr/analysis/DoubleMetaphoneFilterFactoryTest.java",0,0.578947368421053,2,3,5
"solr/core/src/test/org/apache/solr/analysis/LegacyHTMLStripCharFilterTest.java",0,0.97196261682243,3,1,4
"solr/core/src/test/org/apache/solr/analysis/LengthFilterTest.java",0,0.62,1,4,5
"solr/core/src/test/org/apache/solr/analysis/SnowballPorterFilterFactoryTest.java",0,0.603960396039604,1,3,4
"solr/core/src/test/org/apache/solr/analysis/TestArabicFilters.java",0,0.622448979591837,1,3,4
"solr/core/src/test/org/apache/solr/analysis/TestBeiderMorseFilterFactory.java",0,0.9,1,2,3
"solr/core/src/test/org/apache/solr/analysis/TestBrazilianStemFilterFactory.java",0,0.880952380952381,3,1,4
"solr/core/src/test/org/apache/solr/analysis/TestBulgarianStemFilterFactory.java",0,0.928571428571429,2,1,3
"solr/core/src/test/org/apache/solr/analysis/TestCJKBigramFilterFactory.java",0,0.875,1,2,3
"solr/core/src/test/org/apache/solr/analysis/TestCJKTokenizerFactory.java",0,0.878048780487805,3,1,4
"solr/core/src/test/org/apache/solr/analysis/TestCJKWidthFilterFactory.java",0,0.918918918918919,1,2,3
"solr/core/src/test/org/apache/solr/analysis/TestCapitalizationFilterFactory.java",0,0.299107142857143,2,5,7
"solr/core/src/test/org/apache/solr/analysis/TestChineseFilterFactory.java",0,0.880952380952381,3,1,4
"solr/core/src/test/org/apache/solr/analysis/TestChineseTokenizerFactory.java",0,0.923076923076923,1,2,3
"solr/core/src/test/org/apache/solr/analysis/TestCollationKeyFilterFactory.java",0,0.472081218274112,2,3,5
"solr/core/src/test/org/apache/solr/analysis/TestCollationKeyRangeQueries.java",0,0.988095238095238,1,1,2
"solr/core/src/test/org/apache/solr/analysis/TestCzechStemFilterFactory.java",0,0.928571428571429,2,1,3
"solr/core/src/test/org/apache/solr/analysis/TestDelimitedPayloadTokenFilterFactory.java",0,0.775,2,3,5
"solr/core/src/test/org/apache/solr/analysis/TestDictionaryCompoundWordTokenFilterFactory.java",0,0.851851851851852,2,2,4
"solr/core/src/test/org/apache/solr/analysis/TestElisionFilterFactory.java",0,0.522727272727273,1,3,4
"solr/core/src/test/org/apache/solr/analysis/TestEnglishMinimalStemFilterFactory.java",0,0.918918918918919,1,2,3
"solr/core/src/test/org/apache/solr/analysis/TestFinnishLightStemFilterFactory.java",0,0.918918918918919,1,2,3
"solr/core/src/test/org/apache/solr/analysis/TestFrenchLightStemFilterFactory.java",0,0.918918918918919,1,2,3
"solr/core/src/test/org/apache/solr/analysis/TestFrenchMinimalStemFilterFactory.java",0,0.918918918918919,1,2,3
"solr/core/src/test/org/apache/solr/analysis/TestGalicianMinimalStemFilterFactory.java",0,0.918918918918919,1,2,3
"solr/core/src/test/org/apache/solr/analysis/TestGalicianStemFilterFactory.java",0,0.918918918918919,1,2,3
"solr/core/src/test/org/apache/solr/analysis/TestGermanLightStemFilterFactory.java",0,0.918918918918919,1,2,3
"solr/core/src/test/org/apache/solr/analysis/TestGermanMinimalStemFilterFactory.java",0,0.918918918918919,1,2,3
"solr/core/src/test/org/apache/solr/analysis/TestGermanNormalizationFilterFactory.java",0,0.918918918918919,1,2,3
"solr/core/src/test/org/apache/solr/analysis/TestGermanStemFilterFactory.java",0,0.880952380952381,3,1,4
"solr/core/src/test/org/apache/solr/analysis/TestGreekLowerCaseFilterFactory.java",0,0.765957446808511,1,3,4
"solr/core/src/test/org/apache/solr/analysis/TestGreekStemFilterFactory.java",0,0.902439024390244,1,2,3
"solr/core/src/test/org/apache/solr/analysis/TestHTMLStripCharFilterFactory.java",0,0.976377952755906,2,1,3
"solr/core/src/test/org/apache/solr/analysis/TestHindiFilters.java",0,0.775280898876405,1,2,3
"solr/core/src/test/org/apache/solr/analysis/TestHungarianLightStemFilterFactory.java",0,0.918918918918919,1,2,3
"solr/core/src/test/org/apache/solr/analysis/TestHunspellStemFilterFactory.java",0,0.875,2,2,4
"solr/core/src/test/org/apache/solr/analysis/TestHyphenationCompoundWordTokenFilterFactory.java",0,0.901234567901235,1,2,3
"solr/core/src/test/org/apache/solr/analysis/TestIndonesianStemFilterFactory.java",0,0.95,2,1,3
"solr/core/src/test/org/apache/solr/analysis/TestIrishLowerCaseFilterFactory.java",0,0.918918918918919,1,2,3
"solr/core/src/test/org/apache/solr/analysis/TestItalianLightStemFilterFactory.java",0,0.918918918918919,1,2,3
"solr/core/src/test/org/apache/solr/analysis/TestJapaneseBaseFormFilterFactory.java",0,0.760869565217391,1,3,4
"solr/core/src/test/org/apache/solr/analysis/TestJapaneseKatakanaStemFilterFactory.java",0,0.979591836734694,1,1,2
"solr/core/src/test/org/apache/solr/analysis/TestJapanesePartOfSpeechStopFilterFactory.java",0,0.803571428571429,1,3,4
"solr/core/src/test/org/apache/solr/analysis/TestJapaneseReadingFormFilterFactory.java",0,0.977272727272727,1,1,2
"solr/core/src/test/org/apache/solr/analysis/TestJapaneseTokenizerFactory.java",0,0.821052631578947,1,3,4
"solr/core/src/test/org/apache/solr/analysis/TestKStemFilterFactory.java",0,0.918918918918919,1,2,3
"solr/core/src/test/org/apache/solr/analysis/TestKeepFilterFactory.java",0,0.816666666666667,3,2,5
"solr/core/src/test/org/apache/solr/analysis/TestKeywordMarkerFilterFactory.java",0,0.882352941176471,1,2,3
"solr/core/src/test/org/apache/solr/analysis/TestLatvianStemFilterFactory.java",0,0.918918918918919,1,2,3
"solr/core/src/test/org/apache/solr/analysis/TestLuceneMatchVersion.java",0,0.756756756756757,1,4,5
"solr/core/src/test/org/apache/solr/analysis/TestMappingCharFilterFactory.java",0,0.886792452830189,2,2,4
"solr/core/src/test/org/apache/solr/analysis/TestMultiWordSynonyms.java",0,0.517647058823529,2,4,6
"solr/core/src/test/org/apache/solr/analysis/TestNGramFilters.java",0,0.945121951219512,3,1,4
"solr/core/src/test/org/apache/solr/analysis/TestNorwegianLightStemFilterFactory.java",0,0.918918918918919,1,2,3
"solr/core/src/test/org/apache/solr/analysis/TestNorwegianMinimalStemFilterFactory.java",0,0.918918918918919,1,2,3
"solr/core/src/test/org/apache/solr/analysis/TestPatternReplaceCharFilterFactory.java",0,0.965116279069767,2,1,3
"solr/core/src/test/org/apache/solr/analysis/TestPatternReplaceFilterFactory.java",0,0.934782608695652,2,1,3
"solr/core/src/test/org/apache/solr/analysis/TestPatternTokenizerFactory.java",0,0.609756097560976,3,3,6
"solr/core/src/test/org/apache/solr/analysis/TestPersianNormalizationFilterFactory.java",0,0.880952380952381,3,1,4
"solr/core/src/test/org/apache/solr/analysis/TestPhoneticFilterFactory.java",0,0.409836065573771,3,4,7
"solr/core/src/test/org/apache/solr/analysis/TestPorterStemFilterFactory.java",0,0.880952380952381,3,1,4
"solr/core/src/test/org/apache/solr/analysis/TestPortugueseLightStemFilterFactory.java",0,0.918918918918919,1,2,3
"solr/core/src/test/org/apache/solr/analysis/TestPortugueseMinimalStemFilterFactory.java",0,0.918918918918919,1,2,3
"solr/core/src/test/org/apache/solr/analysis/TestPortugueseStemFilterFactory.java",0,0.918918918918919,1,2,3
"solr/core/src/test/org/apache/solr/analysis/TestRemoveDuplicatesTokenFilterFactory.java",0,0.575,1,4,5
"solr/core/src/test/org/apache/solr/analysis/TestReverseStringFilterFactory.java",0,0.787234042553192,2,2,4
"solr/core/src/test/org/apache/solr/analysis/TestReversedWildcardFilterFactory.java",0,0.45360824742268,2,4,6
"solr/core/src/test/org/apache/solr/analysis/TestRussianFilters.java",0,0.822222222222222,1,2,3
"solr/core/src/test/org/apache/solr/analysis/TestRussianLightStemFilterFactory.java",0,0.918918918918919,1,2,3
"solr/core/src/test/org/apache/solr/analysis/TestShingleFilterFactory.java",0,0.631799163179916,2,3,5
"solr/core/src/test/org/apache/solr/analysis/TestSlowSynonymFilter.java",0,0.495192307692308,1,3,4
"solr/core/src/test/org/apache/solr/analysis/TestSpanishLightStemFilterFactory.java",0,0.918918918918919,1,2,3
"solr/core/src/test/org/apache/solr/analysis/TestStandardFactories.java",0,0.543010752688172,2,3,5
"solr/core/src/test/org/apache/solr/analysis/TestStemmerOverrideFilterFactory.java",0,0.884057971014493,1,2,3
"solr/core/src/test/org/apache/solr/analysis/TestStopFilterFactory.java",0,0.644736842105263,2,3,5
"solr/core/src/test/org/apache/solr/analysis/TestSwedishLightStemFilterFactory.java",0,0.918918918918919,1,2,3
"solr/core/src/test/org/apache/solr/analysis/TestSynonymFilterFactory.java",0,0.758333333333333,1,3,4
"solr/core/src/test/org/apache/solr/analysis/TestSynonymMap.java",0,0.705329153605016,2,3,5
"solr/core/src/test/org/apache/solr/analysis/TestThaiWordFilterFactory.java",0,0.76,2,3,5
"solr/core/src/test/org/apache/solr/analysis/TestTrimFilterFactory.java",0,0.925,1,2,3
"solr/core/src/test/org/apache/solr/analysis/TestTurkishLowerCaseFilterFactory.java",0,0.928571428571429,2,1,3
"solr/core/src/test/org/apache/solr/analysis/TestTypeTokenFilterFactory.java",0,0.723809523809524,1,3,4
"solr/core/src/test/org/apache/solr/analysis/TestUAX29URLEmailTokenizerFactory.java",0,0.775700934579439,1,3,4
"solr/core/src/test/org/apache/solr/analysis/TestWikipediaTokenizerFactory.java",0,0.930232558139535,2,1,3
"solr/core/src/test/org/apache/solr/analysis/TestWordDelimiterFilterFactory.java",0,0.971074380165289,3,1,4
"solr/core/src/test/org/apache/solr/cloud/AbstractDistributedZkTestCase.java",0,0.542105263157895,1,2,3
"solr/core/src/test/org/apache/solr/cloud/AbstractZkTestCase.java",0,0.784810126582278,2,2,4
"solr/core/src/test/org/apache/solr/cloud/BasicDistributedZkTest.java",0,0.476943346508564,3,4,7
"solr/core/src/test/org/apache/solr/cloud/BasicZkTest.java",0,0.627118644067797,3,2,5
"solr/core/src/test/org/apache/solr/cloud/ChaosMonkey.java",0,0.995337995337995,2,1,3
"solr/core/src/test/org/apache/solr/cloud/ChaosMonkeyNothingIsSafeTest.java",0,0.955128205128205,3,1,4
"solr/core/src/test/org/apache/solr/cloud/ChaosMonkeySafeLeaderTest.java",0,0.987421383647799,2,1,3
"solr/core/src/test/org/apache/solr/cloud/CloudStateTest.java",0,0.987179487179487,1,1,2
"solr/core/src/test/org/apache/solr/cloud/CloudStateUpdateTest.java",0,0.793893129770992,3,2,5
"solr/core/src/test/org/apache/solr/cloud/FullSolrCloudDistribCmdsTest.java",0,0.983552631578947,2,1,3
"solr/core/src/test/org/apache/solr/cloud/FullSolrCloudTest.java",0,0.921726408193124,3,2,5
"solr/core/src/test/org/apache/solr/cloud/LeaderElectionIntegrationTest.java",0,0.883870967741936,2,2,4
"solr/core/src/test/org/apache/solr/cloud/LeaderElectionTest.java",0,0.848552338530067,2,2,4
"solr/core/src/test/org/apache/solr/cloud/OverseerTest.java",0,0.621295279912184,2,2,4
"solr/core/src/test/org/apache/solr/cloud/RecoveryZkTest.java",0,0.99290780141844,1,1,2
"solr/core/src/test/org/apache/solr/cloud/TestHashPartitioner.java",0,0.977777777777778,1,1,2
"solr/core/src/test/org/apache/solr/cloud/TestMultiCoreConfBootstrap.java",0,0.991525423728814,1,1,2
"solr/core/src/test/org/apache/solr/cloud/ZkControllerTest.java",0,0.420233463035019,1,3,4
"solr/core/src/test/org/apache/solr/cloud/ZkNodePropsTest.java",0,0.807692307692308,1,2,3
"solr/core/src/test/org/apache/solr/cloud/ZkSolrClientTest.java",0,0.880478087649402,2,2,4
"solr/core/src/test/org/apache/solr/cloud/ZkTestServer.java",0,0.87536231884058,2,2,4
"solr/core/src/test/org/apache/solr/core/AlternateDirectoryTest.java",0,0.6,5,3,8
"solr/core/src/test/org/apache/solr/core/DummyValueSourceParser.java",0,0.830508474576271,1,3,4
"solr/core/src/test/org/apache/solr/core/FakeDeletionPolicy.java",0,0.964912280701754,2,1,3
"solr/core/src/test/org/apache/solr/core/IndexReaderFactoryTest.java",0,0.91304347826087,1,2,3
"solr/core/src/test/org/apache/solr/core/MockEventListener.java",0,0.907407407407407,0,2,2
"solr/core/src/test/org/apache/solr/core/MockQuerySenderListenerReqHandler.java",0,0.441176470588235,1,4,5
"solr/core/src/test/org/apache/solr/core/PluginInfoTest.java",0,0.963855421686747,1,1,2
"solr/core/src/test/org/apache/solr/core/RAMDirectoryFactoryTest.java",0,0.557377049180328,2,3,5
"solr/core/src/test/org/apache/solr/core/RequestHandlersTest.java",0,0.733333333333333,0,3,3
"solr/core/src/test/org/apache/solr/core/ResourceLoaderTest.java",0,0.616541353383459,3,2,5
"solr/core/src/test/org/apache/solr/core/SOLR749Test.java",0,0.851063829787234,1,2,3
"solr/core/src/test/org/apache/solr/core/SolrCoreCheckLockOnStartupTest.java",0,1,0,1,1
"solr/core/src/test/org/apache/solr/core/SolrCoreTest.java",0,0.763948497854077,2,3,5
"solr/core/src/test/org/apache/solr/core/TestArbitraryIndexDir.java",0,0.671328671328671,9,2,11
"solr/core/src/test/org/apache/solr/core/TestBadConfig.java",0,0.957446808510638,2,1,3
"solr/core/src/test/org/apache/solr/core/TestCodecSupport.java",0,0.986301369863014,1,1,2
"solr/core/src/test/org/apache/solr/core/TestConfig.java",0,0.728476821192053,2,3,5
"solr/core/src/test/org/apache/solr/core/TestCoreContainer.java",0,0.720720720720721,1,2,3
"solr/core/src/test/org/apache/solr/core/TestJmxIntegration.java",0,0.863095238095238,5,2,7
"solr/core/src/test/org/apache/solr/core/TestJmxMonitoredMap.java",0,0.607476635514019,4,3,7
"solr/core/src/test/org/apache/solr/core/TestMergePolicyConfig.java",0,0.962264150943396,2,1,3
"solr/core/src/test/org/apache/solr/core/TestPropInject.java",0,0.92,3,1,4
"solr/core/src/test/org/apache/solr/core/TestPropInjectDefaults.java",0,0.708333333333333,2,2,4
"solr/core/src/test/org/apache/solr/core/TestQuerySenderListener.java",0,0.314606741573034,2,4,6
"solr/core/src/test/org/apache/solr/core/TestQuerySenderNoQuery.java",0,0.976744186046512,2,1,3
"solr/core/src/test/org/apache/solr/core/TestSolrDeletionPolicy1.java",0,0.816176470588235,4,2,6
"solr/core/src/test/org/apache/solr/core/TestSolrDeletionPolicy2.java",0,0.868852459016393,2,2,4
"solr/core/src/test/org/apache/solr/core/TestSolrXMLSerializer.java",0,0.993506493506494,1,1,2
"solr/core/src/test/org/apache/solr/core/TestXIncludeConfig.java",0,0.671428571428571,3,2,5
"solr/core/src/test/org/apache/solr/handler/AnalysisRequestHandlerTestBase.java",0,0.887096774193548,3,2,5
"solr/core/src/test/org/apache/solr/handler/BinaryUpdateRequestHandlerTest.java",0,0.909090909090909,1,2,3
"solr/core/src/test/org/apache/solr/handler/CSVRequestHandlerTest.java",0,0.907407407407407,2,2,4
"solr/core/src/test/org/apache/solr/handler/DocumentAnalysisRequestHandlerTest.java",0,0.507418397626113,3,3,6
"solr/core/src/test/org/apache/solr/handler/FieldAnalysisRequestHandlerTest.java",0,0.4453125,4,4,8
"solr/core/src/test/org/apache/solr/handler/JsonLoaderTest.java",0,0.910596026490066,5,1,6
"solr/core/src/test/org/apache/solr/handler/MoreLikeThisHandlerTest.java",0,0.405797101449275,2,4,6
"solr/core/src/test/org/apache/solr/handler/PingRequestHandlerTest.java",0,0.592783505154639,0,2,2
"solr/core/src/test/org/apache/solr/handler/StandardRequestHandlerTest.java",0,0.893203883495146,0,2,2
"solr/core/src/test/org/apache/solr/handler/TestCSVLoader.java",0,0.693290734824281,3,3,6
"solr/core/src/test/org/apache/solr/handler/TestReplicationHandler.java",0,0.273612463485881,5,6,11
"solr/core/src/test/org/apache/solr/handler/XmlUpdateRequestHandlerTest.java",0,0.545454545454545,4,4,8
"solr/core/src/test/org/apache/solr/handler/XsltUpdateRequestHandlerTest.java",0,0.771739130434783,2,2,4
"solr/core/src/test/org/apache/solr/handler/admin/CoreAdminHandlerTest.java",0,1,0,1,1
"solr/core/src/test/org/apache/solr/handler/admin/LoggingHandlerTest.java",0,0.981132075471698,1,1,2
"solr/core/src/test/org/apache/solr/handler/admin/LukeRequestHandlerTest.java",0,0.587912087912088,0,3,3
"solr/core/src/test/org/apache/solr/handler/admin/MBeansHandlerTest.java",0,0.984615384615385,1,1,2
"solr/core/src/test/org/apache/solr/handler/admin/ShowFileRequestHandlerTest.java",0,0.98876404494382,1,1,2
"solr/core/src/test/org/apache/solr/handler/admin/SystemInfoHandlerTest.java",0,0.938775510204082,2,1,3
"solr/core/src/test/org/apache/solr/handler/component/BadComponentTest.java",0,1,0,1,1
"solr/core/src/test/org/apache/solr/handler/component/DebugComponentTest.java",0,0.992957746478873,1,1,2
"solr/core/src/test/org/apache/solr/handler/component/DistributedQueryElevationComponentTest.java",0,0.96969696969697,3,1,4
"solr/core/src/test/org/apache/solr/handler/component/DistributedSpellCheckComponentTest.java",0,0.227272727272727,4,6,10
"solr/core/src/test/org/apache/solr/handler/component/DistributedTermsComponentTest.java",0,0.648148148148148,3,2,5
"solr/core/src/test/org/apache/solr/handler/component/DummyCustomParamSpellChecker.java",0,0.967213114754098,2,1,3
"solr/core/src/test/org/apache/solr/handler/component/QueryElevationComponentTest.java",0,0.858369098712446,6,2,8
"solr/core/src/test/org/apache/solr/handler/component/SearchHandlerTest.java",0,0.640776699029126,1,3,4
"solr/core/src/test/org/apache/solr/handler/component/SpellCheckComponentTest.java",0,0.276264591439689,4,5,9
"solr/core/src/test/org/apache/solr/handler/component/StatsComponentTest.java",0,0.448979591836735,1,4,5
"solr/core/src/test/org/apache/solr/handler/component/TermVectorComponentTest.java",0,0.444444444444444,3,4,7
"solr/core/src/test/org/apache/solr/handler/component/TermsComponentTest.java",0,0.554744525547445,1,4,5
"solr/core/src/test/org/apache/solr/highlight/DummyHighlighter.java",0,0.581395348837209,2,2,4
"solr/core/src/test/org/apache/solr/highlight/FastVectorHighlighterTest.java",0,0.829545454545455,3,2,5
"solr/core/src/test/org/apache/solr/highlight/HighlighterConfigTest.java",0,0.710144927536232,2,2,4
"solr/core/src/test/org/apache/solr/highlight/HighlighterTest.java",0,0.364749082007344,3,6,9
"solr/core/src/test/org/apache/solr/internal/csv/CSVParserTest.java",0,1,0,1,1
"solr/core/src/test/org/apache/solr/internal/csv/CSVPrinterTest.java",0,1,0,1,1
"solr/core/src/test/org/apache/solr/internal/csv/CSVStrategyTest.java",0,1,0,1,1
"solr/core/src/test/org/apache/solr/internal/csv/CSVUtilsTest.java",0,1,0,1,1
"solr/core/src/test/org/apache/solr/internal/csv/CharBufferTest.java",0,1,0,1,1
"solr/core/src/test/org/apache/solr/internal/csv/ExtendedBufferedReaderTest.java",0,1,0,1,1
"solr/core/src/test/org/apache/solr/internal/csv/writer/CSVConfigGuesserTest.java",0,1,0,1,1
"solr/core/src/test/org/apache/solr/internal/csv/writer/CSVConfigTest.java",0,1,0,1,1
"solr/core/src/test/org/apache/solr/internal/csv/writer/CSVFieldTest.java",0,1,0,1,1
"solr/core/src/test/org/apache/solr/internal/csv/writer/CSVWriterTest.java",0,1,0,1,1
"solr/core/src/test/org/apache/solr/request/JSONWriterTest.java",0,0.333333333333333,1,4,5
"solr/core/src/test/org/apache/solr/request/SimpleFacetsTest.java",0,0.781763826606876,1,3,4
"solr/core/src/test/org/apache/solr/request/TestBinaryResponseWriter.java",0,0.601941747572815,5,2,7
"solr/core/src/test/org/apache/solr/request/TestFaceting.java",0,0.764044943820225,3,3,6
"solr/core/src/test/org/apache/solr/request/TestRemoteStreaming.java",0,0.765957446808511,1,2,3
"solr/core/src/test/org/apache/solr/request/TestWriterPerf.java",0,0.916666666666667,3,1,4
"solr/core/src/test/org/apache/solr/response/TestCSVResponseWriter.java",0,0.780612244897959,2,3,5
"solr/core/src/test/org/apache/solr/response/TestPHPSerializedResponseWriter.java",0,1,0,1,1
"solr/core/src/test/org/apache/solr/schema/BadIndexSchemaTest.java",0,0.561797752808989,2,3,5
"solr/core/src/test/org/apache/solr/schema/CopyFieldTest.java",0,0.951515151515152,2,1,3
"solr/core/src/test/org/apache/solr/schema/CurrencyFieldTest.java",0,0.995555555555556,1,1,2
"solr/core/src/test/org/apache/solr/schema/DateFieldTest.java",0,0.87962962962963,3,2,5
"solr/core/src/test/org/apache/solr/schema/IndexSchemaRuntimeFieldTest.java",0,1,0,1,1
"solr/core/src/test/org/apache/solr/schema/IndexSchemaTest.java",0,0.65625,1,5,6
"solr/core/src/test/org/apache/solr/schema/MockExchangeRateProvider.java",0,0.978260869565217,2,1,3
"solr/core/src/test/org/apache/solr/schema/MultiTermTest.java",0,0.988636363636364,1,1,2
"solr/core/src/test/org/apache/solr/schema/NotRequiredUniqueKeyTest.java",0,0.82,1,2,3
"solr/core/src/test/org/apache/solr/schema/NumericFieldsTest.java",0,0.672955974842767,1,2,3
"solr/core/src/test/org/apache/solr/schema/OpenExchangeRatesOrgProviderTest.java",0,0.97752808988764,2,1,3
"solr/core/src/test/org/apache/solr/schema/PolyFieldTest.java",0,0.840659340659341,4,2,6
"solr/core/src/test/org/apache/solr/schema/PreAnalyzedFieldTest.java",0,0.993333333333333,1,1,2
"solr/core/src/test/org/apache/solr/schema/PrimitiveFieldTypeTest.java",0,0.994764397905759,1,1,2
"solr/core/src/test/org/apache/solr/schema/RequiredFieldsTest.java",0,0.826388888888889,2,2,4
"solr/core/src/test/org/apache/solr/schema/TestBinaryField.java",0,0.705882352941177,4,4,8
"solr/core/src/test/org/apache/solr/schema/TestCollationField.java",0,0.994974874371859,1,1,2
"solr/core/src/test/org/apache/solr/schema/TestOmitPositions.java",0,0.983333333333333,1,1,2
"solr/core/src/test/org/apache/solr/schema/UUIDFieldTest.java",0,0.746268656716418,1,2,3
"solr/core/src/test/org/apache/solr/search/DocSetPerf.java",0,0.988950276243094,2,1,3
"solr/core/src/test/org/apache/solr/search/FooQParserPlugin.java",0,0.916666666666667,3,1,4
"solr/core/src/test/org/apache/solr/search/QueryEqualityTest.java",0,1,0,1,1
"solr/core/src/test/org/apache/solr/search/QueryParsingTest.java",0,0.53515625,2,5,7
"solr/core/src/test/org/apache/solr/search/ReturnFieldsTest.java",0,0.842622950819672,1,2,3
"solr/core/src/test/org/apache/solr/search/SpatialFilterTest.java",0,0.746411483253589,2,3,5
"solr/core/src/test/org/apache/solr/search/TestDocSet.java",0,0.829365079365079,6,2,8
"solr/core/src/test/org/apache/solr/search/TestExtendedDismaxParser.java",0,0.377840909090909,3,4,7
"solr/core/src/test/org/apache/solr/search/TestFastLRUCache.java",0,0.491442542787286,4,3,7
"solr/core/src/test/org/apache/solr/search/TestFiltering.java",0,0.937869822485207,2,2,4
"solr/core/src/test/org/apache/solr/search/TestFoldingMultitermQuery.java",0,0.891495601173021,0,2,2
"solr/core/src/test/org/apache/solr/search/TestIndexSearcher.java",0,0.728395061728395,3,3,6
"solr/core/src/test/org/apache/solr/search/TestLFUCache.java",0,1,0,1,1
"solr/core/src/test/org/apache/solr/search/TestLRUCache.java",0,0.867647058823529,0,2,2
"solr/core/src/test/org/apache/solr/search/TestPseudoReturnFields.java",0,0.993449781659389,2,1,3
"solr/core/src/test/org/apache/solr/search/TestQueryTypes.java",0,0.926630434782609,2,2,4
"solr/core/src/test/org/apache/solr/search/TestQueryUtils.java",0,0.965156794425087,3,1,4
"solr/core/src/test/org/apache/solr/search/TestRangeQuery.java",0,0.909722222222222,2,2,4
"solr/core/src/test/org/apache/solr/search/TestRealTimeGet.java",0,0.524555903866249,4,2,6
"solr/core/src/test/org/apache/solr/search/TestRecovery.java",0,0.615698267074414,3,2,5
"solr/core/src/test/org/apache/solr/search/TestSearchPerf.java",0,0.972111553784861,4,1,5
"solr/core/src/test/org/apache/solr/search/TestSolrQueryParser.java",0,0.961538461538462,2,1,3
"solr/core/src/test/org/apache/solr/search/TestSort.java",0,0.593167701863354,7,2,9
"solr/core/src/test/org/apache/solr/search/TestSurroundQueryParser.java",0,1,0,1,1
"solr/core/src/test/org/apache/solr/search/TestValueSourceCache.java",0,1,0,1,1
"solr/core/src/test/org/apache/solr/search/function/NvlValueSourceParser.java",0,0.658227848101266,2,3,5
"solr/core/src/test/org/apache/solr/search/function/SortByFunctionTest.java",0,0.658730158730159,1,3,4
"solr/core/src/test/org/apache/solr/search/function/TestFunctionQuery.java",0,0.705882352941177,8,2,10
"solr/core/src/test/org/apache/solr/search/function/distance/DistanceFunctionTest.java",0,0.513513513513513,3,3,6
"solr/core/src/test/org/apache/solr/search/similarities/BaseSimilarityTestCase.java",0,0.975,1,1,2
"solr/core/src/test/org/apache/solr/search/similarities/CustomSimilarityFactory.java",0,0.555555555555556,1,3,4
"solr/core/src/test/org/apache/solr/search/similarities/MockConfigurableSimilarity.java",0,0.483870967741935,1,3,4
"solr/core/src/test/org/apache/solr/search/similarities/TestBM25SimilarityFactory.java",0,0.978260869565217,1,1,2
"solr/core/src/test/org/apache/solr/search/similarities/TestDFRSimilarityFactory.java",0,0.986111111111111,1,1,2
"solr/core/src/test/org/apache/solr/search/similarities/TestDefaultSimilarityFactory.java",0,0.416666666666667,1,3,4
"solr/core/src/test/org/apache/solr/search/similarities/TestIBSimilarityFactory.java",0,0.983333333333333,1,1,2
"solr/core/src/test/org/apache/solr/search/similarities/TestLMDirichletSimilarityFactory.java",0,0.977777777777778,1,1,2
"solr/core/src/test/org/apache/solr/search/similarities/TestLMJelinekMercerSimilarityFactory.java",0,0.977777777777778,1,1,2
"solr/core/src/test/org/apache/solr/search/similarities/TestPerFieldSimilarity.java",0,0.986842105263158,1,1,2
"solr/core/src/test/org/apache/solr/servlet/CacheHeaderTest.java",0,0.408560311284047,4,3,7
"solr/core/src/test/org/apache/solr/servlet/CacheHeaderTestBase.java",0,0.493506493506494,3,3,6
"solr/core/src/test/org/apache/solr/servlet/DirectSolrConnectionTest.java",0,0.964705882352941,2,1,3
"solr/core/src/test/org/apache/solr/servlet/NoCacheHeaderTest.java",0,0.578034682080925,0,4,4
"solr/core/src/test/org/apache/solr/servlet/SolrRequestParserTest.java",0,0.391534391534392,2,4,6
"solr/core/src/test/org/apache/solr/spelling/DirectSolrSpellCheckerTest.java",0,0.948453608247423,3,1,4
"solr/core/src/test/org/apache/solr/spelling/FileBasedSpellCheckerTest.java",0,0.701657458563536,5,2,7
"solr/core/src/test/org/apache/solr/spelling/IndexBasedSpellCheckerTest.java",0,0.75,7,3,10
"solr/core/src/test/org/apache/solr/spelling/SampleComparator.java",0,0.972222222222222,1,1,2
"solr/core/src/test/org/apache/solr/spelling/SimpleQueryConverter.java",0,0.526315789473684,1,4,5
"solr/core/src/test/org/apache/solr/spelling/SpellCheckCollatorTest.java",0,0.432558139534884,1,5,6
"solr/core/src/test/org/apache/solr/spelling/SpellPossibilityIteratorTest.java",0,0.526315789473684,2,3,5
"solr/core/src/test/org/apache/solr/spelling/SpellingQueryConverterTest.java",0,0.420792079207921,3,3,6
"solr/core/src/test/org/apache/solr/spelling/TestSuggestSpellingConverter.java",0,0.972602739726027,2,1,3
"solr/core/src/test/org/apache/solr/spelling/WordBreakSolrSpellCheckerTest.java",0,0.99645390070922,1,1,2
"solr/core/src/test/org/apache/solr/spelling/suggest/SuggesterFSTTest.java",0,0.666666666666667,1,2,3
"solr/core/src/test/org/apache/solr/spelling/suggest/SuggesterTSTTest.java",0,0.666666666666667,1,2,3
"solr/core/src/test/org/apache/solr/spelling/suggest/SuggesterTest.java",0,0.341463414634146,1,4,5
"solr/core/src/test/org/apache/solr/spelling/suggest/SuggesterWFSTTest.java",0,0.958333333333333,1,1,2
"solr/core/src/test/org/apache/solr/spelling/suggest/TestPhraseSuggestions.java",0,0.978260869565217,1,1,2
"solr/core/src/test/org/apache/solr/update/AutoCommitTest.java",0,0.330409356725146,2,5,7
"solr/core/src/test/org/apache/solr/update/DirectUpdateHandlerOptimizeTest.java",0,0.700934579439252,2,2,4
"solr/core/src/test/org/apache/solr/update/DirectUpdateHandlerTest.java",0,0.507288629737609,1,4,5
"solr/core/src/test/org/apache/solr/update/DocumentBuilderTest.java",0,0.558823529411765,3,3,6
"solr/core/src/test/org/apache/solr/update/DummyMergePolicy.java",0,1,0,1,1
"solr/core/src/test/org/apache/solr/update/PeerSyncTest.java",0,0.767955801104972,1,3,4
"solr/core/src/test/org/apache/solr/update/SoftAutoCommitTest.java",0,0.968503937007874,3,1,4
"solr/core/src/test/org/apache/solr/update/SolrCmdDistributorTest.java",0,0.976331360946746,2,1,3
"solr/core/src/test/org/apache/solr/update/SolrIndexConfigTest.java",0,1,0,1,1
"solr/core/src/test/org/apache/solr/update/TestIndexingPerformance.java",0,0.781954887218045,0,3,3
"solr/core/src/test/org/apache/solr/update/TestUpdate.java",0,0.995192307692308,1,1,2
"solr/core/src/test/org/apache/solr/update/UpdateParamsTest.java",0,0.881578947368421,2,2,4
"solr/core/src/test/org/apache/solr/update/processor/CustomUpdateRequestProcessor.java",0,1,0,1,1
"solr/core/src/test/org/apache/solr/update/processor/CustomUpdateRequestProcessorFactory.java",0,0.955555555555556,1,1,2
"solr/core/src/test/org/apache/solr/update/processor/DefaultValueUpdateProcessorTest.java",0,1,0,1,1
"solr/core/src/test/org/apache/solr/update/processor/FieldMutatingUpdateProcessorTest.java",0,0.995449374288965,1,1,2
"solr/core/src/test/org/apache/solr/update/processor/SignatureUpdateProcessorFactoryTest.java",0,0.493261455525606,4,2,6
"solr/core/src/test/org/apache/solr/update/processor/URLClassifyProcessorTest.java",0,0.990384615384615,1,1,2
"solr/core/src/test/org/apache/solr/update/processor/UniqFieldsUpdateProcessorFactoryTest.java",0,0.975609756097561,2,1,3
"solr/core/src/test/org/apache/solr/update/processor/UpdateRequestProcessorFactoryTest.java",0,0.504950495049505,1,2,3
"solr/core/src/test/org/apache/solr/util/BitSetPerf.java",0,0.964285714285714,3,1,4
"solr/core/src/test/org/apache/solr/util/CircularListTest.java",0,0.98,1,1,2
"solr/core/src/test/org/apache/solr/util/DOMUtilTest.java",0,0.88135593220339,1,2,3
"solr/core/src/test/org/apache/solr/util/DateMathParserTest.java",0,0.988338192419825,2,1,3
"solr/core/src/test/org/apache/solr/util/FileUtilsTest.java",0,0.757575757575758,0,4,4
"solr/core/src/test/org/apache/solr/util/PrimUtilsTest.java",0,0.923913043478261,0,2,2
"solr/core/src/test/org/apache/solr/util/SolrPluginUtilsTest.java",0,0.826086956521739,4,2,6
"solr/core/src/test/org/apache/solr/util/TestNumberUtils.java",0,0.902527075812274,2,2,4
"solr/core/src/test/org/apache/solr/util/TestSystemIdResolver.java",0,0.808219178082192,0,3,3
"solr/core/src/test/org/apache/solr/util/TestUtils.java",0,0.473684210526316,7,2,9
"solr/core/src/test/org/apache/solr/util/TimeZoneUtilsTest.java",0,1,0,1,1
"solr/solrj/src/java/org/apache/noggit/CharArr.java",0,0.997159090909091,1,1,2
"solr/solrj/src/java/org/apache/noggit/CharUtil.java",0,0.981132075471698,1,1,2
"solr/solrj/src/java/org/apache/noggit/JSONParser.java",0,0.998803827751196,1,1,2
"solr/solrj/src/java/org/apache/noggit/JSONUtil.java",0,0.993827160493827,1,1,2
"solr/solrj/src/java/org/apache/noggit/JSONWriter.java",0,0.997076023391813,1,1,2
"solr/solrj/src/java/org/apache/noggit/ObjectBuilder.java",0,0.993421052631579,1,1,2
"solr/solrj/src/java/org/apache/solr/client/solrj/ResponseParser.java",0,0.795454545454545,2,2,4
"solr/solrj/src/java/org/apache/solr/client/solrj/SolrQuery.java",0,0.620977353992849,8,3,11
"solr/solrj/src/java/org/apache/solr/client/solrj/SolrRequest.java",0,0.636363636363636,2,2,4
"solr/solrj/src/java/org/apache/solr/client/solrj/SolrResponse.java",0,0.857142857142857,2,2,4
"solr/solrj/src/java/org/apache/solr/client/solrj/SolrServer.java",0,0.552,9,2,11
"solr/solrj/src/java/org/apache/solr/client/solrj/SolrServerException.java",0,0.962962962962963,2,1,3
"solr/solrj/src/java/org/apache/solr/client/solrj/StreamingResponseCallback.java",0,0.972972972972973,1,1,2
"solr/solrj/src/java/org/apache/solr/client/solrj/beans/BindingException.java",0,1,0,1,1
"solr/solrj/src/java/org/apache/solr/client/solrj/beans/DocumentObjectBinder.java",0,0.403061224489796,3,3,6
"solr/solrj/src/java/org/apache/solr/client/solrj/beans/Field.java",0,0.914285714285714,3,1,4
"solr/solrj/src/java/org/apache/solr/client/solrj/impl/BinaryRequestWriter.java",0,0.87719298245614,3,2,5
"solr/solrj/src/java/org/apache/solr/client/solrj/impl/BinaryResponseParser.java",0,0.724137931034483,2,4,6
"solr/solrj/src/java/org/apache/solr/client/solrj/impl/CloudSolrServer.java",0,0.834101382488479,1,3,4
"solr/solrj/src/java/org/apache/solr/client/solrj/impl/ConcurrentUpdateSolrServer.java",0,0.982142857142857,2,1,3
"solr/solrj/src/java/org/apache/solr/client/solrj/impl/HttpClientUtil.java",0,0.996784565916399,1,1,2
"solr/solrj/src/java/org/apache/solr/client/solrj/impl/HttpSolrServer.java",0,0.967479674796748,4,1,5
"solr/solrj/src/java/org/apache/solr/client/solrj/impl/LBHttpSolrServer.java",0,0.581239530988275,6,2,8
"solr/solrj/src/java/org/apache/solr/client/solrj/impl/StreamingBinaryResponseParser.java",0,0.978021978021978,2,1,3
"solr/solrj/src/java/org/apache/solr/client/solrj/impl/XMLResponseParser.java",0,0.828507795100223,7,2,9
"solr/solrj/src/java/org/apache/solr/client/solrj/request/AbstractUpdateRequest.java",0,0.89041095890411,1,2,3
"solr/solrj/src/java/org/apache/solr/client/solrj/request/ContentStreamUpdateRequest.java",0,0.935897435897436,1,2,3
"solr/solrj/src/java/org/apache/solr/client/solrj/request/CoreAdminRequest.java",0,0.367741935483871,4,4,8
"solr/solrj/src/java/org/apache/solr/client/solrj/request/DirectXmlRequest.java",0,0.847222222222222,3,2,5
"solr/solrj/src/java/org/apache/solr/client/solrj/request/DocumentAnalysisRequest.java",0,0.990338164251208,2,1,3
"solr/solrj/src/java/org/apache/solr/client/solrj/request/FieldAnalysisRequest.java",0,0.982078853046595,4,1,5
"solr/solrj/src/java/org/apache/solr/client/solrj/request/JavaBinUpdateRequestCodec.java",0,0.822966507177033,5,2,7
"solr/solrj/src/java/org/apache/solr/client/solrj/request/LukeRequest.java",0,0.968253968253968,3,1,4
"solr/solrj/src/java/org/apache/solr/client/solrj/request/QueryRequest.java",0,0.833333333333333,4,2,6
"solr/solrj/src/java/org/apache/solr/client/solrj/request/RequestWriter.java",0,0.985074626865672,2,1,3
"solr/solrj/src/java/org/apache/solr/client/solrj/request/SolrPing.java",0,0.90625,4,1,5
"solr/solrj/src/java/org/apache/solr/client/solrj/request/UpdateRequest.java",0,0.75,7,2,9
"solr/solrj/src/java/org/apache/solr/client/solrj/request/UpdateRequestExt.java",0,0.996031746031746,1,1,2
"solr/solrj/src/java/org/apache/solr/client/solrj/response/AnalysisResponseBase.java",0,0.972222222222222,2,1,3
"solr/solrj/src/java/org/apache/solr/client/solrj/response/CoreAdminResponse.java",0,0.96551724137931,2,1,3
"solr/solrj/src/java/org/apache/solr/client/solrj/response/DocumentAnalysisResponse.java",0,0.89453125,1,2,3
"solr/solrj/src/java/org/apache/solr/client/solrj/response/FacetField.java",0,0.829545454545455,2,2,4
"solr/solrj/src/java/org/apache/solr/client/solrj/response/FieldAnalysisResponse.java",0,0.838235294117647,1,2,3
"solr/solrj/src/java/org/apache/solr/client/solrj/response/FieldStatsInfo.java",0,0.969512195121951,3,1,4
"solr/solrj/src/java/org/apache/solr/client/solrj/response/Group.java",0,1,0,1,1
"solr/solrj/src/java/org/apache/solr/client/solrj/response/GroupCommand.java",0,1,0,1,1
"solr/solrj/src/java/org/apache/solr/client/solrj/response/GroupResponse.java",0,1,0,1,1
"solr/solrj/src/java/org/apache/solr/client/solrj/response/LukeResponse.java",0,0.574074074074074,2,2,4
"solr/solrj/src/java/org/apache/solr/client/solrj/response/PivotField.java",0,0.986301369863014,1,1,2
"solr/solrj/src/java/org/apache/solr/client/solrj/response/QueryResponse.java",0,0.566191446028513,4,4,8
"solr/solrj/src/java/org/apache/solr/client/solrj/response/RangeFacet.java",0,1,0,1,1
"solr/solrj/src/java/org/apache/solr/client/solrj/response/SolrPingResponse.java",0,0.928571428571429,2,1,3
"solr/solrj/src/java/org/apache/solr/client/solrj/response/SolrResponseBase.java",0,0.813186813186813,3,2,5
"solr/solrj/src/java/org/apache/solr/client/solrj/response/SpellCheckResponse.java",0,0.421428571428571,2,4,6
"solr/solrj/src/java/org/apache/solr/client/solrj/response/TermsResponse.java",0,0.955056179775281,1,1,2
"solr/solrj/src/java/org/apache/solr/client/solrj/response/UpdateResponse.java",0,0.933333333333333,2,1,3
"solr/solrj/src/java/org/apache/solr/client/solrj/util/ClientUtils.java",0,0.575875486381323,10,4,14
"solr/solrj/src/java/org/apache/solr/common/SolrDocument.java",0,0.951612903225806,5,1,6
"solr/solrj/src/java/org/apache/solr/common/SolrDocumentList.java",0,0.838235294117647,3,2,5
"solr/solrj/src/java/org/apache/solr/common/SolrException.java",0,0.532544378698225,5,4,9
"solr/solrj/src/java/org/apache/solr/common/SolrInputDocument.java",0,0.948497854077253,4,1,5
"solr/solrj/src/java/org/apache/solr/common/SolrInputField.java",0,0.985148514851485,3,1,4
"solr/solrj/src/java/org/apache/solr/common/cloud/CloudState.java",0,0.806451612903226,1,2,3
"solr/solrj/src/java/org/apache/solr/common/cloud/ConnectionManager.java",0,0.993103448275862,1,1,2
"solr/solrj/src/java/org/apache/solr/common/cloud/DefaultConnectionStrategy.java",0,0.982456140350877,1,1,2
"solr/solrj/src/java/org/apache/solr/common/cloud/HashPartitioner.java",0,0.984126984126984,1,1,2
"solr/solrj/src/java/org/apache/solr/common/cloud/OnReconnect.java",0,0.954545454545455,1,1,2
"solr/solrj/src/java/org/apache/solr/common/cloud/SafeStopThread.java",0,0.956521739130435,1,1,2
"solr/solrj/src/java/org/apache/solr/common/cloud/Slice.java",0,0.769230769230769,1,2,3
"solr/solrj/src/java/org/apache/solr/common/cloud/SolrZkClient.java",0,0.988286969253294,2,1,3
"solr/solrj/src/java/org/apache/solr/common/cloud/ZkClientConnectionStrategy.java",0,0.972972972972973,1,1,2
"solr/solrj/src/java/org/apache/solr/common/cloud/ZkCmdExecutor.java",0,0.991379310344828,1,1,2
"solr/solrj/src/java/org/apache/solr/common/cloud/ZkCoreNodeProps.java",0,0.986486486486487,1,1,2
"solr/solrj/src/java/org/apache/solr/common/cloud/ZkNodeProps.java",0,0.724137931034483,2,2,4
"solr/solrj/src/java/org/apache/solr/common/cloud/ZkOperation.java",0,1,0,1,1
"solr/solrj/src/java/org/apache/solr/common/cloud/ZkStateReader.java",0,0.942622950819672,3,1,4
"solr/solrj/src/java/org/apache/solr/common/cloud/ZooKeeperException.java",0,0.96969696969697,1,1,2
"solr/solrj/src/java/org/apache/solr/common/luke/FieldFlag.java",0,0.529411764705882,3,3,6
"solr/solrj/src/java/org/apache/solr/common/params/AnalysisParams.java",0,0.966666666666667,2,1,3
"solr/solrj/src/java/org/apache/solr/common/params/AppendedSolrParams.java",0,0.836363636363636,0,3,3
"solr/solrj/src/java/org/apache/solr/common/params/CommonParams.java",0,0.398963730569948,4,4,8
"solr/solrj/src/java/org/apache/solr/common/params/CoreAdminParams.java",0,0.584905660377358,3,4,7
"solr/solrj/src/java/org/apache/solr/common/params/DefaultSolrParams.java",0,0.646153846153846,1,4,5
"solr/solrj/src/java/org/apache/solr/common/params/DisMaxParams.java",0,0.435897435897436,0,4,4
"solr/solrj/src/java/org/apache/solr/common/params/EventParams.java",0,0.96551724137931,1,1,2
"solr/solrj/src/java/org/apache/solr/common/params/FacetParams.java",0,0.449438202247191,2,3,5
"solr/solrj/src/java/org/apache/solr/common/params/GroupParams.java",0,0.577464788732394,1,2,3
"solr/solrj/src/java/org/apache/solr/common/params/HighlightParams.java",0,0.602941176470588,4,3,7
"solr/solrj/src/java/org/apache/solr/common/params/MapSolrParams.java",0,0.826666666666667,2,3,5
"solr/solrj/src/java/org/apache/solr/common/params/ModifiableSolrParams.java",0,0.961904761904762,3,1,4
"solr/solrj/src/java/org/apache/solr/common/params/MoreLikeThisParams.java",0,0.931506849315068,3,1,4
"solr/solrj/src/java/org/apache/solr/common/params/MultiMapSolrParams.java",0,0.858695652173913,3,2,5
"solr/solrj/src/java/org/apache/solr/common/params/QueryElevationParams.java",0,0.666666666666667,1,2,3
"solr/solrj/src/java/org/apache/solr/common/params/RequiredSolrParams.java",0,0.675496688741722,1,3,4
"solr/solrj/src/java/org/apache/solr/common/params/ShardParams.java",0,0.6875,2,3,5
"solr/solrj/src/java/org/apache/solr/common/params/SolrParams.java",0,0.48,6,5,11
"solr/solrj/src/java/org/apache/solr/common/params/SpatialParams.java",0,0.951219512195122,2,1,3
"solr/solrj/src/java/org/apache/solr/common/params/SpellingParams.java",0,0.516129032258065,1,4,5
"solr/solrj/src/java/org/apache/solr/common/params/StatsParams.java",0,0.962962962962963,1,1,2
"solr/solrj/src/java/org/apache/solr/common/params/TermVectorParams.java",0,0.984848484848485,1,1,2
"solr/solrj/src/java/org/apache/solr/common/params/TermsParams.java",0,0.616666666666667,2,3,5
"solr/solrj/src/java/org/apache/solr/common/params/UpdateParams.java",0,0.414285714285714,4,5,9
"solr/solrj/src/java/org/apache/solr/common/util/Base64.java",0,0.993464052287582,1,1,2
"solr/solrj/src/java/org/apache/solr/common/util/ByteUtils.java",0,0.984126984126984,2,1,3
"solr/solrj/src/java/org/apache/solr/common/util/ContentStream.java",0,0.827160493827161,3,2,5
"solr/solrj/src/java/org/apache/solr/common/util/ContentStreamBase.java",0,0.773504273504274,4,2,6
"solr/solrj/src/java/org/apache/solr/common/util/DateUtil.java",0,0.75,2,2,4
"solr/solrj/src/java/org/apache/solr/common/util/FastInputStream.java",0,0.84453781512605,2,2,4
"solr/solrj/src/java/org/apache/solr/common/util/FastOutputStream.java",0,0.91304347826087,3,2,5
"solr/solrj/src/java/org/apache/solr/common/util/Hash.java",0,0.80952380952381,1,2,3
"solr/solrj/src/java/org/apache/solr/common/util/IteratorChain.java",0,0.890243902439024,2,2,4
"solr/solrj/src/java/org/apache/solr/common/util/JavaBinCodec.java",0,0.79746835443038,5,2,7
"solr/solrj/src/java/org/apache/solr/common/util/NamedList.java",0,0.468599033816425,4,4,8
"solr/solrj/src/java/org/apache/solr/common/util/SimpleOrderedMap.java",0,0.835820895522388,1,2,3
"solr/solrj/src/java/org/apache/solr/common/util/StrUtils.java",0,0.777777777777778,5,3,8
"solr/solrj/src/java/org/apache/solr/common/util/XML.java",0,0.598086124401914,2,5,7
"solr/solrj/src/java/org/apache/solr/common/util/XMLErrorLogger.java",0,0.987012987012987,1,1,2
"solr/solrj/src/java/org/apache/zookeeper/SolrZooKeeper.java",0,0.706896551724138,1,2,3
"solr/solrj/src/test/org/apache/solr/client/solrj/LargeVolumeTestBase.java",0,0.806451612903226,3,2,5
"solr/solrj/src/test/org/apache/solr/client/solrj/MergeIndexesExampleTestBase.java",0,0.781914893617021,4,2,6
"solr/solrj/src/test/org/apache/solr/client/solrj/MultiCoreExampleTestBase.java",0,0.523364485981308,8,3,11
"solr/solrj/src/test/org/apache/solr/client/solrj/SolrExampleBinaryTest.java",0,0.916666666666667,3,1,4
"solr/solrj/src/test/org/apache/solr/client/solrj/SolrExampleTestBase.java",0,0.915254237288136,5,1,6
"solr/solrj/src/test/org/apache/solr/client/solrj/SolrExampleTests.java",0,0.639810426540284,9,4,13
"solr/solrj/src/test/org/apache/solr/client/solrj/SolrExampleXMLTest.java",0,0.980392156862745,1,1,2
"solr/solrj/src/test/org/apache/solr/client/solrj/SolrExceptionTest.java",0,0.696428571428571,2,5,7
"solr/solrj/src/test/org/apache/solr/client/solrj/SolrQueryTest.java",0,0.38,5,5,10
"solr/solrj/src/test/org/apache/solr/client/solrj/StartSolrJetty.java",0,0.971830985915493,2,1,3
"solr/solrj/src/test/org/apache/solr/client/solrj/TestBatchUpdate.java",0,0.807692307692308,4,2,6
"solr/solrj/src/test/org/apache/solr/client/solrj/TestLBHttpSolrServer.java",0,0.666666666666667,6,3,9
"solr/solrj/src/test/org/apache/solr/client/solrj/beans/TestDocumentObjectBinder.java",0,0.503846153846154,2,3,5
"solr/solrj/src/test/org/apache/solr/client/solrj/embedded/AbstractEmbeddedSolrServerTestCase.java",0,0.99,1,1,2
"solr/solrj/src/test/org/apache/solr/client/solrj/embedded/JettyWebappTest.java",0,0.646464646464647,7,2,9
"solr/solrj/src/test/org/apache/solr/client/solrj/embedded/LargeVolumeBinaryJettyTest.java",0,0.8125,1,3,4
"solr/solrj/src/test/org/apache/solr/client/solrj/embedded/LargeVolumeEmbeddedTest.java",0,0.793103448275862,1,3,4
"solr/solrj/src/test/org/apache/solr/client/solrj/embedded/LargeVolumeJettyTest.java",0,0.793103448275862,1,3,4
"solr/solrj/src/test/org/apache/solr/client/solrj/embedded/MergeIndexesEmbeddedTest.java",0,0.944444444444444,3,1,4
"solr/solrj/src/test/org/apache/solr/client/solrj/embedded/MultiCoreEmbeddedTest.java",0,0.835820895522388,3,2,5
"solr/solrj/src/test/org/apache/solr/client/solrj/embedded/MultiCoreExampleJettyTest.java",0,0.832258064516129,5,2,7
"solr/solrj/src/test/org/apache/solr/client/solrj/embedded/SolrExampleEmbeddedTest.java",0,0.805555555555556,2,3,5
"solr/solrj/src/test/org/apache/solr/client/solrj/embedded/SolrExampleJettyTest.java",0,0.792452830188679,3,2,5
"solr/solrj/src/test/org/apache/solr/client/solrj/embedded/SolrExampleStreamingBinaryTest.java",0,0.470588235294118,1,3,4
"solr/solrj/src/test/org/apache/solr/client/solrj/embedded/SolrExampleStreamingTest.java",0,0.6875,3,3,6
"solr/solrj/src/test/org/apache/solr/client/solrj/embedded/TestEmbeddedSolrServer.java",0,0.480519480519481,2,3,5
"solr/solrj/src/test/org/apache/solr/client/solrj/embedded/TestSolrProperties.java",0,0.422310756972112,7,4,11
"solr/solrj/src/test/org/apache/solr/client/solrj/impl/BasicHttpSolrServerTest.java",0,0.995454545454545,2,1,3
"solr/solrj/src/test/org/apache/solr/client/solrj/impl/HttpClientUtilTest.java",0,0.984126984126984,1,1,2
"solr/solrj/src/test/org/apache/solr/client/solrj/request/TestUpdateRequestCodec.java",0,0.486772486772487,3,2,5
"solr/solrj/src/test/org/apache/solr/client/solrj/response/AnlysisResponseBaseTest.java",0,0.966942148760331,3,1,4
"solr/solrj/src/test/org/apache/solr/client/solrj/response/DocumentAnalysisResponseTest.java",0,0.967105263157895,3,1,4
"solr/solrj/src/test/org/apache/solr/client/solrj/response/FacetFieldTest.java",0,1,0,1,1
"solr/solrj/src/test/org/apache/solr/client/solrj/response/FieldAnalysisResponseTest.java",0,0.959349593495935,3,1,4
"solr/solrj/src/test/org/apache/solr/client/solrj/response/QueryResponseTest.java",0,0.751131221719457,5,2,7
"solr/solrj/src/test/org/apache/solr/client/solrj/response/TermsResponseTest.java",0,0.730769230769231,4,3,7
"solr/solrj/src/test/org/apache/solr/client/solrj/response/TestSpellCheckResponse.java",0,0.441624365482233,3,5,8
"solr/solrj/src/test/org/apache/solr/client/solrj/util/ClientUtilsTest.java",0,0.891891891891892,2,2,4
"solr/solrj/src/test/org/apache/solr/common/SolrDocumentTest.java",0,0.984455958549223,2,1,3
"solr/solrj/src/test/org/apache/solr/common/params/ModifiableSolrParamsTest.java",0,0.904761904761905,3,1,4
"solr/solrj/src/test/org/apache/solr/common/params/SolrParamTest.java",0,0.913513513513514,4,1,5
"solr/solrj/src/test/org/apache/solr/common/util/ContentStreamTest.java",0,0.591304347826087,3,5,8
"solr/solrj/src/test/org/apache/solr/common/util/IteratorChainTest.java",0,0.866666666666667,4,2,6
"solr/solrj/src/test/org/apache/solr/common/util/NamedListTest.java",0,0.90625,1,2,3
"solr/solrj/src/test/org/apache/solr/common/util/TestFastInputStream.java",0,0.923913043478261,4,1,5
"solr/solrj/src/test/org/apache/solr/common/util/TestHash.java",0,0.96039603960396,3,1,4
"solr/solrj/src/test/org/apache/solr/common/util/TestJavaBinCodec.java",0,0.948717948717949,2,1,3
"solr/solrj/src/test/org/apache/solr/common/util/TestNamedListCodec.java",0,0.781132075471698,5,2,7
"solr/solrj/src/test/org/apache/solr/common/util/TestXMLEscaping.java",0,0.91304347826087,3,1,4
"solr/test-framework/src/java/org/apache/solr/BaseDistributedSearchTestCase.java",0,0.67842605156038,8,2,10
"solr/test-framework/src/java/org/apache/solr/JSONTestUtil.java",0,0.788659793814433,2,2,4
"solr/test-framework/src/java/org/apache/solr/SolrJettyTestBase.java",0,0.737864077669903,4,2,6
"solr/test-framework/src/java/org/apache/solr/SolrTestCaseJ4.java",0,0.765047135605511,7,2,9
"solr/test-framework/src/java/org/apache/solr/analysis/MockTokenizerFactory.java",0,0.952380952380952,2,1,3
"solr/test-framework/src/java/org/apache/solr/analysis/StringMockSolrResourceLoader.java",0,0.934782608695652,2,1,3
"solr/test-framework/src/java/org/apache/solr/core/MockDirectoryFactory.java",0,0.847457627118644,2,2,4
"solr/test-framework/src/java/org/apache/solr/core/MockFSDirectoryFactory.java",0,0.976190476190476,1,1,2
"solr/test-framework/src/java/org/apache/solr/update/processor/BufferingRequestProcessor.java",0,0.969230769230769,2,1,3
"solr/test-framework/src/java/org/apache/solr/util/AbstractSolrTestCase.java",0,0.463362068965517,7,5,12
"solr/test-framework/src/java/org/apache/solr/util/DOMUtilTestBase.java",0,0.982142857142857,1,1,2
"solr/test-framework/src/java/org/apache/solr/util/ExternalPaths.java",0,0.759259259259259,1,2,3
"solr/test-framework/src/java/org/apache/solr/util/TestHarness.java",0,0.506410256410256,9,3,12
"dev-tools/scripts/buildAndPushRelease.py",0,0.996587030716723,1,1,2
"dev-tools/scripts/checkJavaDocs.py",0,0.767441860465116,0,2,2
"dev-tools/scripts/checkJavadocLinks.py",0,0.874439461883408,1,2,3
"dev-tools/scripts/diffSources.py",0,1,0,1,1
"dev-tools/scripts/smokeTestRelease.py",0,0.500454959053685,0,3,3
"lucene/analysis/common/src/java/org/apache/lucene/analysis/charfilter/htmlentity.py",0,0.975881261595547,1,1,2
"lucene/core/src/java/org/apache/lucene/util/automaton/UTF32ToUTF8.py",0,1,0,1,1
"lucene/core/src/java/org/apache/lucene/util/automaton/createLevAutomata.py",0,0.959919839679359,1,1,2
"lucene/core/src/test/org/apache/lucene/util/makeEuroparlLineFile.py",0,1,0,1,1
"lucene/misc/src/java/org/apache/lucene/store/NativePosixUtil.cpp",0,0.947976878612717,2,1,3
"lucene/misc/src/java/org/apache/lucene/store/WindowsDirectory.cpp",0,1,0,1,1
