"Filename","X","LineOWN","LineMinor","LineMajor","LineNumDev"
"contrib/analyzers/common/src/java/org/apache/lucene/analysis/ar/ArabicAnalyzer.java",0,0.745222929936306,0,2,2
"contrib/analyzers/common/src/java/org/apache/lucene/analysis/ar/ArabicLetterTokenizer.java",0,0.777777777777778,0,3,3
"contrib/analyzers/common/src/java/org/apache/lucene/analysis/ar/ArabicNormalizationFilter.java",0,0.764705882352941,1,2,3
"contrib/analyzers/common/src/java/org/apache/lucene/analysis/ar/ArabicNormalizer.java",0,1,0,1,1
"contrib/analyzers/common/src/java/org/apache/lucene/analysis/ar/ArabicStemFilter.java",0,0.764705882352941,1,2,3
"contrib/analyzers/common/src/java/org/apache/lucene/analysis/ar/ArabicStemmer.java",0,0.99438202247191,1,1,2
"contrib/analyzers/common/src/java/org/apache/lucene/analysis/br/BrazilianAnalyzer.java",0,0.497175141242938,2,4,6
"contrib/analyzers/common/src/java/org/apache/lucene/analysis/br/BrazilianStemFilter.java",0,0.382352941176471,1,4,5
"contrib/analyzers/common/src/java/org/apache/lucene/analysis/br/BrazilianStemmer.java",0,0.941234084231146,5,1,6
"contrib/analyzers/common/src/java/org/apache/lucene/analysis/cjk/CJKAnalyzer.java",0,0.420168067226891,1,4,5
"contrib/analyzers/common/src/java/org/apache/lucene/analysis/cjk/CJKTokenizer.java",0,0.586750788643533,3,4,7
"contrib/analyzers/common/src/java/org/apache/lucene/analysis/cn/ChineseAnalyzer.java",0,0.453333333333333,0,4,4
"contrib/analyzers/common/src/java/org/apache/lucene/analysis/cn/ChineseFilter.java",0,0.524271844660194,0,7,7
"contrib/analyzers/common/src/java/org/apache/lucene/analysis/cn/ChineseTokenizer.java",0,0.454545454545455,3,4,7
"contrib/analyzers/common/src/java/org/apache/lucene/analysis/compound/CompoundWordTokenFilterBase.java",0,0.678571428571429,2,2,4
"contrib/analyzers/common/src/java/org/apache/lucene/analysis/compound/DictionaryCompoundWordTokenFilter.java",0,0.931623931623932,0,2,2
"contrib/analyzers/common/src/java/org/apache/lucene/analysis/compound/HyphenationCompoundWordTokenFilter.java",0,0.954545454545455,2,1,3
"contrib/analyzers/common/src/java/org/apache/lucene/analysis/compound/hyphenation/ByteVector.java",0,1,0,1,1
"contrib/analyzers/common/src/java/org/apache/lucene/analysis/compound/hyphenation/CharVector.java",0,1,0,1,1
"contrib/analyzers/common/src/java/org/apache/lucene/analysis/compound/hyphenation/Hyphen.java",0,1,0,1,1
"contrib/analyzers/common/src/java/org/apache/lucene/analysis/compound/hyphenation/Hyphenation.java",0,1,0,1,1
"contrib/analyzers/common/src/java/org/apache/lucene/analysis/compound/hyphenation/HyphenationException.java",0,1,0,1,1
"contrib/analyzers/common/src/java/org/apache/lucene/analysis/compound/hyphenation/HyphenationTree.java",0,0.997894736842105,1,1,2
"contrib/analyzers/common/src/java/org/apache/lucene/analysis/compound/hyphenation/PatternConsumer.java",0,1,0,1,1
"contrib/analyzers/common/src/java/org/apache/lucene/analysis/compound/hyphenation/PatternParser.java",0,0.998065764023211,1,1,2
"contrib/analyzers/common/src/java/org/apache/lucene/analysis/compound/hyphenation/TernaryTree.java",0,0.995475113122172,1,1,2
"contrib/analyzers/common/src/java/org/apache/lucene/analysis/cz/CzechAnalyzer.java",0,0.578034682080925,2,3,5
"contrib/analyzers/common/src/java/org/apache/lucene/analysis/de/GermanAnalyzer.java",0,0.609625668449198,3,2,5
"contrib/analyzers/common/src/java/org/apache/lucene/analysis/de/GermanStemFilter.java",0,0.65,2,4,6
"contrib/analyzers/common/src/java/org/apache/lucene/analysis/de/GermanStemmer.java",0,0.95910780669145,3,1,4
"contrib/analyzers/common/src/java/org/apache/lucene/analysis/el/GreekAnalyzer.java",0,0.763440860215054,0,2,2
"contrib/analyzers/common/src/java/org/apache/lucene/analysis/el/GreekCharsets.java",0,0.993775933609959,1,1,2
"contrib/analyzers/common/src/java/org/apache/lucene/analysis/el/GreekLowerCaseFilter.java",0,0.606060606060606,0,3,3
"contrib/analyzers/common/src/java/org/apache/lucene/analysis/fa/PersianAnalyzer.java",0,1,0,1,1
"contrib/analyzers/common/src/java/org/apache/lucene/analysis/fa/PersianNormalizationFilter.java",0,1,0,1,1
"contrib/analyzers/common/src/java/org/apache/lucene/analysis/fa/PersianNormalizer.java",0,1,0,1,1
"contrib/analyzers/common/src/java/org/apache/lucene/analysis/fr/ElisionFilter.java",0,0.596774193548387,2,3,5
"contrib/analyzers/common/src/java/org/apache/lucene/analysis/fr/FrenchAnalyzer.java",0,0.556149732620321,3,3,6
"contrib/analyzers/common/src/java/org/apache/lucene/analysis/fr/FrenchStemFilter.java",0,0.617021276595745,0,5,5
"contrib/analyzers/common/src/java/org/apache/lucene/analysis/fr/FrenchStemmer.java",0,0.938028169014084,4,1,5
"contrib/analyzers/common/src/java/org/apache/lucene/analysis/miscellaneous/EmptyTokenStream.java",0,0.688888888888889,0,2,2
"contrib/analyzers/common/src/java/org/apache/lucene/analysis/miscellaneous/PrefixAndSuffixAwareTokenFilter.java",0,0.790697674418605,1,2,3
"contrib/analyzers/common/src/java/org/apache/lucene/analysis/miscellaneous/PrefixAwareTokenFilter.java",0,0.504901960784314,1,2,3
"contrib/analyzers/common/src/java/org/apache/lucene/analysis/miscellaneous/SingleTokenTokenStream.java",0,0.528089887640449,2,3,5
"contrib/analyzers/common/src/java/org/apache/lucene/analysis/ngram/EdgeNGramTokenFilter.java",0,0.662721893491124,0,3,3
"contrib/analyzers/common/src/java/org/apache/lucene/analysis/ngram/EdgeNGramTokenizer.java",0,0.491735537190083,4,3,7
"contrib/analyzers/common/src/java/org/apache/lucene/analysis/ngram/NGramTokenFilter.java",0,0.52991452991453,0,3,3
"contrib/analyzers/common/src/java/org/apache/lucene/analysis/ngram/NGramTokenizer.java",0,0.477987421383648,3,3,6
"contrib/analyzers/common/src/java/org/apache/lucene/analysis/nl/DutchAnalyzer.java",0,0.464285714285714,1,4,5
"contrib/analyzers/common/src/java/org/apache/lucene/analysis/nl/DutchStemFilter.java",0,0.451327433628319,2,5,7
"contrib/analyzers/common/src/java/org/apache/lucene/analysis/nl/DutchStemmer.java",0,0.889434889434889,5,1,6
"contrib/analyzers/common/src/java/org/apache/lucene/analysis/nl/WordlistLoader.java",0,0.713178294573643,2,2,4
"contrib/analyzers/common/src/java/org/apache/lucene/analysis/payloads/AbstractEncoder.java",0,0.548387096774194,1,2,3
"contrib/analyzers/common/src/java/org/apache/lucene/analysis/payloads/DelimitedPayloadTokenFilter.java",0,0.964705882352941,1,1,2
"contrib/analyzers/common/src/java/org/apache/lucene/analysis/payloads/FloatEncoder.java",0,0.972972972972973,1,1,2
"contrib/analyzers/common/src/java/org/apache/lucene/analysis/payloads/IdentityEncoder.java",0,1,0,1,1
"contrib/analyzers/common/src/java/org/apache/lucene/analysis/payloads/IntegerEncoder.java",0,1,0,1,1
"contrib/analyzers/common/src/java/org/apache/lucene/analysis/payloads/NumericPayloadTokenFilter.java",0,0.638888888888889,0,2,2
"contrib/analyzers/common/src/java/org/apache/lucene/analysis/payloads/PayloadEncoder.java",0,0.95,0,2,2
"contrib/analyzers/common/src/java/org/apache/lucene/analysis/payloads/PayloadHelper.java",0,0.972972972972973,1,1,2
"contrib/analyzers/common/src/java/org/apache/lucene/analysis/payloads/TokenOffsetPayloadTokenFilter.java",0,0.6,0,2,2
"contrib/analyzers/common/src/java/org/apache/lucene/analysis/payloads/TypeAsPayloadTokenFilter.java",0,0.614285714285714,0,2,2
"contrib/analyzers/common/src/java/org/apache/lucene/analysis/position/PositionFilter.java",0,0.765957446808511,0,2,2
"contrib/analyzers/common/src/java/org/apache/lucene/analysis/query/QueryAutoStopWordAnalyzer.java",0,0.65034965034965,2,2,4
"contrib/analyzers/common/src/java/org/apache/lucene/analysis/reverse/ReverseStringFilter.java",0,0.484848484848485,0,3,3
"contrib/analyzers/common/src/java/org/apache/lucene/analysis/ru/RussianAnalyzer.java",0,0.739130434782609,4,2,6
"contrib/analyzers/common/src/java/org/apache/lucene/analysis/ru/RussianCharsets.java",0,0.856687898089172,2,2,4
"contrib/analyzers/common/src/java/org/apache/lucene/analysis/ru/RussianLetterTokenizer.java",0,0.539325842696629,1,4,5
"contrib/analyzers/common/src/java/org/apache/lucene/analysis/ru/RussianLowerCaseFilter.java",0,0.514285714285714,2,4,6
"contrib/analyzers/common/src/java/org/apache/lucene/analysis/ru/RussianStemFilter.java",0,0.551724137931034,3,4,7
"contrib/analyzers/common/src/java/org/apache/lucene/analysis/ru/RussianStemmer.java",0,0.962848297213622,4,1,5
"contrib/analyzers/common/src/java/org/apache/lucene/analysis/shingle/ShingleAnalyzerWrapper.java",0,0.402777777777778,0,3,3
"contrib/analyzers/common/src/java/org/apache/lucene/analysis/shingle/ShingleFilter.java",0,0.568181818181818,4,2,6
"contrib/analyzers/common/src/java/org/apache/lucene/analysis/shingle/ShingleMatrixFilter.java",0,0.89261744966443,3,2,5
"contrib/analyzers/common/src/java/org/apache/lucene/analysis/sinks/DateRecognizerSinkFilter.java",0,0.897058823529412,0,2,2
"contrib/analyzers/common/src/java/org/apache/lucene/analysis/sinks/DateRecognizerSinkTokenizer.java",0,0.943181818181818,2,1,3
"contrib/analyzers/common/src/java/org/apache/lucene/analysis/sinks/TokenRangeSinkFilter.java",0,1,0,1,1
"contrib/analyzers/common/src/java/org/apache/lucene/analysis/sinks/TokenRangeSinkTokenizer.java",0,0.964285714285714,1,1,2
"contrib/analyzers/common/src/java/org/apache/lucene/analysis/sinks/TokenTypeSinkFilter.java",0,0.951219512195122,1,1,2
"contrib/analyzers/common/src/java/org/apache/lucene/analysis/sinks/TokenTypeSinkTokenizer.java",0,0.946428571428571,2,1,3
"contrib/analyzers/common/src/java/org/apache/lucene/analysis/th/ThaiAnalyzer.java",0,0.5,1,2,3
"contrib/analyzers/common/src/java/org/apache/lucene/analysis/th/ThaiWordFilter.java",0,0.544554455445545,0,3,3
"contrib/analyzers/common/src/test/org/apache/lucene/analysis/ar/TestArabicAnalyzer.java",0,0.546666666666667,1,2,3
"contrib/analyzers/common/src/test/org/apache/lucene/analysis/ar/TestArabicNormalizationFilter.java",0,0.957446808510638,2,1,3
"contrib/analyzers/common/src/test/org/apache/lucene/analysis/ar/TestArabicStemFilter.java",0,0.934426229508197,3,1,4
"contrib/analyzers/common/src/test/org/apache/lucene/analysis/br/TestBrazilianStemmer.java",0,0.727848101265823,1,3,4
"contrib/analyzers/common/src/test/org/apache/lucene/analysis/cjk/TestCJKTokenizer.java",0,0.446969696969697,1,3,4
"contrib/analyzers/common/src/test/org/apache/lucene/analysis/cn/TestChineseTokenizer.java",0,0.627118644067797,2,5,7
"contrib/analyzers/common/src/test/org/apache/lucene/analysis/compound/TestCompoundWordTokenFilter.java",0,0.728813559322034,2,3,5
"contrib/analyzers/common/src/test/org/apache/lucene/analysis/cz/TestCzechAnalyzer.java",0,0.576470588235294,1,2,3
"contrib/analyzers/common/src/test/org/apache/lucene/analysis/de/TestGermanStemFilter.java",0,0.366336633663366,1,4,5
"contrib/analyzers/common/src/test/org/apache/lucene/analysis/el/GreekAnalyzerTest.java",0,0.727272727272727,1,2,3
"contrib/analyzers/common/src/test/org/apache/lucene/analysis/fa/TestPersianAnalyzer.java",0,0.990783410138249,1,1,2
"contrib/analyzers/common/src/test/org/apache/lucene/analysis/fa/TestPersianNormalizationFilter.java",0,0.9375,0,2,2
"contrib/analyzers/common/src/test/org/apache/lucene/analysis/fr/TestElision.java",0,0.866666666666667,1,2,3
"contrib/analyzers/common/src/test/org/apache/lucene/analysis/fr/TestFrenchAnalyzer.java",0,0.658682634730539,1,4,5
"contrib/analyzers/common/src/test/org/apache/lucene/analysis/miscellaneous/TestEmptyTokenStream.java",0,0.882352941176471,0,3,3
"contrib/analyzers/common/src/test/org/apache/lucene/analysis/miscellaneous/TestPrefixAndSuffixAwareTokenFilter.java",0,0.587301587301587,1,3,4
"contrib/analyzers/common/src/test/org/apache/lucene/analysis/miscellaneous/TestPrefixAwareTokenFilter.java",0,0.583333333333333,1,3,4
"contrib/analyzers/common/src/test/org/apache/lucene/analysis/miscellaneous/TestSingleTokenTokenFilter.java",0,0.681818181818182,1,2,3
"contrib/analyzers/common/src/test/org/apache/lucene/analysis/ngram/EdgeNGramTokenFilterTest.java",0,0.828571428571429,0,3,3
"contrib/analyzers/common/src/test/org/apache/lucene/analysis/ngram/EdgeNGramTokenizerTest.java",0,0.835051546391753,0,3,3
"contrib/analyzers/common/src/test/org/apache/lucene/analysis/ngram/NGramTokenFilterTest.java",0,0.768421052631579,1,3,4
"contrib/analyzers/common/src/test/org/apache/lucene/analysis/ngram/NGramTokenizerTest.java",0,0.75,2,2,4
"contrib/analyzers/common/src/test/org/apache/lucene/analysis/nl/TestDutchStemmer.java",0,0.662790697674419,0,3,3
"contrib/analyzers/common/src/test/org/apache/lucene/analysis/payloads/DelimitedPayloadTokenFilterTest.java",0,0.956834532374101,1,1,2
"contrib/analyzers/common/src/test/org/apache/lucene/analysis/payloads/NumericPayloadTokenFilterTest.java",0,0.63855421686747,1,2,3
"contrib/analyzers/common/src/test/org/apache/lucene/analysis/payloads/TokenOffsetPayloadTokenFilterTest.java",0,0.810344827586207,1,2,3
"contrib/analyzers/common/src/test/org/apache/lucene/analysis/payloads/TypeAsPayloadTokenFilterTest.java",0,0.653846153846154,1,2,3
"contrib/analyzers/common/src/test/org/apache/lucene/analysis/position/PositionFilterTest.java",0,0.642857142857143,0,3,3
"contrib/analyzers/common/src/test/org/apache/lucene/analysis/query/QueryAutoStopWordAnalyzerTest.java",0,0.681592039800995,2,2,4
"contrib/analyzers/common/src/test/org/apache/lucene/analysis/reverse/TestReverseStringFilter.java",0,0.552631578947368,1,3,4
"contrib/analyzers/common/src/test/org/apache/lucene/analysis/ru/TestRussianAnalyzer.java",0,0.595959595959596,4,4,8
"contrib/analyzers/common/src/test/org/apache/lucene/analysis/ru/TestRussianStem.java",0,0.872340425531915,0,3,3
"contrib/analyzers/common/src/test/org/apache/lucene/analysis/shingle/ShingleAnalyzerWrapperTest.java",0,0.678030303030303,3,2,5
"contrib/analyzers/common/src/test/org/apache/lucene/analysis/shingle/ShingleFilterTest.java",0,0.367469879518072,2,4,6
"contrib/analyzers/common/src/test/org/apache/lucene/analysis/shingle/TestShingleMatrixFilter.java",0,0.490942028985507,2,3,5
"contrib/analyzers/common/src/test/org/apache/lucene/analysis/sinks/DateRecognizerSinkTokenizerTest.java",0,0.631578947368421,0,3,3
"contrib/analyzers/common/src/test/org/apache/lucene/analysis/sinks/TokenRangeSinkTokenizerTest.java",0,0.6,1,2,3
"contrib/analyzers/common/src/test/org/apache/lucene/analysis/sinks/TokenTypeSinkTokenizerTest.java",0,0.534090909090909,2,2,4
"contrib/analyzers/common/src/test/org/apache/lucene/analysis/th/TestThaiAnalyzer.java",0,0.375,2,4,6
"contrib/analyzers/smartcn/src/java/org/apache/lucene/analysis/cn/smart/AnalyzerProfile.java",0,0.845360824742268,2,2,4
"contrib/analyzers/smartcn/src/java/org/apache/lucene/analysis/cn/smart/CharType.java",0,0.528571428571429,2,2,4
"contrib/analyzers/smartcn/src/java/org/apache/lucene/analysis/cn/smart/SentenceTokenizer.java",0,0.552238805970149,2,4,6
"contrib/analyzers/smartcn/src/java/org/apache/lucene/analysis/cn/smart/SmartChineseAnalyzer.java",0,0.527397260273973,2,2,4
"contrib/analyzers/smartcn/src/java/org/apache/lucene/analysis/cn/smart/Utility.java",0,0.728260869565217,2,2,4
"contrib/analyzers/smartcn/src/java/org/apache/lucene/analysis/cn/smart/WordSegmenter.java",0,0.684782608695652,2,3,5
"contrib/analyzers/smartcn/src/java/org/apache/lucene/analysis/cn/smart/WordTokenFilter.java",0,0.404255319148936,1,4,5
"contrib/analyzers/smartcn/src/java/org/apache/lucene/analysis/cn/smart/WordType.java",0,0.5,2,2,4
"contrib/analyzers/smartcn/src/java/org/apache/lucene/analysis/cn/smart/hhmm/AbstractDictionary.java",0,0.708920187793427,2,2,4
"contrib/analyzers/smartcn/src/java/org/apache/lucene/analysis/cn/smart/hhmm/BiSegGraph.java",0,0.883333333333333,2,2,4
"contrib/analyzers/smartcn/src/java/org/apache/lucene/analysis/cn/smart/hhmm/BigramDictionary.java",0,0.931159420289855,2,2,4
"contrib/analyzers/smartcn/src/java/org/apache/lucene/analysis/cn/smart/hhmm/HHMMSegmenter.java",0,0.892682926829268,2,2,4
"contrib/analyzers/smartcn/src/java/org/apache/lucene/analysis/cn/smart/hhmm/PathNode.java",0,0.545454545454545,2,2,4
"contrib/analyzers/smartcn/src/java/org/apache/lucene/analysis/cn/smart/hhmm/SegGraph.java",0,0.801324503311258,2,2,4
"contrib/analyzers/smartcn/src/java/org/apache/lucene/analysis/cn/smart/hhmm/SegToken.java",0,0.959349593495935,3,1,4
"contrib/analyzers/smartcn/src/java/org/apache/lucene/analysis/cn/smart/hhmm/SegTokenFilter.java",0,0.652777777777778,2,2,4
"contrib/analyzers/smartcn/src/java/org/apache/lucene/analysis/cn/smart/hhmm/SegTokenPair.java",0,0.516129032258065,2,2,4
"contrib/analyzers/smartcn/src/java/org/apache/lucene/analysis/cn/smart/hhmm/WordDictionary.java",0,0.91713747645951,2,2,4
"contrib/analyzers/smartcn/src/test/org/apache/lucene/analysis/cn/smart/TestSmartChineseAnalyzer.java",0,0.440789473684211,2,3,5
"contrib/ant/src/java/org/apache/lucene/ant/ConfigurableDocumentHandler.java",0,0.75,0,2,2
"contrib/ant/src/java/org/apache/lucene/ant/DocumentHandler.java",0,0.825,1,2,3
"contrib/ant/src/java/org/apache/lucene/ant/DocumentHandlerException.java",0,0.9125,1,2,3
"contrib/ant/src/java/org/apache/lucene/ant/FileExtensionDocumentHandler.java",0,0.876923076923077,2,2,4
"contrib/ant/src/java/org/apache/lucene/ant/HtmlDocument.java",0,0.761904761904762,2,2,4
"contrib/ant/src/java/org/apache/lucene/ant/IndexTask.java",0,0.97423887587822,3,1,4
"contrib/ant/src/java/org/apache/lucene/ant/TextDocument.java",0,0.897959183673469,3,2,5
"contrib/ant/src/test/org/apache/lucene/ant/DocumentTestCase.java",0,0.775,0,3,3
"contrib/ant/src/test/org/apache/lucene/ant/HtmlDocumentTest.java",0,0.869565217391304,0,2,2
"contrib/ant/src/test/org/apache/lucene/ant/IndexTaskTest.java",0,0.91304347826087,1,2,3
"contrib/ant/src/test/org/apache/lucene/ant/TextDocumentTest.java",0,0.866666666666667,0,2,2
"contrib/benchmark/src/java/org/apache/lucene/benchmark/Constants.java",0,1,0,1,1
"contrib/benchmark/src/java/org/apache/lucene/benchmark/byTask/Benchmark.java",0,0.992592592592593,1,1,2
"contrib/benchmark/src/java/org/apache/lucene/benchmark/byTask/PerfRunData.java",0,0.704119850187266,3,3,6
"contrib/benchmark/src/java/org/apache/lucene/benchmark/byTask/feeds/AbstractQueryMaker.java",0,1,0,1,1
"contrib/benchmark/src/java/org/apache/lucene/benchmark/byTask/feeds/ContentSource.java",0,1,0,1,1
"contrib/benchmark/src/java/org/apache/lucene/benchmark/byTask/feeds/DemoHTMLParser.java",0,0.858974358974359,0,2,2
"contrib/benchmark/src/java/org/apache/lucene/benchmark/byTask/feeds/DirContentSource.java",0,0.540650406504065,2,2,4
"contrib/benchmark/src/java/org/apache/lucene/benchmark/byTask/feeds/DocData.java",0,0.59375,0,2,2
"contrib/benchmark/src/java/org/apache/lucene/benchmark/byTask/feeds/DocMaker.java",0,0.775175644028103,0,3,3
"contrib/benchmark/src/java/org/apache/lucene/benchmark/byTask/feeds/EnwikiContentSource.java",0,1,0,1,1
"contrib/benchmark/src/java/org/apache/lucene/benchmark/byTask/feeds/EnwikiDocMaker.java",0,0.658536585365854,0,3,3
"contrib/benchmark/src/java/org/apache/lucene/benchmark/byTask/feeds/EnwikiQueryMaker.java",0,0.985185185185185,1,1,2
"contrib/benchmark/src/java/org/apache/lucene/benchmark/byTask/feeds/FileBasedQueryMaker.java",0,0.785714285714286,0,2,2
"contrib/benchmark/src/java/org/apache/lucene/benchmark/byTask/feeds/HTMLParser.java",0,0.92156862745098,0,2,2
"contrib/benchmark/src/java/org/apache/lucene/benchmark/byTask/feeds/LineDocMaker.java",0,0.833333333333333,0,2,2
"contrib/benchmark/src/java/org/apache/lucene/benchmark/byTask/feeds/LineDocSource.java",0,1,0,1,1
"contrib/benchmark/src/java/org/apache/lucene/benchmark/byTask/feeds/NoMoreDataException.java",0,0.962962962962963,1,1,2
"contrib/benchmark/src/java/org/apache/lucene/benchmark/byTask/feeds/QueryMaker.java",0,1,0,1,1
"contrib/benchmark/src/java/org/apache/lucene/benchmark/byTask/feeds/ReutersContentSource.java",0,1,0,1,1
"contrib/benchmark/src/java/org/apache/lucene/benchmark/byTask/feeds/ReutersQueryMaker.java",0,0.897435897435897,1,2,3
"contrib/benchmark/src/java/org/apache/lucene/benchmark/byTask/feeds/SimpleQueryMaker.java",0,0.838235294117647,1,3,4
"contrib/benchmark/src/java/org/apache/lucene/benchmark/byTask/feeds/SimpleSloppyPhraseQueryMaker.java",0,0.731707317073171,2,2,4
"contrib/benchmark/src/java/org/apache/lucene/benchmark/byTask/feeds/SingleDocSource.java",0,0.478260869565217,0,3,3
"contrib/benchmark/src/java/org/apache/lucene/benchmark/byTask/feeds/SortableSingleDocSource.java",0,1,0,1,1
"contrib/benchmark/src/java/org/apache/lucene/benchmark/byTask/feeds/TrecContentSource.java",0,1,0,1,1
"contrib/benchmark/src/java/org/apache/lucene/benchmark/byTask/programmatic/Sample.java",0,0.96,2,1,3
"contrib/benchmark/src/java/org/apache/lucene/benchmark/byTask/stats/Points.java",0,0.934065934065934,0,2,2
"contrib/benchmark/src/java/org/apache/lucene/benchmark/byTask/stats/Report.java",0,0.96875,2,1,3
"contrib/benchmark/src/java/org/apache/lucene/benchmark/byTask/stats/TaskStats.java",0,0.984375,2,1,3
"contrib/benchmark/src/java/org/apache/lucene/benchmark/byTask/tasks/AddDocTask.java",0,0.8125,0,3,3
"contrib/benchmark/src/java/org/apache/lucene/benchmark/byTask/tasks/BenchmarkHighlighter.java",0,1,0,1,1
"contrib/benchmark/src/java/org/apache/lucene/benchmark/byTask/tasks/ClearStatsTask.java",0,0.977272727272727,1,1,2
"contrib/benchmark/src/java/org/apache/lucene/benchmark/byTask/tasks/CloseIndexTask.java",0,0.645161290322581,1,2,3
"contrib/benchmark/src/java/org/apache/lucene/benchmark/byTask/tasks/CloseReaderTask.java",0,0.955555555555556,1,1,2
"contrib/benchmark/src/java/org/apache/lucene/benchmark/byTask/tasks/CommitIndexTask.java",0,0.614035087719298,0,2,2
"contrib/benchmark/src/java/org/apache/lucene/benchmark/byTask/tasks/ConsumeContentSourceTask.java",0,1,0,1,1
"contrib/benchmark/src/java/org/apache/lucene/benchmark/byTask/tasks/CreateIndexTask.java",0,0.748201438848921,1,2,3
"contrib/benchmark/src/java/org/apache/lucene/benchmark/byTask/tasks/DeleteByPercentTask.java",0,1,0,1,1
"contrib/benchmark/src/java/org/apache/lucene/benchmark/byTask/tasks/DeleteDocTask.java",0,0.75609756097561,1,3,4
"contrib/benchmark/src/java/org/apache/lucene/benchmark/byTask/tasks/FlushReaderTask.java",0,1,0,1,1
"contrib/benchmark/src/java/org/apache/lucene/benchmark/byTask/tasks/NearRealtimeReaderTask.java",0,1,0,1,1
"contrib/benchmark/src/java/org/apache/lucene/benchmark/byTask/tasks/NewAnalyzerTask.java",0,1,0,1,1
"contrib/benchmark/src/java/org/apache/lucene/benchmark/byTask/tasks/NewRoundTask.java",0,0.977272727272727,1,1,2
"contrib/benchmark/src/java/org/apache/lucene/benchmark/byTask/tasks/OpenIndexTask.java",0,0.620689655172414,0,3,3
"contrib/benchmark/src/java/org/apache/lucene/benchmark/byTask/tasks/OpenReaderTask.java",0,0.597938144329897,1,2,3
"contrib/benchmark/src/java/org/apache/lucene/benchmark/byTask/tasks/OptimizeTask.java",0,0.76,1,2,3
"contrib/benchmark/src/java/org/apache/lucene/benchmark/byTask/tasks/PerfTask.java",0,0.645569620253165,2,3,5
"contrib/benchmark/src/java/org/apache/lucene/benchmark/byTask/tasks/PrintReaderTask.java",0,1,0,1,1
"contrib/benchmark/src/java/org/apache/lucene/benchmark/byTask/tasks/ReadTask.java",0,0.378289473684211,1,3,4
"contrib/benchmark/src/java/org/apache/lucene/benchmark/byTask/tasks/ReadTokensTask.java",0,0.921985815602837,0,2,2
"contrib/benchmark/src/java/org/apache/lucene/benchmark/byTask/tasks/ReopenReaderTask.java",0,1,0,1,1
"contrib/benchmark/src/java/org/apache/lucene/benchmark/byTask/tasks/RepAllTask.java",0,0.525641025641026,0,2,2
"contrib/benchmark/src/java/org/apache/lucene/benchmark/byTask/tasks/RepSelectByPrefTask.java",0,0.56,0,2,2
"contrib/benchmark/src/java/org/apache/lucene/benchmark/byTask/tasks/RepSumByNameRoundTask.java",0,0.530864197530864,0,2,2
"contrib/benchmark/src/java/org/apache/lucene/benchmark/byTask/tasks/RepSumByNameTask.java",0,0.530864197530864,0,2,2
"contrib/benchmark/src/java/org/apache/lucene/benchmark/byTask/tasks/RepSumByPrefRoundTask.java",0,0.551282051282051,0,2,2
"contrib/benchmark/src/java/org/apache/lucene/benchmark/byTask/tasks/RepSumByPrefTask.java",0,1,0,1,1
"contrib/benchmark/src/java/org/apache/lucene/benchmark/byTask/tasks/ReportTask.java",0,0.722222222222222,1,2,3
"contrib/benchmark/src/java/org/apache/lucene/benchmark/byTask/tasks/ResetInputsTask.java",0,1,0,1,1
"contrib/benchmark/src/java/org/apache/lucene/benchmark/byTask/tasks/ResetSystemEraseTask.java",0,0.928571428571429,3,1,4
"contrib/benchmark/src/java/org/apache/lucene/benchmark/byTask/tasks/ResetSystemSoftTask.java",0,0.952380952380952,2,1,3
"contrib/benchmark/src/java/org/apache/lucene/benchmark/byTask/tasks/SearchTask.java",0,0.982142857142857,1,1,2
"contrib/benchmark/src/java/org/apache/lucene/benchmark/byTask/tasks/SearchTravRetHighlightTask.java",0,0.823943661971831,0,2,2
"contrib/benchmark/src/java/org/apache/lucene/benchmark/byTask/tasks/SearchTravRetLoadFieldSelectorTask.java",0,0.921052631578947,1,2,3
"contrib/benchmark/src/java/org/apache/lucene/benchmark/byTask/tasks/SearchTravRetTask.java",0,0.931818181818182,2,1,3
"contrib/benchmark/src/java/org/apache/lucene/benchmark/byTask/tasks/SearchTravRetVectorHighlightTask.java",0,1,0,1,1
"contrib/benchmark/src/java/org/apache/lucene/benchmark/byTask/tasks/SearchTravTask.java",0,0.730769230769231,0,2,2
"contrib/benchmark/src/java/org/apache/lucene/benchmark/byTask/tasks/SearchWithSortTask.java",0,0.623376623376623,1,2,3
"contrib/benchmark/src/java/org/apache/lucene/benchmark/byTask/tasks/SetPropTask.java",0,0.848484848484849,1,2,3
"contrib/benchmark/src/java/org/apache/lucene/benchmark/byTask/tasks/TaskSequence.java",0,0.714285714285714,2,3,5
"contrib/benchmark/src/java/org/apache/lucene/benchmark/byTask/tasks/UpdateDocTask.java",0,0.941860465116279,0,2,2
"contrib/benchmark/src/java/org/apache/lucene/benchmark/byTask/tasks/WarmTask.java",0,1,0,1,1
"contrib/benchmark/src/java/org/apache/lucene/benchmark/byTask/tasks/WriteLineDocTask.java",0,0.907142857142857,1,2,3
"contrib/benchmark/src/java/org/apache/lucene/benchmark/byTask/utils/Algorithm.java",0,0.896428571428571,2,2,4
"contrib/benchmark/src/java/org/apache/lucene/benchmark/byTask/utils/Config.java",0,0.765432098765432,2,3,5
"contrib/benchmark/src/java/org/apache/lucene/benchmark/byTask/utils/FileUtils.java",0,1,0,1,1
"contrib/benchmark/src/java/org/apache/lucene/benchmark/byTask/utils/Format.java",0,0.872,1,2,3
"contrib/benchmark/src/java/org/apache/lucene/benchmark/byTask/utils/StringBufferReader.java",0,0.994219653179191,1,1,2
"contrib/benchmark/src/java/org/apache/lucene/benchmark/quality/Judge.java",0,1,0,1,1
"contrib/benchmark/src/java/org/apache/lucene/benchmark/quality/QualityBenchmark.java",0,0.987577639751553,1,1,2
"contrib/benchmark/src/java/org/apache/lucene/benchmark/quality/QualityQuery.java",0,1,0,1,1
"contrib/benchmark/src/java/org/apache/lucene/benchmark/quality/QualityQueryParser.java",0,1,0,1,1
"contrib/benchmark/src/java/org/apache/lucene/benchmark/quality/QualityStats.java",0,0.996598639455782,1,1,2
"contrib/benchmark/src/java/org/apache/lucene/benchmark/quality/trec/QueryDriver.java",0,0.743243243243243,1,2,3
"contrib/benchmark/src/java/org/apache/lucene/benchmark/quality/trec/Trec1MQReader.java",0,1,0,1,1
"contrib/benchmark/src/java/org/apache/lucene/benchmark/quality/trec/TrecJudge.java",0,1,0,1,1
"contrib/benchmark/src/java/org/apache/lucene/benchmark/quality/trec/TrecTopicsReader.java",0,1,0,1,1
"contrib/benchmark/src/java/org/apache/lucene/benchmark/quality/utils/DocNameExtractor.java",0,1,0,1,1
"contrib/benchmark/src/java/org/apache/lucene/benchmark/quality/utils/QualityQueriesFinder.java",0,0.985185185185185,2,1,3
"contrib/benchmark/src/java/org/apache/lucene/benchmark/quality/utils/SimpleQQParser.java",0,1,0,1,1
"contrib/benchmark/src/java/org/apache/lucene/benchmark/quality/utils/SubmissionReport.java",0,1,0,1,1
"contrib/benchmark/src/java/org/apache/lucene/benchmark/stats/MemUsage.java",0,1,0,1,1
"contrib/benchmark/src/java/org/apache/lucene/benchmark/stats/QueryData.java",0,1,0,1,1
"contrib/benchmark/src/java/org/apache/lucene/benchmark/stats/TestData.java",0,0.989565217391304,1,1,2
"contrib/benchmark/src/java/org/apache/lucene/benchmark/stats/TestRunData.java",0,0.994252873563218,1,1,2
"contrib/benchmark/src/java/org/apache/lucene/benchmark/stats/TimeData.java",0,0.98019801980198,1,1,2
"contrib/benchmark/src/java/org/apache/lucene/benchmark/utils/ExtractReuters.java",0,0.994318181818182,1,1,2
"contrib/benchmark/src/java/org/apache/lucene/benchmark/utils/ExtractWikipedia.java",0,0.947712418300654,0,2,2
"contrib/benchmark/src/java/org/apache/lucene/benchmark/utils/NoDeletionPolicy.java",0,1,0,1,1
"contrib/benchmark/src/test/org/apache/lucene/benchmark/BenchmarkTestCase.java",0,1,0,1,1
"contrib/benchmark/src/test/org/apache/lucene/benchmark/byTask/TestPerfTasksLogic.java",0,0.449131513647643,0,4,4
"contrib/benchmark/src/test/org/apache/lucene/benchmark/byTask/TestPerfTasksParse.java",0,0.829545454545455,0,3,3
"contrib/benchmark/src/test/org/apache/lucene/benchmark/byTask/feeds/DocMakerTest.java",0,1,0,1,1
"contrib/benchmark/src/test/org/apache/lucene/benchmark/byTask/feeds/LineDocSourceTest.java",0,1,0,1,1
"contrib/benchmark/src/test/org/apache/lucene/benchmark/byTask/feeds/TrecContentSourceTest.java",0,0.852409638554217,0,2,2
"contrib/benchmark/src/test/org/apache/lucene/benchmark/byTask/tasks/CountingHighlighterTestTask.java",0,0.753846153846154,0,2,2
"contrib/benchmark/src/test/org/apache/lucene/benchmark/byTask/tasks/CountingSearchTestTask.java",0,0.796296296296296,0,2,2
"contrib/benchmark/src/test/org/apache/lucene/benchmark/byTask/tasks/CreateIndexTaskTest.java",0,1,0,1,1
"contrib/benchmark/src/test/org/apache/lucene/benchmark/byTask/tasks/PerfTaskTest.java",0,1,0,1,1
"contrib/benchmark/src/test/org/apache/lucene/benchmark/byTask/tasks/WriteLineDocTaskTest.java",0,0.651785714285714,0,2,2
"contrib/benchmark/src/test/org/apache/lucene/benchmark/quality/TestQualityRun.java",0,0.971428571428571,2,1,3
"contrib/collation/src/java/org/apache/lucene/collation/CollationKeyAnalyzer.java",0,0.927272727272727,0,2,2
"contrib/collation/src/java/org/apache/lucene/collation/CollationKeyFilter.java",0,0.8,0,3,3
"contrib/collation/src/java/org/apache/lucene/collation/ICUCollationKeyAnalyzer.java",0,0.913461538461538,0,2,2
"contrib/collation/src/java/org/apache/lucene/collation/ICUCollationKeyFilter.java",0,0.787037037037037,0,3,3
"contrib/collation/src/test/org/apache/lucene/collation/CollationTestBase.java",0,0.970588235294118,1,1,2
"contrib/collation/src/test/org/apache/lucene/collation/TestCollationKeyAnalyzer.java",0,1,0,1,1
"contrib/collation/src/test/org/apache/lucene/collation/TestCollationKeyFilter.java",0,1,0,1,1
"contrib/collation/src/test/org/apache/lucene/collation/TestICUCollationKeyAnalyzer.java",0,1,0,1,1
"contrib/collation/src/test/org/apache/lucene/collation/TestICUCollationKeyFilter.java",0,1,0,1,1
"contrib/db/bdb-je/src/java/org/apache/lucene/store/je/Block.java",0,0.710843373493976,1,3,4
"contrib/db/bdb-je/src/java/org/apache/lucene/store/je/File.java",0,0.666666666666667,2,2,4
"contrib/db/bdb-je/src/java/org/apache/lucene/store/je/JEDirectory.java",0,0.963302752293578,3,1,4
"contrib/db/bdb-je/src/java/org/apache/lucene/store/je/JEIndexInput.java",0,0.947761194029851,2,1,3
"contrib/db/bdb-je/src/java/org/apache/lucene/store/je/JEIndexOutput.java",0,0.571428571428571,3,2,5
"contrib/db/bdb-je/src/java/org/apache/lucene/store/je/JELock.java",0,0.78,1,3,4
"contrib/db/bdb-je/src/test/org/apache/lucene/store/je/JEStoreTest.java",0,0.958925750394945,4,1,5
"contrib/db/bdb/src/java/com/sleepycat/db/DbHandleExtractor.java",0,0.88,0,2,2
"contrib/db/bdb/src/java/org/apache/lucene/store/db/Block.java",0,0.861702127659574,1,3,4
"contrib/db/bdb/src/java/org/apache/lucene/store/db/DbDirectory.java",0,0.755813953488372,2,2,4
"contrib/db/bdb/src/java/org/apache/lucene/store/db/DbIndexInput.java",0,0.951724137931034,2,1,3
"contrib/db/bdb/src/java/org/apache/lucene/store/db/DbIndexOutput.java",0,0.644295302013423,3,2,5
"contrib/db/bdb/src/java/org/apache/lucene/store/db/DbLock.java",0,0.884615384615385,0,2,2
"contrib/db/bdb/src/java/org/apache/lucene/store/db/File.java",0,0.85171102661597,2,2,4
"contrib/db/bdb/src/test/org/apache/lucene/store/db/DbStoreTest.java",0,0.949640287769784,3,1,4
"contrib/db/bdb/src/test/org/apache/lucene/store/db/SanityLoadLibrary.java",0,1,0,1,1
"contrib/fast-vector-highlighter/src/java/org/apache/lucene/search/vectorhighlight/BaseFragmentsBuilder.java",0,0.984,1,1,2
"contrib/fast-vector-highlighter/src/java/org/apache/lucene/search/vectorhighlight/FastVectorHighlighter.java",0,0.985401459854015,1,1,2
"contrib/fast-vector-highlighter/src/java/org/apache/lucene/search/vectorhighlight/FieldFragList.java",0,1,0,1,1
"contrib/fast-vector-highlighter/src/java/org/apache/lucene/search/vectorhighlight/FieldPhraseList.java",0,1,0,1,1
"contrib/fast-vector-highlighter/src/java/org/apache/lucene/search/vectorhighlight/FieldQuery.java",0,0.989795918367347,1,1,2
"contrib/fast-vector-highlighter/src/java/org/apache/lucene/search/vectorhighlight/FieldTermStack.java",0,1,0,1,1
"contrib/fast-vector-highlighter/src/java/org/apache/lucene/search/vectorhighlight/FragListBuilder.java",0,1,0,1,1
"contrib/fast-vector-highlighter/src/java/org/apache/lucene/search/vectorhighlight/FragmentsBuilder.java",0,1,0,1,1
"contrib/fast-vector-highlighter/src/java/org/apache/lucene/search/vectorhighlight/ScoreOrderFragmentsBuilder.java",0,0.985507246376812,1,1,2
"contrib/fast-vector-highlighter/src/java/org/apache/lucene/search/vectorhighlight/SimpleFragListBuilder.java",0,1,0,1,1
"contrib/fast-vector-highlighter/src/java/org/apache/lucene/search/vectorhighlight/SimpleFragmentsBuilder.java",0,1,0,1,1
"contrib/fast-vector-highlighter/src/test/org/apache/lucene/search/vectorhighlight/AbstractTestCase.java",0,0.971830985915493,2,1,3
"contrib/fast-vector-highlighter/src/test/org/apache/lucene/search/vectorhighlight/FieldPhraseListTest.java",0,1,0,1,1
"contrib/fast-vector-highlighter/src/test/org/apache/lucene/search/vectorhighlight/FieldQueryTest.java",0,0.991556091676719,1,1,2
"contrib/fast-vector-highlighter/src/test/org/apache/lucene/search/vectorhighlight/FieldTermStackTest.java",0,1,0,1,1
"contrib/fast-vector-highlighter/src/test/org/apache/lucene/search/vectorhighlight/IndexTimeSynonymTest.java",0,0.965079365079365,1,1,2
"contrib/fast-vector-highlighter/src/test/org/apache/lucene/search/vectorhighlight/ScoreOrderFragmentsBuilderTest.java",0,1,0,1,1
"contrib/fast-vector-highlighter/src/test/org/apache/lucene/search/vectorhighlight/SimpleFragListBuilderTest.java",0,1,0,1,1
"contrib/fast-vector-highlighter/src/test/org/apache/lucene/search/vectorhighlight/SimpleFragmentsBuilderTest.java",0,0.761538461538461,0,2,2
"contrib/highlighter/src/java/org/apache/lucene/search/highlight/DefaultEncoder.java",0,0.96875,1,1,2
"contrib/highlighter/src/java/org/apache/lucene/search/highlight/Encoder.java",0,0.931034482758621,2,1,3
"contrib/highlighter/src/java/org/apache/lucene/search/highlight/Formatter.java",0,0.636363636363636,0,3,3
"contrib/highlighter/src/java/org/apache/lucene/search/highlight/Fragmenter.java",0,0.5,0,3,3
"contrib/highlighter/src/java/org/apache/lucene/search/highlight/GradientFormatter.java",0,0.951541850220264,4,1,5
"contrib/highlighter/src/java/org/apache/lucene/search/highlight/Highlighter.java",0,0.559726962457338,5,3,8
"contrib/highlighter/src/java/org/apache/lucene/search/highlight/InvalidTokenOffsetsException.java",0,1,0,1,1
"contrib/highlighter/src/java/org/apache/lucene/search/highlight/NullFragmenter.java",0,0.696969696969697,0,3,3
"contrib/highlighter/src/java/org/apache/lucene/search/highlight/QueryScorer.java",0,0.940298507462687,4,1,5
"contrib/highlighter/src/java/org/apache/lucene/search/highlight/QueryTermExtractor.java",0,0.616279069767442,4,2,6
"contrib/highlighter/src/java/org/apache/lucene/search/highlight/QueryTermScorer.java",0,0.993827160493827,1,1,2
"contrib/highlighter/src/java/org/apache/lucene/search/highlight/Scorer.java",0,0.656716417910448,0,3,3
"contrib/highlighter/src/java/org/apache/lucene/search/highlight/SimpleFragmenter.java",0,0.5875,1,3,4
"contrib/highlighter/src/java/org/apache/lucene/search/highlight/SimpleHTMLEncoder.java",0,0.987654320987654,1,1,2
"contrib/highlighter/src/java/org/apache/lucene/search/highlight/SimpleHTMLFormatter.java",0,0.457627118644068,0,4,4
"contrib/highlighter/src/java/org/apache/lucene/search/highlight/SimpleSpanFragmenter.java",0,0.675925925925926,1,2,3
"contrib/highlighter/src/java/org/apache/lucene/search/highlight/SpanGradientFormatter.java",0,0.909090909090909,1,2,3
"contrib/highlighter/src/java/org/apache/lucene/search/highlight/TextFragment.java",0,0.810126582278481,0,3,3
"contrib/highlighter/src/java/org/apache/lucene/search/highlight/TokenGroup.java",0,0.704545454545455,2,2,4
"contrib/highlighter/src/java/org/apache/lucene/search/highlight/TokenSources.java",0,0.656934306569343,3,4,7
"contrib/highlighter/src/java/org/apache/lucene/search/highlight/WeightedSpanTerm.java",0,1,0,1,1
"contrib/highlighter/src/java/org/apache/lucene/search/highlight/WeightedSpanTermExtractor.java",0,0.98019801980198,3,1,4
"contrib/highlighter/src/java/org/apache/lucene/search/highlight/WeightedTerm.java",0,0.890625,1,2,3
"contrib/highlighter/src/test/org/apache/lucene/search/highlight/HighlighterTest.java",0,0.68580894533407,6,2,8
"contrib/instantiated/src/java/org/apache/lucene/store/instantiated/FieldSetting.java",0,1,0,1,1
"contrib/instantiated/src/java/org/apache/lucene/store/instantiated/FieldSettings.java",0,0.989583333333333,1,1,2
"contrib/instantiated/src/java/org/apache/lucene/store/instantiated/InstantiatedDocument.java",0,1,0,1,1
"contrib/instantiated/src/java/org/apache/lucene/store/instantiated/InstantiatedIndex.java",0,0.722689075630252,1,2,3
"contrib/instantiated/src/java/org/apache/lucene/store/instantiated/InstantiatedIndexReader.java",0,0.680203045685279,1,2,3
"contrib/instantiated/src/java/org/apache/lucene/store/instantiated/InstantiatedIndexWriter.java",0,0.853197674418605,4,2,6
"contrib/instantiated/src/java/org/apache/lucene/store/instantiated/InstantiatedTerm.java",0,0.976,1,1,2
"contrib/instantiated/src/java/org/apache/lucene/store/instantiated/InstantiatedTermDocs.java",0,1,0,1,1
"contrib/instantiated/src/java/org/apache/lucene/store/instantiated/InstantiatedTermDocumentInformation.java",0,0.992805755395683,1,1,2
"contrib/instantiated/src/java/org/apache/lucene/store/instantiated/InstantiatedTermEnum.java",0,0.955752212389381,1,1,2
"contrib/instantiated/src/java/org/apache/lucene/store/instantiated/InstantiatedTermFreqVector.java",0,1,0,1,1
"contrib/instantiated/src/java/org/apache/lucene/store/instantiated/InstantiatedTermPositionVector.java",0,1,0,1,1
"contrib/instantiated/src/java/org/apache/lucene/store/instantiated/InstantiatedTermPositions.java",0,0.99,1,1,2
"contrib/instantiated/src/test/org/apache/lucene/store/instantiated/TestEmptyIndex.java",0,0.921052631578947,0,2,2
"contrib/instantiated/src/test/org/apache/lucene/store/instantiated/TestIndicesEquals.java",0,0.755381604696673,2,3,5
"contrib/instantiated/src/test/org/apache/lucene/store/instantiated/TestRealTime.java",0,1,0,1,1
"contrib/instantiated/src/test/org/apache/lucene/store/instantiated/TestSerialization.java",0,1,0,1,1
"contrib/instantiated/src/test/org/apache/lucene/store/instantiated/TestUnoptimizedReaderOnConstructor.java",0,1,0,1,1
"contrib/lucli/src/java/lucli/LuceneMethods.java",0,0.704301075268817,2,3,5
"contrib/lucli/src/java/lucli/Lucli.java",0,0.751552795031056,2,2,4
"contrib/memory/src/java/org/apache/lucene/index/memory/AnalyzerUtil.java",0,0.701754385964912,1,3,4
"contrib/memory/src/java/org/apache/lucene/index/memory/MemoryIndex.java",0,0.630999213217939,7,2,9
"contrib/memory/src/java/org/apache/lucene/index/memory/PatternAnalyzer.java",0,0.678936605316973,4,4,8
"contrib/memory/src/java/org/apache/lucene/index/memory/SynonymMap.java",0,0.786967418546366,1,2,3
"contrib/memory/src/java/org/apache/lucene/index/memory/SynonymTokenFilter.java",0,0.546666666666667,2,4,6
"contrib/memory/src/test/org/apache/lucene/index/memory/MemoryIndexTest.java",0,0.545787545787546,7,2,9
"contrib/memory/src/test/org/apache/lucene/index/memory/PatternAnalyzerTest.java",0,0.704225352112676,5,2,7
"contrib/memory/src/test/org/apache/lucene/index/memory/TestSynonymTokenFilter.java",0,0.982905982905983,1,1,2
"contrib/misc/src/java/org/apache/lucene/index/FieldNormModifier.java",0,0.91875,5,1,6
"contrib/misc/src/java/org/apache/lucene/index/TermVectorAccessor.java",0,0.982352941176471,1,1,2
"contrib/misc/src/java/org/apache/lucene/misc/ChainedFilter.java",0,0.477611940298507,3,4,7
"contrib/misc/src/java/org/apache/lucene/misc/HighFreqTerms.java",0,0.958333333333333,1,1,2
"contrib/misc/src/java/org/apache/lucene/misc/IndexMergeTool.java",0,0.836363636363636,2,2,4
"contrib/misc/src/java/org/apache/lucene/misc/LengthNormModifier.java",0,0.746753246753247,4,2,6
"contrib/misc/src/java/org/apache/lucene/misc/SweetSpotSimilarity.java",0,0.805243445692884,3,2,5
"contrib/misc/src/java/org/apache/lucene/queryParser/analyzing/AnalyzingQueryParser.java",0,0.842767295597484,3,2,5
"contrib/misc/src/java/org/apache/lucene/queryParser/complexPhrase/ComplexPhraseQueryParser.java",0,0.958974358974359,3,1,4
"contrib/misc/src/java/org/apache/lucene/queryParser/precedence/CharStream.java",0,0.872727272727273,0,2,2
"contrib/misc/src/java/org/apache/lucene/queryParser/precedence/FastCharStream.java",0,0.951612903225806,1,1,2
"contrib/misc/src/java/org/apache/lucene/queryParser/precedence/ParseException.java",0,1,0,1,1
"contrib/misc/src/java/org/apache/lucene/queryParser/precedence/PrecedenceQueryParser.java",0,0.921189591078067,1,2,3
"contrib/misc/src/java/org/apache/lucene/queryParser/precedence/PrecedenceQueryParserConstants.java",0,1,0,1,1
"contrib/misc/src/java/org/apache/lucene/queryParser/precedence/PrecedenceQueryParserTokenManager.java",0,0.981290926099158,1,1,2
"contrib/misc/src/java/org/apache/lucene/queryParser/precedence/Token.java",0,1,0,1,1
"contrib/misc/src/java/org/apache/lucene/queryParser/precedence/TokenMgrError.java",0,1,0,1,1
"contrib/misc/src/test/org/apache/lucene/index/TestFieldNormModifier.java",0,0.710743801652893,0,2,2
"contrib/misc/src/test/org/apache/lucene/index/TestTermVectorAccessor.java",0,0.864864864864865,0,2,2
"contrib/misc/src/test/org/apache/lucene/misc/ChainedFilterTest.java",0,0.5,3,3,6
"contrib/misc/src/test/org/apache/lucene/misc/SweetSpotSimilarityTest.java",0,0.951923076923077,2,1,3
"contrib/misc/src/test/org/apache/lucene/misc/TestLengthNormModifier.java",0,0.620192307692308,1,2,3
"contrib/misc/src/test/org/apache/lucene/queryParser/analyzing/TestAnalyzingQueryParser.java",0,0.949152542372881,0,2,2
"contrib/misc/src/test/org/apache/lucene/queryParser/complexPhrase/TestComplexPhraseQuery.java",0,0.986111111111111,1,1,2
"contrib/misc/src/test/org/apache/lucene/queryParser/precedence/TestPrecedenceQueryParser.java",0,0.901502504173623,1,2,3
"contrib/queries/src/java/org/apache/lucene/search/BooleanFilter.java",0,0.965686274509804,2,1,3
"contrib/queries/src/java/org/apache/lucene/search/BoostingQuery.java",0,0.735537190082645,0,2,2
"contrib/queries/src/java/org/apache/lucene/search/DuplicateFilter.java",0,1,0,1,1
"contrib/queries/src/java/org/apache/lucene/search/FilterClause.java",0,1,0,1,1
"contrib/queries/src/java/org/apache/lucene/search/FuzzyLikeThisQuery.java",0,0.791044776119403,1,2,3
"contrib/queries/src/java/org/apache/lucene/search/TermsFilter.java",0,1,0,1,1
"contrib/queries/src/java/org/apache/lucene/search/similar/MoreLikeThis.java",0,0.968302658486708,3,1,4
"contrib/queries/src/java/org/apache/lucene/search/similar/MoreLikeThisQuery.java",0,1,0,1,1
"contrib/queries/src/java/org/apache/lucene/search/similar/SimilarityQueries.java",0,0.947368421052632,2,1,3
"contrib/queries/src/test/org/apache/lucene/search/BooleanFilterTest.java",0,0.972972972972973,2,1,3
"contrib/queries/src/test/org/apache/lucene/search/BoostingQueryTest.java",0,1,0,1,1
"contrib/queries/src/test/org/apache/lucene/search/DuplicateFilterTest.java",0,0.981818181818182,1,1,2
"contrib/queries/src/test/org/apache/lucene/search/FuzzyLikeThisQueryTest.java",0,0.919354838709677,0,2,2
"contrib/queries/src/test/org/apache/lucene/search/TermsFilterTest.java",0,0.793103448275862,1,2,3
"contrib/queries/src/test/org/apache/lucene/search/similar/TestMoreLikeThis.java",0,1,0,1,1
"contrib/queryparser/src/java/org/apache/lucene/queryParser/core/QueryNodeError.java",0,1,0,1,1
"contrib/queryparser/src/java/org/apache/lucene/queryParser/core/QueryNodeException.java",0,1,0,1,1
"contrib/queryparser/src/java/org/apache/lucene/queryParser/core/QueryNodeParseException.java",0,0.991735537190083,1,1,2
"contrib/queryparser/src/java/org/apache/lucene/queryParser/core/QueryParserHelper.java",0,1,0,1,1
"contrib/queryparser/src/java/org/apache/lucene/queryParser/core/builders/QueryBuilder.java",0,1,0,1,1
"contrib/queryparser/src/java/org/apache/lucene/queryParser/core/builders/QueryTreeBuilder.java",0,0.986486486486487,2,1,3
"contrib/queryparser/src/java/org/apache/lucene/queryParser/core/config/FieldConfig.java",0,1,0,1,1
"contrib/queryparser/src/java/org/apache/lucene/queryParser/core/config/FieldConfigListener.java",0,0.552631578947368,0,2,2
"contrib/queryparser/src/java/org/apache/lucene/queryParser/core/config/QueryConfigHandler.java",0,1,0,1,1
"contrib/queryparser/src/java/org/apache/lucene/queryParser/core/messages/QueryParserMessages.java",0,1,0,1,1
"contrib/queryparser/src/java/org/apache/lucene/queryParser/core/nodes/AndQueryNode.java",0,1,0,1,1
"contrib/queryparser/src/java/org/apache/lucene/queryParser/core/nodes/AnyQueryNode.java",0,1,0,1,1
"contrib/queryparser/src/java/org/apache/lucene/queryParser/core/nodes/BooleanQueryNode.java",0,1,0,1,1
"contrib/queryparser/src/java/org/apache/lucene/queryParser/core/nodes/BoostQueryNode.java",0,0.991803278688525,1,1,2
"contrib/queryparser/src/java/org/apache/lucene/queryParser/core/nodes/DeletedQueryNode.java",0,1,0,1,1
"contrib/queryparser/src/java/org/apache/lucene/queryParser/core/nodes/FieldQueryNode.java",0,1,0,1,1
"contrib/queryparser/src/java/org/apache/lucene/queryParser/core/nodes/FieldableNode.java",0,1,0,1,1
"contrib/queryparser/src/java/org/apache/lucene/queryParser/core/nodes/FuzzyQueryNode.java",0,1,0,1,1
"contrib/queryparser/src/java/org/apache/lucene/queryParser/core/nodes/GroupQueryNode.java",0,0.987951807228916,1,1,2
"contrib/queryparser/src/java/org/apache/lucene/queryParser/core/nodes/MatchAllDocsQueryNode.java",0,1,0,1,1
"contrib/queryparser/src/java/org/apache/lucene/queryParser/core/nodes/MatchNoDocsQueryNode.java",0,1,0,1,1
"contrib/queryparser/src/java/org/apache/lucene/queryParser/core/nodes/ModifierQueryNode.java",0,0.955414012738854,2,1,3
"contrib/queryparser/src/java/org/apache/lucene/queryParser/core/nodes/NoTokenFoundQueryNode.java",0,1,0,1,1
"contrib/queryparser/src/java/org/apache/lucene/queryParser/core/nodes/OpaqueQueryNode.java",0,1,0,1,1
"contrib/queryparser/src/java/org/apache/lucene/queryParser/core/nodes/OrQueryNode.java",0,1,0,1,1
"contrib/queryparser/src/java/org/apache/lucene/queryParser/core/nodes/ParametricQueryNode.java",0,1,0,1,1
"contrib/queryparser/src/java/org/apache/lucene/queryParser/core/nodes/ParametricRangeQueryNode.java",0,1,0,1,1
"contrib/queryparser/src/java/org/apache/lucene/queryParser/core/nodes/PathQueryNode.java",0,0.949074074074074,0,2,2
"contrib/queryparser/src/java/org/apache/lucene/queryParser/core/nodes/PhraseSlopQueryNode.java",0,0.990825688073395,1,1,2
"contrib/queryparser/src/java/org/apache/lucene/queryParser/core/nodes/ProximityQueryNode.java",0,0.98804780876494,2,1,3
"contrib/queryparser/src/java/org/apache/lucene/queryParser/core/nodes/QueryNode.java",0,1,0,1,1
"contrib/queryparser/src/java/org/apache/lucene/queryParser/core/nodes/QueryNodeImpl.java",0,0.995555555555556,1,1,2
"contrib/queryparser/src/java/org/apache/lucene/queryParser/core/nodes/QuotedFieldQueryNode.java",0,1,0,1,1
"contrib/queryparser/src/java/org/apache/lucene/queryParser/core/nodes/SlopQueryNode.java",0,0.991379310344828,1,1,2
"contrib/queryparser/src/java/org/apache/lucene/queryParser/core/nodes/TextableQueryNode.java",0,0.896551724137931,0,2,2
"contrib/queryparser/src/java/org/apache/lucene/queryParser/core/nodes/TokenizedPhraseQueryNode.java",0,0.990384615384615,1,1,2
"contrib/queryparser/src/java/org/apache/lucene/queryParser/core/parser/EscapeQuerySyntax.java",0,1,0,1,1
"contrib/queryparser/src/java/org/apache/lucene/queryParser/core/parser/SyntaxParser.java",0,1,0,1,1
"contrib/queryparser/src/java/org/apache/lucene/queryParser/core/processors/NoChildOptimizationQueryNodeProcessor.java",0,1,0,1,1
"contrib/queryparser/src/java/org/apache/lucene/queryParser/core/processors/QueryNodeProcessor.java",0,1,0,1,1
"contrib/queryparser/src/java/org/apache/lucene/queryParser/core/processors/QueryNodeProcessorImpl.java",0,1,0,1,1
"contrib/queryparser/src/java/org/apache/lucene/queryParser/core/processors/QueryNodeProcessorPipeline.java",0,1,0,1,1
"contrib/queryparser/src/java/org/apache/lucene/queryParser/core/processors/RemoveDeletedQueryNodesProcessor.java",0,1,0,1,1
"contrib/queryparser/src/java/org/apache/lucene/queryParser/core/util/QueryNodeOperation.java",0,1,0,1,1
"contrib/queryparser/src/java/org/apache/lucene/queryParser/core/util/UnescapedCharSequence.java",0,1,0,1,1
"contrib/queryparser/src/java/org/apache/lucene/queryParser/standard/MultiFieldQueryParserWrapper.java",0,0.988847583643123,1,1,2
"contrib/queryparser/src/java/org/apache/lucene/queryParser/standard/QueryParserUtil.java",0,0.898058252427185,1,2,3
"contrib/queryparser/src/java/org/apache/lucene/queryParser/standard/QueryParserWrapper.java",0,0.938524590163934,0,2,2
"contrib/queryparser/src/java/org/apache/lucene/queryParser/standard/StandardQueryParser.java",0,0.906976744186046,0,2,2
"contrib/queryparser/src/java/org/apache/lucene/queryParser/standard/builders/AnyQueryNodeBuilder.java",0,0.974025974025974,1,1,2
"contrib/queryparser/src/java/org/apache/lucene/queryParser/standard/builders/BooleanQueryNodeBuilder.java",0,0.954545454545455,2,1,3
"contrib/queryparser/src/java/org/apache/lucene/queryParser/standard/builders/BoostQueryNodeBuilder.java",0,0.962962962962963,1,1,2
"contrib/queryparser/src/java/org/apache/lucene/queryParser/standard/builders/FieldQueryNodeBuilder.java",0,0.953488372093023,1,1,2
"contrib/queryparser/src/java/org/apache/lucene/queryParser/standard/builders/FuzzyQueryNodeBuilder.java",0,0.954545454545455,1,1,2
"contrib/queryparser/src/java/org/apache/lucene/queryParser/standard/builders/GroupQueryNodeBuilder.java",0,0.955555555555556,1,1,2
"contrib/queryparser/src/java/org/apache/lucene/queryParser/standard/builders/MatchAllDocsQueryNodeBuilder.java",0,0.903846153846154,1,2,3
"contrib/queryparser/src/java/org/apache/lucene/queryParser/standard/builders/MatchNoDocsQueryNodeBuilder.java",0,0.903846153846154,1,2,3
"contrib/queryparser/src/java/org/apache/lucene/queryParser/standard/builders/ModifierQueryNodeBuilder.java",0,0.955555555555556,1,1,2
"contrib/queryparser/src/java/org/apache/lucene/queryParser/standard/builders/MultiPhraseQueryNodeBuilder.java",0,0.964285714285714,1,1,2
"contrib/queryparser/src/java/org/apache/lucene/queryParser/standard/builders/PhraseQueryNodeBuilder.java",0,0.96875,1,1,2
"contrib/queryparser/src/java/org/apache/lucene/queryParser/standard/builders/PrefixWildcardQueryNodeBuilder.java",0,0.943396226415094,0,2,2
"contrib/queryparser/src/java/org/apache/lucene/queryParser/standard/builders/RangeQueryNodeBuilder.java",0,0.956521739130435,1,1,2
"contrib/queryparser/src/java/org/apache/lucene/queryParser/standard/builders/SlopQueryNodeBuilder.java",0,0.964912280701754,1,1,2
"contrib/queryparser/src/java/org/apache/lucene/queryParser/standard/builders/StandardBooleanQueryNodeBuilder.java",0,0.926605504587156,1,2,3
"contrib/queryparser/src/java/org/apache/lucene/queryParser/standard/builders/StandardQueryBuilder.java",0,0.945945945945946,0,2,2
"contrib/queryparser/src/java/org/apache/lucene/queryParser/standard/builders/StandardQueryTreeBuilder.java",0,0.858974358974359,0,2,2
"contrib/queryparser/src/java/org/apache/lucene/queryParser/standard/builders/WildcardQueryNodeBuilder.java",0,0.903846153846154,0,2,2
"contrib/queryparser/src/java/org/apache/lucene/queryParser/standard/config/AllowLeadingWildcardAttribute.java",0,0.939393939393939,0,2,2
"contrib/queryparser/src/java/org/apache/lucene/queryParser/standard/config/AllowLeadingWildcardAttributeImpl.java",0,0.947368421052632,0,2,2
"contrib/queryparser/src/java/org/apache/lucene/queryParser/standard/config/AnalyzerAttribute.java",0,0.942857142857143,0,2,2
"contrib/queryparser/src/java/org/apache/lucene/queryParser/standard/config/AnalyzerAttributeImpl.java",0,0.96551724137931,1,1,2
"contrib/queryparser/src/java/org/apache/lucene/queryParser/standard/config/BoostAttribute.java",0,0.942857142857143,0,2,2
"contrib/queryparser/src/java/org/apache/lucene/queryParser/standard/config/BoostAttributeImpl.java",0,0.962962962962963,1,1,2
"contrib/queryparser/src/java/org/apache/lucene/queryParser/standard/config/DateResolutionAttribute.java",0,0.930232558139535,0,2,2
"contrib/queryparser/src/java/org/apache/lucene/queryParser/standard/config/DateResolutionAttributeImpl.java",0,0.96551724137931,1,1,2
"contrib/queryparser/src/java/org/apache/lucene/queryParser/standard/config/DefaultOperatorAttribute.java",0,0.948717948717949,0,2,2
"contrib/queryparser/src/java/org/apache/lucene/queryParser/standard/config/DefaultOperatorAttributeImpl.java",0,0.966292134831461,1,1,2
"contrib/queryparser/src/java/org/apache/lucene/queryParser/standard/config/DefaultPhraseSlopAttribute.java",0,0.941176470588235,0,2,2
"contrib/queryparser/src/java/org/apache/lucene/queryParser/standard/config/DefaultPhraseSlopAttributeImpl.java",0,0.963414634146341,1,1,2
"contrib/queryparser/src/java/org/apache/lucene/queryParser/standard/config/FieldBoostMapAttribute.java",0,0.971428571428571,1,1,2
"contrib/queryparser/src/java/org/apache/lucene/queryParser/standard/config/FieldBoostMapAttributeImpl.java",0,0.966292134831461,1,1,2
"contrib/queryparser/src/java/org/apache/lucene/queryParser/standard/config/FieldBoostMapFCListener.java",0,0.983050847457627,1,1,2
"contrib/queryparser/src/java/org/apache/lucene/queryParser/standard/config/FieldDateResolutionFCListener.java",0,0.986301369863014,1,1,2
"contrib/queryparser/src/java/org/apache/lucene/queryParser/standard/config/FieldDateResolutionMapAttribute.java",0,0.971428571428571,1,1,2
"contrib/queryparser/src/java/org/apache/lucene/queryParser/standard/config/FieldDateResolutionMapAttributeImpl.java",0,0.988372093023256,1,1,2
"contrib/queryparser/src/java/org/apache/lucene/queryParser/standard/config/FuzzyAttribute.java",0,0.944444444444444,0,2,2
"contrib/queryparser/src/java/org/apache/lucene/queryParser/standard/config/FuzzyAttributeImpl.java",0,0.967032967032967,1,1,2
"contrib/queryparser/src/java/org/apache/lucene/queryParser/standard/config/LocaleAttribute.java",0,0.942857142857143,0,2,2
"contrib/queryparser/src/java/org/apache/lucene/queryParser/standard/config/LocaleAttributeImpl.java",0,0.96551724137931,1,1,2
"contrib/queryparser/src/java/org/apache/lucene/queryParser/standard/config/LowercaseExpandedTermsAttribute.java",0,0.942857142857143,0,2,2
"contrib/queryparser/src/java/org/apache/lucene/queryParser/standard/config/LowercaseExpandedTermsAttributeImpl.java",0,0.963414634146341,1,1,2
"contrib/queryparser/src/java/org/apache/lucene/queryParser/standard/config/MultiFieldAttribute.java",0,0.939393939393939,0,2,2
"contrib/queryparser/src/java/org/apache/lucene/queryParser/standard/config/MultiFieldAttributeImpl.java",0,0.962962962962963,1,1,2
"contrib/queryparser/src/java/org/apache/lucene/queryParser/standard/config/MultiTermRewriteMethodAttribute.java",0,0.95,0,2,2
"contrib/queryparser/src/java/org/apache/lucene/queryParser/standard/config/MultiTermRewriteMethodAttributeImpl.java",0,0.975903614457831,1,1,2
"contrib/queryparser/src/java/org/apache/lucene/queryParser/standard/config/PositionIncrementsAttribute.java",0,0.939393939393939,0,2,2
"contrib/queryparser/src/java/org/apache/lucene/queryParser/standard/config/PositionIncrementsAttributeImpl.java",0,0.962962962962963,1,1,2
"contrib/queryparser/src/java/org/apache/lucene/queryParser/standard/config/RangeCollatorAttribute.java",0,0.945945945945946,0,2,2
"contrib/queryparser/src/java/org/apache/lucene/queryParser/standard/config/RangeCollatorAttributeImpl.java",0,0.966292134831461,1,1,2
"contrib/queryparser/src/java/org/apache/lucene/queryParser/standard/config/StandardQueryConfigHandler.java",0,0.890909090909091,0,2,2
"contrib/queryparser/src/java/org/apache/lucene/queryParser/standard/nodes/BooleanModifierNode.java",0,0.948717948717949,0,2,2
"contrib/queryparser/src/java/org/apache/lucene/queryParser/standard/nodes/MultiPhraseQueryNode.java",0,0.990740740740741,1,1,2
"contrib/queryparser/src/java/org/apache/lucene/queryParser/standard/nodes/PrefixWildcardQueryNode.java",0,1,0,1,1
"contrib/queryparser/src/java/org/apache/lucene/queryParser/standard/nodes/RangeQueryNode.java",0,0.956521739130435,1,1,2
"contrib/queryparser/src/java/org/apache/lucene/queryParser/standard/nodes/StandardBooleanQueryNode.java",0,0.927272727272727,0,2,2
"contrib/queryparser/src/java/org/apache/lucene/queryParser/standard/nodes/WildcardQueryNode.java",0,1,0,1,1
"contrib/queryparser/src/java/org/apache/lucene/queryParser/standard/parser/EscapeQuerySyntaxImpl.java",0,0.986486486486487,3,1,4
"contrib/queryparser/src/java/org/apache/lucene/queryParser/standard/parser/JavaCharStream.java",0,0.99837925445705,1,1,2
"contrib/queryparser/src/java/org/apache/lucene/queryParser/standard/parser/ParseException.java",0,0.974619289340102,2,1,3
"contrib/queryparser/src/java/org/apache/lucene/queryParser/standard/parser/StandardSyntaxParser.java",0,0.985327313769752,2,1,3
"contrib/queryparser/src/java/org/apache/lucene/queryParser/standard/parser/StandardSyntaxParserConstants.java",0,0.974137931034483,1,1,2
"contrib/queryparser/src/java/org/apache/lucene/queryParser/standard/parser/StandardSyntaxParserTokenManager.java",0,0.994520547945206,1,1,2
"contrib/queryparser/src/java/org/apache/lucene/queryParser/standard/parser/Token.java",0,0.99236641221374,1,1,2
"contrib/queryparser/src/java/org/apache/lucene/queryParser/standard/parser/TokenMgrError.java",0,0.993197278911565,1,1,2
"contrib/queryparser/src/java/org/apache/lucene/queryParser/standard/processors/AllowLeadingWildcardProcessor.java",0,0.95049504950495,2,1,3
"contrib/queryparser/src/java/org/apache/lucene/queryParser/standard/processors/AnalyzerQueryNodeProcessor.java",0,0.964809384164223,1,1,2
"contrib/queryparser/src/java/org/apache/lucene/queryParser/standard/processors/BooleanSingleChildOptimizationQueryNodeProcessor.java",0,0.977272727272727,1,1,2
"contrib/queryparser/src/java/org/apache/lucene/queryParser/standard/processors/BoostQueryNodeProcessor.java",0,0.976190476190476,1,1,2
"contrib/queryparser/src/java/org/apache/lucene/queryParser/standard/processors/DefaultPhraseSlopQueryNodeProcessor.java",0,0.973913043478261,1,1,2
"contrib/queryparser/src/java/org/apache/lucene/queryParser/standard/processors/FuzzyQueryNodeProcessor.java",0,0.976744186046512,1,1,2
"contrib/queryparser/src/java/org/apache/lucene/queryParser/standard/processors/GroupQueryNodeProcessor.java",0,0.976958525345622,1,1,2
"contrib/queryparser/src/java/org/apache/lucene/queryParser/standard/processors/LowercaseExpandedTermsQueryNodeProcessor.java",0,0.978494623655914,1,1,2
"contrib/queryparser/src/java/org/apache/lucene/queryParser/standard/processors/MatchAllDocsQueryNodeProcessor.java",0,0.986486486486487,1,1,2
"contrib/queryparser/src/java/org/apache/lucene/queryParser/standard/processors/MultiFieldQueryNodeProcessor.java",0,0.984732824427481,1,1,2
"contrib/queryparser/src/java/org/apache/lucene/queryParser/standard/processors/MultiTermRewriteMethodProcessor.java",0,0.984615384615385,1,1,2
"contrib/queryparser/src/java/org/apache/lucene/queryParser/standard/processors/ParametricRangeQueryNodeProcessor.java",0,0.971428571428571,1,1,2
"contrib/queryparser/src/java/org/apache/lucene/queryParser/standard/processors/PhraseSlopQueryNodeProcessor.java",0,0.971830985915493,1,1,2
"contrib/queryparser/src/java/org/apache/lucene/queryParser/standard/processors/RemoveEmptyNonLeafQueryNodeProcessor.java",0,0.991071428571429,1,1,2
"contrib/queryparser/src/java/org/apache/lucene/queryParser/standard/processors/StandardQueryNodeProcessorPipeline.java",0,0.828571428571429,0,2,2
"contrib/queryparser/src/java/org/apache/lucene/queryParser/standard/processors/WildcardQueryNodeProcessor.java",0,1,0,1,1
"contrib/queryparser/src/test/org/apache/lucene/queryParser/spans/SpanOrQueryNodeBuilder.java",0,0.964285714285714,1,1,2
"contrib/queryparser/src/test/org/apache/lucene/queryParser/spans/SpanTermQueryNodeBuilder.java",0,0.951219512195122,1,1,2
"contrib/queryparser/src/test/org/apache/lucene/queryParser/spans/SpansQueryConfigHandler.java",0,1,0,1,1
"contrib/queryparser/src/test/org/apache/lucene/queryParser/spans/SpansQueryTreeBuilder.java",0,0.96078431372549,1,1,2
"contrib/queryparser/src/test/org/apache/lucene/queryParser/spans/SpansValidatorQueryNodeProcessor.java",0,1,0,1,1
"contrib/queryparser/src/test/org/apache/lucene/queryParser/spans/TestSpanQueryParser.java",0,0.978448275862069,1,1,2
"contrib/queryparser/src/test/org/apache/lucene/queryParser/spans/TestSpanQueryParserSimpleSample.java",0,0.967741935483871,1,1,2
"contrib/queryparser/src/test/org/apache/lucene/queryParser/spans/UniqueFieldAttribute.java",0,1,0,1,1
"contrib/queryparser/src/test/org/apache/lucene/queryParser/spans/UniqueFieldAttributeImpl.java",0,1,0,1,1
"contrib/queryparser/src/test/org/apache/lucene/queryParser/spans/UniqueFieldQueryNodeProcessor.java",0,1,0,1,1
"contrib/queryparser/src/test/org/apache/lucene/queryParser/standard/TestMultiAnalyzerQPHelper.java",0,0.984662576687117,1,1,2
"contrib/queryparser/src/test/org/apache/lucene/queryParser/standard/TestMultiAnalyzerWrapper.java",0,0.99375,1,1,2
"contrib/queryparser/src/test/org/apache/lucene/queryParser/standard/TestMultiFieldQPHelper.java",0,0.97554347826087,1,1,2
"contrib/queryparser/src/test/org/apache/lucene/queryParser/standard/TestMultiFieldQueryParserWrapper.java",0,0.991803278688525,1,1,2
"contrib/queryparser/src/test/org/apache/lucene/queryParser/standard/TestQPHelper.java",0,0.913290113452188,0,2,2
"contrib/queryparser/src/test/org/apache/lucene/queryParser/standard/TestQueryParserWrapper.java",0,0.985319516407599,1,1,2
"contrib/regex/src/java/org/apache/lucene/search/regex/JakartaRegexpCapabilities.java",0,0.573033707865168,1,3,4
"contrib/regex/src/java/org/apache/lucene/search/regex/JavaUtilRegexCapabilities.java",0,0.515789473684211,2,3,5
"contrib/regex/src/java/org/apache/lucene/search/regex/RegexCapabilities.java",0,0.875,0,2,2
"contrib/regex/src/java/org/apache/lucene/search/regex/RegexQuery.java",0,0.924050632911392,0,2,2
"contrib/regex/src/java/org/apache/lucene/search/regex/RegexQueryCapable.java",0,0.777777777777778,0,2,2
"contrib/regex/src/java/org/apache/lucene/search/regex/RegexTermEnum.java",0,0.924050632911392,0,2,2
"contrib/regex/src/java/org/apache/lucene/search/regex/SpanRegexQuery.java",0,0.944,2,1,3
"contrib/regex/src/java/org/apache/regexp/RegexpTunnel.java",0,0.793103448275862,0,2,2
"contrib/regex/src/test/org/apache/lucene/search/regex/TestRegexQuery.java",0,0.676691729323308,1,2,3
"contrib/regex/src/test/org/apache/lucene/search/regex/TestSpanRegexQuery.java",0,0.642857142857143,0,3,3
"contrib/remote/src/java/org/apache/lucene/search/RMIRemoteSearchable.java",0,0.956521739130435,1,1,2
"contrib/remote/src/java/org/apache/lucene/search/RemoteCachingWrapperFilter.java",0,0.76056338028169,1,3,4
"contrib/remote/src/java/org/apache/lucene/search/RemoteSearchable.java",0,0.492063492063492,2,5,7
"contrib/remote/src/test/org/apache/lucene/search/RemoteCachingWrapperFilterHelper.java",0,0.966101694915254,1,1,2
"contrib/remote/src/test/org/apache/lucene/search/TestRemoteCachingWrapperFilter.java",0,0.804511278195489,0,3,3
"contrib/remote/src/test/org/apache/lucene/search/TestRemoteSearchable.java",0,0.4375,1,6,7
"contrib/remote/src/test/org/apache/lucene/search/TestRemoteSort.java",0,0.952890792291221,1,1,2
"contrib/snowball/src/java/org/apache/lucene/analysis/snowball/SnowballAnalyzer.java",0,0.473684210526316,2,4,6
"contrib/snowball/src/java/org/apache/lucene/analysis/snowball/SnowballFilter.java",0,0.408602150537634,1,4,5
"contrib/snowball/src/java/org/tartarus/snowball/Among.java",0,0.62,2,2,4
"contrib/snowball/src/java/org/tartarus/snowball/SnowballProgram.java",0,0.914221218961625,2,1,3
"contrib/snowball/src/java/org/tartarus/snowball/TestApp.java",0,0.819148936170213,0,2,2
"contrib/snowball/src/java/org/tartarus/snowball/ext/DanishStemmer.java",0,0.773049645390071,0,2,2
"contrib/snowball/src/java/org/tartarus/snowball/ext/DutchStemmer.java",0,0.996415770609319,1,1,2
"contrib/snowball/src/java/org/tartarus/snowball/ext/EnglishStemmer.java",0,0.700913242009132,0,2,2
"contrib/snowball/src/java/org/tartarus/snowball/ext/FinnishStemmer.java",0,0.982591876208897,1,1,2
"contrib/snowball/src/java/org/tartarus/snowball/ext/FrenchStemmer.java",0,0.784810126582278,0,2,2
"contrib/snowball/src/java/org/tartarus/snowball/ext/German2Stemmer.java",0,0.831955922865014,0,2,2
"contrib/snowball/src/java/org/tartarus/snowball/ext/GermanStemmer.java",0,0.822674418604651,0,2,2
"contrib/snowball/src/java/org/tartarus/snowball/ext/HungarianStemmer.java",0,1,0,1,1
"contrib/snowball/src/java/org/tartarus/snowball/ext/ItalianStemmer.java",0,0.898305084745763,0,2,2
"contrib/snowball/src/java/org/tartarus/snowball/ext/KpStemmer.java",0,0.998624484181568,1,1,2
"contrib/snowball/src/java/org/tartarus/snowball/ext/LovinsStemmer.java",0,0.935010482180293,1,2,3
"contrib/snowball/src/java/org/tartarus/snowball/ext/NorwegianStemmer.java",0,0.720670391061452,0,2,2
"contrib/snowball/src/java/org/tartarus/snowball/ext/PorterStemmer.java",0,0.996688741721854,1,1,2
"contrib/snowball/src/java/org/tartarus/snowball/ext/PortugueseStemmer.java",0,0.861111111111111,1,2,3
"contrib/snowball/src/java/org/tartarus/snowball/ext/RomanianStemmer.java",0,1,0,1,1
"contrib/snowball/src/java/org/tartarus/snowball/ext/RussianStemmer.java",0,0.635488308115543,0,2,2
"contrib/snowball/src/java/org/tartarus/snowball/ext/SpanishStemmer.java",0,0.879864636209814,0,2,2
"contrib/snowball/src/java/org/tartarus/snowball/ext/SwedishStemmer.java",0,0.925501432664756,0,2,2
"contrib/snowball/src/java/org/tartarus/snowball/ext/TurkishStemmer.java",0,1,0,1,1
"contrib/snowball/src/test/org/apache/lucene/analysis/snowball/TestSnowball.java",0,0.432203389830508,1,5,6
"contrib/spatial/src/java/org/apache/lucene/spatial/geohash/GeoHashDistanceFilter.java",0,0.666666666666667,0,2,2
"contrib/spatial/src/java/org/apache/lucene/spatial/geohash/GeoHashUtils.java",0,0.977011494252874,1,1,2
"contrib/spatial/src/java/org/apache/lucene/spatial/geometry/CartesianPoint.java",0,0.63855421686747,1,2,3
"contrib/spatial/src/java/org/apache/lucene/spatial/geometry/DistanceUnits.java",0,0.821428571428571,0,2,2
"contrib/spatial/src/java/org/apache/lucene/spatial/geometry/FixedLatLng.java",0,0.8125,1,2,3
"contrib/spatial/src/java/org/apache/lucene/spatial/geometry/FloatLatLng.java",0,0.762237762237762,2,2,4
"contrib/spatial/src/java/org/apache/lucene/spatial/geometry/LatLng.java",0,0.936708860759494,3,1,4
"contrib/spatial/src/java/org/apache/lucene/spatial/geometry/shape/DistanceApproximation.java",0,0.967213114754098,1,1,2
"contrib/spatial/src/java/org/apache/lucene/spatial/geometry/shape/Ellipse.java",0,0.978632478632479,2,1,3
"contrib/spatial/src/java/org/apache/lucene/spatial/geometry/shape/Geometry2D.java",0,0.929824561403509,0,2,2
"contrib/spatial/src/java/org/apache/lucene/spatial/geometry/shape/IntersectCase.java",0,0.806451612903226,0,2,2
"contrib/spatial/src/java/org/apache/lucene/spatial/geometry/shape/LLRect.java",0,0.713178294573643,1,2,3
"contrib/spatial/src/java/org/apache/lucene/spatial/geometry/shape/LineSegment.java",0,0.683760683760684,2,2,4
"contrib/spatial/src/java/org/apache/lucene/spatial/geometry/shape/Point2D.java",0,0.766423357664234,1,2,3
"contrib/spatial/src/java/org/apache/lucene/spatial/geometry/shape/Rectangle.java",0,0.7265625,1,2,3
"contrib/spatial/src/java/org/apache/lucene/spatial/geometry/shape/Vector2D.java",0,0.779310344827586,1,2,3
"contrib/spatial/src/java/org/apache/lucene/spatial/tier/CartesianPolyFilterBuilder.java",0,0.854838709677419,1,2,3
"contrib/spatial/src/java/org/apache/lucene/spatial/tier/CartesianShapeFilter.java",0,0.780487804878049,2,2,4
"contrib/spatial/src/java/org/apache/lucene/spatial/tier/DistanceFieldComparatorSource.java",0,0.930232558139535,0,2,2
"contrib/spatial/src/java/org/apache/lucene/spatial/tier/DistanceFilter.java",0,0.693069306930693,0,2,2
"contrib/spatial/src/java/org/apache/lucene/spatial/tier/DistanceHandler.java",0,0.903846153846154,1,2,3
"contrib/spatial/src/java/org/apache/lucene/spatial/tier/DistanceQueryBuilder.java",0,0.696551724137931,1,2,3
"contrib/spatial/src/java/org/apache/lucene/spatial/tier/DistanceUtils.java",0,0.925373134328358,0,2,2
"contrib/spatial/src/java/org/apache/lucene/spatial/tier/InvalidGeoException.java",0,0.857142857142857,0,2,2
"contrib/spatial/src/java/org/apache/lucene/spatial/tier/LatLongDistanceFilter.java",0,0.62962962962963,1,2,3
"contrib/spatial/src/java/org/apache/lucene/spatial/tier/Shape.java",0,0.942307692307692,0,2,2
"contrib/spatial/src/java/org/apache/lucene/spatial/tier/projections/CartesianTierPlotter.java",0,0.969512195121951,2,1,3
"contrib/spatial/src/java/org/apache/lucene/spatial/tier/projections/IProjector.java",0,0.821428571428571,0,2,2
"contrib/spatial/src/java/org/apache/lucene/spatial/tier/projections/SinusoidalProjector.java",0,0.886363636363636,1,2,3
"contrib/spatial/src/test/org/apache/lucene/spatial/tier/DistanceCheck.java",0,1,0,1,1
"contrib/spatial/src/test/org/apache/lucene/spatial/tier/PolyShape.java",0,1,0,1,1
"contrib/spatial/src/test/org/apache/lucene/spatial/tier/TestCartesian.java",0,0.562111801242236,1,2,3
"contrib/spatial/src/test/org/apache/lucene/spatial/tier/TestDistance.java",0,0.818181818181818,0,2,2
"contrib/spellchecker/src/java/org/apache/lucene/search/spell/Dictionary.java",0,0.571428571428571,1,4,5
"contrib/spellchecker/src/java/org/apache/lucene/search/spell/JaroWinklerDistance.java",0,0.991071428571429,1,1,2
"contrib/spellchecker/src/java/org/apache/lucene/search/spell/LevensteinDistance.java",0,0.532110091743119,1,4,5
"contrib/spellchecker/src/java/org/apache/lucene/search/spell/LuceneDictionary.java",0,0.263636363636364,2,5,7
"contrib/spellchecker/src/java/org/apache/lucene/search/spell/NGramDistance.java",0,1,0,1,1
"contrib/spellchecker/src/java/org/apache/lucene/search/spell/PlainTextDictionary.java",0,0.378048780487805,0,5,5
"contrib/spellchecker/src/java/org/apache/lucene/search/spell/SpellChecker.java",0,0.680487804878049,3,3,6
"contrib/spellchecker/src/java/org/apache/lucene/search/spell/StringDistance.java",0,0.971428571428571,1,1,2
"contrib/spellchecker/src/java/org/apache/lucene/search/spell/SuggestWord.java",0,0.540983606557377,2,3,5
"contrib/spellchecker/src/java/org/apache/lucene/search/spell/SuggestWordQueue.java",0,0.45,1,3,4
"contrib/spellchecker/src/test/org/apache/lucene/search/spell/TestJaroWinklerDistance.java",0,1,0,1,1
"contrib/spellchecker/src/test/org/apache/lucene/search/spell/TestLevenshteinDistance.java",0,0.740740740740741,0,3,3
"contrib/spellchecker/src/test/org/apache/lucene/search/spell/TestLuceneDictionary.java",0,0.975,1,1,2
"contrib/spellchecker/src/test/org/apache/lucene/search/spell/TestNGramDistance.java",0,1,0,1,1
"contrib/spellchecker/src/test/org/apache/lucene/search/spell/TestPlainTextDictionary.java",0,1,0,1,1
"contrib/spellchecker/src/test/org/apache/lucene/search/spell/TestSpellChecker.java",0,0.241379310344828,0,7,7
"contrib/surround/src/java/org/apache/lucene/queryParser/surround/parser/CharStream.java",0,1,0,1,1
"contrib/surround/src/java/org/apache/lucene/queryParser/surround/parser/FastCharStream.java",0,0.950413223140496,1,1,2
"contrib/surround/src/java/org/apache/lucene/queryParser/surround/parser/ParseException.java",0,1,0,1,1
"contrib/surround/src/java/org/apache/lucene/queryParser/surround/parser/QueryParser.java",0,1,0,1,1
"contrib/surround/src/java/org/apache/lucene/queryParser/surround/parser/QueryParserConstants.java",0,1,0,1,1
"contrib/surround/src/java/org/apache/lucene/queryParser/surround/parser/QueryParserTokenManager.java",0,1,0,1,1
"contrib/surround/src/java/org/apache/lucene/queryParser/surround/parser/Token.java",0,1,0,1,1
"contrib/surround/src/java/org/apache/lucene/queryParser/surround/parser/TokenMgrError.java",0,1,0,1,1
"contrib/surround/src/java/org/apache/lucene/queryParser/surround/query/AndQuery.java",0,0.818181818181818,0,2,2
"contrib/surround/src/java/org/apache/lucene/queryParser/surround/query/BasicQueryFactory.java",0,0.907692307692308,0,2,2
"contrib/surround/src/java/org/apache/lucene/queryParser/surround/query/ComposedQuery.java",0,0.94017094017094,1,2,3
"contrib/surround/src/java/org/apache/lucene/queryParser/surround/query/DistanceQuery.java",0,0.949152542372881,0,2,2
"contrib/surround/src/java/org/apache/lucene/queryParser/surround/query/DistanceSubQuery.java",0,0.806451612903226,0,2,2
"contrib/surround/src/java/org/apache/lucene/queryParser/surround/query/FieldsQuery.java",0,0.904255319148936,1,2,3
"contrib/surround/src/java/org/apache/lucene/queryParser/surround/query/NotQuery.java",0,0.842105263157895,0,2,2
"contrib/surround/src/java/org/apache/lucene/queryParser/surround/query/OrQuery.java",0,0.9,0,2,2
"contrib/surround/src/java/org/apache/lucene/queryParser/surround/query/SimpleTerm.java",0,0.892857142857143,0,3,3
"contrib/surround/src/java/org/apache/lucene/queryParser/surround/query/SpanNearClauseFactory.java",0,0.957446808510638,1,1,2
"contrib/surround/src/java/org/apache/lucene/queryParser/surround/query/SrndBooleanQuery.java",0,0.866666666666667,0,2,2
"contrib/surround/src/java/org/apache/lucene/queryParser/surround/query/SrndPrefixQuery.java",0,0.918918918918919,0,2,2
"contrib/surround/src/java/org/apache/lucene/queryParser/surround/query/SrndQuery.java",0,0.901234567901235,1,2,3
"contrib/surround/src/java/org/apache/lucene/queryParser/surround/query/SrndTermQuery.java",0,0.875,1,2,3
"contrib/surround/src/java/org/apache/lucene/queryParser/surround/query/SrndTruncQuery.java",0,0.946428571428571,0,2,2
"contrib/surround/src/java/org/apache/lucene/queryParser/surround/query/TooManyBasicQueries.java",0,0.777777777777778,0,2,2
"contrib/surround/src/test/org/apache/lucene/queryParser/surround/query/BooleanQueryTst.java",0,0.774774774774775,0,3,3
"contrib/surround/src/test/org/apache/lucene/queryParser/surround/query/ExceptionQueryTst.java",0,0.651515151515151,0,3,3
"contrib/surround/src/test/org/apache/lucene/queryParser/surround/query/SingleFieldTestDb.java",0,0.631578947368421,0,3,3
"contrib/surround/src/test/org/apache/lucene/queryParser/surround/query/Test01Exceptions.java",0,0.72463768115942,1,2,3
"contrib/surround/src/test/org/apache/lucene/queryParser/surround/query/Test02Boolean.java",0,0.852459016393443,1,2,3
"contrib/surround/src/test/org/apache/lucene/queryParser/surround/query/Test03Distance.java",0,0.772727272727273,1,3,4
"contrib/swing/src/java/org/apache/lucene/swing/models/ListSearcher.java",0,0.992857142857143,1,1,2
"contrib/swing/src/java/org/apache/lucene/swing/models/TableSearcher.java",0,0.991452991452991,1,1,2
"contrib/swing/src/test/org/apache/lucene/swing/models/BaseListModel.java",0,1,0,1,1
"contrib/swing/src/test/org/apache/lucene/swing/models/BaseTableModel.java",0,1,0,1,1
"contrib/swing/src/test/org/apache/lucene/swing/models/DataStore.java",0,1,0,1,1
"contrib/swing/src/test/org/apache/lucene/swing/models/ListSearcherSimulator.java",0,1,0,1,1
"contrib/swing/src/test/org/apache/lucene/swing/models/RestaurantInfo.java",0,1,0,1,1
"contrib/swing/src/test/org/apache/lucene/swing/models/TableSearcherSimulator.java",0,1,0,1,1
"contrib/swing/src/test/org/apache/lucene/swing/models/TestBasicList.java",0,1,0,1,1
"contrib/swing/src/test/org/apache/lucene/swing/models/TestBasicTable.java",0,1,0,1,1
"contrib/swing/src/test/org/apache/lucene/swing/models/TestSearchingList.java",0,1,0,1,1
"contrib/swing/src/test/org/apache/lucene/swing/models/TestSearchingTable.java",0,1,0,1,1
"contrib/swing/src/test/org/apache/lucene/swing/models/TestUpdatingList.java",0,1,0,1,1
"contrib/swing/src/test/org/apache/lucene/swing/models/TestUpdatingTable.java",0,1,0,1,1
"contrib/wikipedia/src/java/org/apache/lucene/wikipedia/analysis/WikipediaTokenizer.java",0,0.583832335329341,2,3,5
"contrib/wikipedia/src/java/org/apache/lucene/wikipedia/analysis/WikipediaTokenizerImpl.java",0,0.975359342915811,2,1,3
"contrib/wikipedia/src/test/org/apache/lucene/wikipedia/analysis/WikipediaTokenizerTest.java",0,0.677007299270073,1,2,3
"contrib/wordnet/src/java/org/apache/lucene/wordnet/SynExpand.java",0,0.69811320754717,2,3,5
"contrib/wordnet/src/java/org/apache/lucene/wordnet/SynLookup.java",0,0.60958904109589,1,4,5
"contrib/wordnet/src/java/org/apache/lucene/wordnet/Syns2Index.java",0,0.67524115755627,4,3,7
"contrib/xml-query-parser/src/demo/java/org/apache/lucene/xmlparser/webdemo/FormBasedXmlQueryDemo.java",0,0.886666666666667,0,2,2
"contrib/xml-query-parser/src/java/org/apache/lucene/xmlparser/CoreParser.java",0,0.964497041420118,1,1,2
"contrib/xml-query-parser/src/java/org/apache/lucene/xmlparser/CorePlusExtensionsParser.java",0,0.924242424242424,0,2,2
"contrib/xml-query-parser/src/java/org/apache/lucene/xmlparser/DOMUtils.java",0,0.985714285714286,1,1,2
"contrib/xml-query-parser/src/java/org/apache/lucene/xmlparser/FilterBuilder.java",0,0.9,0,2,2
"contrib/xml-query-parser/src/java/org/apache/lucene/xmlparser/FilterBuilderFactory.java",0,0.94,0,2,2
"contrib/xml-query-parser/src/java/org/apache/lucene/xmlparser/ParserException.java",0,0.942307692307692,0,2,2
"contrib/xml-query-parser/src/java/org/apache/lucene/xmlparser/QueryBuilder.java",0,1,0,1,1
"contrib/xml-query-parser/src/java/org/apache/lucene/xmlparser/QueryBuilderFactory.java",0,0.941176470588235,0,2,2
"contrib/xml-query-parser/src/java/org/apache/lucene/xmlparser/QueryTemplateManager.java",0,1,0,1,1
"contrib/xml-query-parser/src/java/org/apache/lucene/xmlparser/builders/BooleanFilterBuilder.java",0,0.955223880597015,1,1,2
"contrib/xml-query-parser/src/java/org/apache/lucene/xmlparser/builders/BooleanQueryBuilder.java",0,0.970588235294118,1,1,2
"contrib/xml-query-parser/src/java/org/apache/lucene/xmlparser/builders/BoostingQueryBuilder.java",0,0.95,0,2,2
"contrib/xml-query-parser/src/java/org/apache/lucene/xmlparser/builders/BoostingTermBuilder.java",0,0.911111111111111,0,2,2
"contrib/xml-query-parser/src/java/org/apache/lucene/xmlparser/builders/CachedFilterBuilder.java",0,1,0,1,1
"contrib/xml-query-parser/src/java/org/apache/lucene/xmlparser/builders/ConstantScoreQueryBuilder.java",0,0.92,0,2,2
"contrib/xml-query-parser/src/java/org/apache/lucene/xmlparser/builders/DuplicateFilterBuilder.java",0,0.960526315789474,1,1,2
"contrib/xml-query-parser/src/java/org/apache/lucene/xmlparser/builders/FilteredQueryBuilder.java",0,0.953125,1,1,2
"contrib/xml-query-parser/src/java/org/apache/lucene/xmlparser/builders/FuzzyLikeThisQueryBuilder.java",0,0.939393939393939,0,2,2
"contrib/xml-query-parser/src/java/org/apache/lucene/xmlparser/builders/LikeThisQueryBuilder.java",0,0.93859649122807,2,1,3
"contrib/xml-query-parser/src/java/org/apache/lucene/xmlparser/builders/MatchAllDocsQueryBuilder.java",0,0.882352941176471,0,2,2
"contrib/xml-query-parser/src/java/org/apache/lucene/xmlparser/builders/RangeFilterBuilder.java",0,0.893617021276596,1,2,3
"contrib/xml-query-parser/src/java/org/apache/lucene/xmlparser/builders/SpanBuilderBase.java",0,0.878787878787879,0,2,2
"contrib/xml-query-parser/src/java/org/apache/lucene/xmlparser/builders/SpanFirstBuilder.java",0,0.92,0,2,2
"contrib/xml-query-parser/src/java/org/apache/lucene/xmlparser/builders/SpanNearBuilder.java",0,0.929824561403509,0,2,2
"contrib/xml-query-parser/src/java/org/apache/lucene/xmlparser/builders/SpanNotBuilder.java",0,0.931034482758621,0,2,2
"contrib/xml-query-parser/src/java/org/apache/lucene/xmlparser/builders/SpanOrBuilder.java",0,0.932203389830508,0,2,2
"contrib/xml-query-parser/src/java/org/apache/lucene/xmlparser/builders/SpanOrTermsBuilder.java",0,0.88,0,3,3
"contrib/xml-query-parser/src/java/org/apache/lucene/xmlparser/builders/SpanQueryBuilder.java",0,1,0,1,1
"contrib/xml-query-parser/src/java/org/apache/lucene/xmlparser/builders/SpanQueryBuilderFactory.java",0,0.94,0,2,2
"contrib/xml-query-parser/src/java/org/apache/lucene/xmlparser/builders/SpanTermBuilder.java",0,0.906976744186046,0,2,2
"contrib/xml-query-parser/src/java/org/apache/lucene/xmlparser/builders/TermQueryBuilder.java",0,0.930232558139535,0,2,2
"contrib/xml-query-parser/src/java/org/apache/lucene/xmlparser/builders/TermsFilterBuilder.java",0,0.892857142857143,1,2,3
"contrib/xml-query-parser/src/java/org/apache/lucene/xmlparser/builders/TermsQueryBuilder.java",0,0.941176470588235,0,2,2
"contrib/xml-query-parser/src/java/org/apache/lucene/xmlparser/builders/UserInputQueryBuilder.java",0,0.98936170212766,1,1,2
"contrib/xml-query-parser/src/test/org/apache/lucene/xmlparser/TestParser.java",0,0.963133640552995,1,1,2
"contrib/xml-query-parser/src/test/org/apache/lucene/xmlparser/TestQueryTemplateManager.java",0,1,0,1,1
"src/demo/org/apache/lucene/demo/DeleteFiles.java",0,0.378787878787879,3,4,7
"src/demo/org/apache/lucene/demo/FileDocument.java",0,0.535211267605634,2,4,6
"src/demo/org/apache/lucene/demo/HTMLDocument.java",0,0.534883720930233,2,4,6
"src/demo/org/apache/lucene/demo/IndexFiles.java",0,0.39,2,6,8
"src/demo/org/apache/lucene/demo/IndexHTML.java",0,0.470238095238095,3,5,8
"src/demo/org/apache/lucene/demo/SearchFiles.java",0,0.461038961038961,7,3,10
"src/demo/org/apache/lucene/demo/html/Entities.java",0,0.945288753799392,5,1,6
"src/demo/org/apache/lucene/demo/html/HTMLParser.java",0,0.848118279569892,4,2,6
"src/demo/org/apache/lucene/demo/html/HTMLParserConstants.java",0,0.4875,0,3,3
"src/demo/org/apache/lucene/demo/html/HTMLParserTokenManager.java",0,0.687384615384615,1,3,4
"src/demo/org/apache/lucene/demo/html/ParseException.java",0,0.96875,1,1,2
"src/demo/org/apache/lucene/demo/html/ParserThread.java",0,0.489795918367347,1,4,5
"src/demo/org/apache/lucene/demo/html/SimpleCharStream.java",0,0.854214123006834,1,2,3
"src/demo/org/apache/lucene/demo/html/Tags.java",0,0.71875,0,4,4
"src/demo/org/apache/lucene/demo/html/Test.java",0,0.431372549019608,1,4,5
"src/demo/org/apache/lucene/demo/html/Token.java",0,1,0,1,1
"src/demo/org/apache/lucene/demo/html/TokenMgrError.java",0,0.992481203007519,1,1,2
"src/java/org/apache/lucene/LucenePackage.java",0,0.793103448275862,0,2,2
"src/java/org/apache/lucene/analysis/ASCIIFoldingFilter.java",0,0.993596059113301,1,1,2
"src/java/org/apache/lucene/analysis/Analyzer.java",0,0.529801324503311,4,5,9
"src/java/org/apache/lucene/analysis/BaseCharFilter.java",0,0.989130434782609,1,1,2
"src/java/org/apache/lucene/analysis/CachingTokenFilter.java",0,1,0,1,1
"src/java/org/apache/lucene/analysis/CharArraySet.java",0,0.550595238095238,0,3,3
"src/java/org/apache/lucene/analysis/CharFilter.java",0,0.802631578947368,0,2,2
"src/java/org/apache/lucene/analysis/CharReader.java",0,0.8,1,2,3
"src/java/org/apache/lucene/analysis/CharStream.java",0,0.878048780487805,0,2,2
"src/java/org/apache/lucene/analysis/CharTokenizer.java",0,0.555555555555556,4,4,8
"src/java/org/apache/lucene/analysis/CharacterCache.java",0,0.978723404255319,1,1,2
"src/java/org/apache/lucene/analysis/ISOLatin1AccentFilter.java",0,0.613382899628253,3,4,7
"src/java/org/apache/lucene/analysis/KeywordAnalyzer.java",0,0.431372549019608,1,3,4
"src/java/org/apache/lucene/analysis/KeywordTokenizer.java",0,0.542056074766355,3,3,6
"src/java/org/apache/lucene/analysis/LengthFilter.java",0,0.515625,4,3,7
"src/java/org/apache/lucene/analysis/LetterTokenizer.java",0,0.384615384615385,1,4,5
"src/java/org/apache/lucene/analysis/LowerCaseFilter.java",0,0.346938775510204,0,5,5
"src/java/org/apache/lucene/analysis/LowerCaseTokenizer.java",0,0.236363636363636,2,5,7
"src/java/org/apache/lucene/analysis/MappingCharFilter.java",0,0.941176470588235,0,2,2
"src/java/org/apache/lucene/analysis/NormalizeCharMap.java",0,1,0,1,1
"src/java/org/apache/lucene/analysis/NumericTokenStream.java",0,0.912698412698413,0,2,2
"src/java/org/apache/lucene/analysis/PerFieldAnalyzerWrapper.java",0,0.390243902439024,0,5,5
"src/java/org/apache/lucene/analysis/PorterStemFilter.java",0,0.333333333333333,0,5,5
"src/java/org/apache/lucene/analysis/PorterStemmer.java",0,0.772477064220183,3,2,5
"src/java/org/apache/lucene/analysis/SimpleAnalyzer.java",0,0.325,0,5,5
"src/java/org/apache/lucene/analysis/SinkTokenizer.java",0,0.681818181818182,0,3,3
"src/java/org/apache/lucene/analysis/StopAnalyzer.java",0,0.44973544973545,5,4,9
"src/java/org/apache/lucene/analysis/StopFilter.java",0,0.344947735191638,3,7,10
"src/java/org/apache/lucene/analysis/TeeSinkTokenFilter.java",0,0.99581589958159,1,1,2
"src/java/org/apache/lucene/analysis/TeeTokenFilter.java",0,0.5125,0,3,3
"src/java/org/apache/lucene/analysis/Token.java",0,0.673469387755102,5,4,9
"src/java/org/apache/lucene/analysis/TokenFilter.java",0,0.344827586206897,1,5,6
"src/java/org/apache/lucene/analysis/TokenStream.java",0,0.423611111111111,5,3,8
"src/java/org/apache/lucene/analysis/TokenWrapper.java",0,0.951807228915663,1,1,2
"src/java/org/apache/lucene/analysis/Tokenizer.java",0,0.319587628865979,2,6,8
"src/java/org/apache/lucene/analysis/WhitespaceAnalyzer.java",0,0.282051282051282,1,4,5
"src/java/org/apache/lucene/analysis/WhitespaceTokenizer.java",0,0.375,2,4,6
"src/java/org/apache/lucene/analysis/WordlistLoader.java",0,0.483333333333333,1,3,4
"src/java/org/apache/lucene/analysis/standard/StandardAnalyzer.java",0,0.507002801120448,8,3,11
"src/java/org/apache/lucene/analysis/standard/StandardFilter.java",0,0.526315789473684,0,5,5
"src/java/org/apache/lucene/analysis/standard/StandardTokenizer.java",0,0.434615384615385,4,3,7
"src/java/org/apache/lucene/analysis/standard/StandardTokenizerImpl.java",0,0.96398891966759,2,1,3
"src/java/org/apache/lucene/analysis/tokenattributes/FlagsAttribute.java",0,0.931818181818182,0,2,2
"src/java/org/apache/lucene/analysis/tokenattributes/FlagsAttributeImpl.java",0,0.986842105263158,1,1,2
"src/java/org/apache/lucene/analysis/tokenattributes/OffsetAttribute.java",0,0.909090909090909,0,2,2
"src/java/org/apache/lucene/analysis/tokenattributes/OffsetAttributeImpl.java",0,1,0,1,1
"src/java/org/apache/lucene/analysis/tokenattributes/PayloadAttribute.java",0,1,0,1,1
"src/java/org/apache/lucene/analysis/tokenattributes/PayloadAttributeImpl.java",0,1,0,1,1
"src/java/org/apache/lucene/analysis/tokenattributes/PositionIncrementAttribute.java",0,1,0,1,1
"src/java/org/apache/lucene/analysis/tokenattributes/PositionIncrementAttributeImpl.java",0,1,0,1,1
"src/java/org/apache/lucene/analysis/tokenattributes/TermAttribute.java",0,1,0,1,1
"src/java/org/apache/lucene/analysis/tokenattributes/TermAttributeImpl.java",0,0.854545454545454,0,2,2
"src/java/org/apache/lucene/analysis/tokenattributes/TypeAttribute.java",0,1,0,1,1
"src/java/org/apache/lucene/analysis/tokenattributes/TypeAttributeImpl.java",0,0.986486486486487,1,1,2
"src/java/org/apache/lucene/document/AbstractField.java",0,0.721311475409836,2,2,4
"src/java/org/apache/lucene/document/CompressionTools.java",0,1,0,1,1
"src/java/org/apache/lucene/document/DateField.java",0,0.385245901639344,1,6,7
"src/java/org/apache/lucene/document/DateTools.java",0,0.686274509803922,4,3,7
"src/java/org/apache/lucene/document/Document.java",0,0.287009063444109,2,7,9
"src/java/org/apache/lucene/document/Field.java",0,0.331481481481481,4,5,9
"src/java/org/apache/lucene/document/FieldSelector.java",0,1,0,1,1
"src/java/org/apache/lucene/document/FieldSelectorResult.java",0,0.94,1,2,3
"src/java/org/apache/lucene/document/Fieldable.java",0,0.567307692307692,2,3,5
"src/java/org/apache/lucene/document/LoadFirstFieldSelector.java",0,0.96551724137931,1,1,2
"src/java/org/apache/lucene/document/MapFieldSelector.java",0,0.742424242424242,1,2,3
"src/java/org/apache/lucene/document/NumberTools.java",0,0.827338129496403,4,2,6
"src/java/org/apache/lucene/document/NumericField.java",0,0.74113475177305,1,2,3
"src/java/org/apache/lucene/document/SetBasedFieldSelector.java",0,0.983333333333333,1,1,2
"src/java/org/apache/lucene/index/AllTermDocs.java",0,1,0,1,1
"src/java/org/apache/lucene/index/BufferedDeletes.java",0,1,0,1,1
"src/java/org/apache/lucene/index/ByteBlockPool.java",0,1,0,1,1
"src/java/org/apache/lucene/index/ByteSliceReader.java",0,1,0,1,1
"src/java/org/apache/lucene/index/ByteSliceWriter.java",0,1,0,1,1
"src/java/org/apache/lucene/index/CharBlockPool.java",0,1,0,1,1
"src/java/org/apache/lucene/index/CheckIndex.java",0,0.89924973204716,2,2,4
"src/java/org/apache/lucene/index/CompoundFileReader.java",0,0.477611940298507,3,5,8
"src/java/org/apache/lucene/index/CompoundFileWriter.java",0,0.51171875,2,5,7
"src/java/org/apache/lucene/index/ConcurrentMergeScheduler.java",0,1,0,1,1
"src/java/org/apache/lucene/index/CorruptIndexException.java",0,1,0,1,1
"src/java/org/apache/lucene/index/DefaultSkipListReader.java",0,1,0,1,1
"src/java/org/apache/lucene/index/DefaultSkipListWriter.java",0,0.91044776119403,0,2,2
"src/java/org/apache/lucene/index/DirectoryOwningReader.java",0,1,0,1,1
"src/java/org/apache/lucene/index/DirectoryReader.java",0,0.469622331691297,1,4,5
"src/java/org/apache/lucene/index/DocConsumer.java",0,1,0,1,1
"src/java/org/apache/lucene/index/DocConsumerPerThread.java",0,1,0,1,1
"src/java/org/apache/lucene/index/DocFieldConsumer.java",0,1,0,1,1
"src/java/org/apache/lucene/index/DocFieldConsumerPerField.java",0,1,0,1,1
"src/java/org/apache/lucene/index/DocFieldConsumerPerThread.java",0,1,0,1,1
"src/java/org/apache/lucene/index/DocFieldConsumers.java",0,1,0,1,1
"src/java/org/apache/lucene/index/DocFieldConsumersPerField.java",0,1,0,1,1
"src/java/org/apache/lucene/index/DocFieldConsumersPerThread.java",0,1,0,1,1
"src/java/org/apache/lucene/index/DocFieldProcessor.java",0,1,0,1,1
"src/java/org/apache/lucene/index/DocFieldProcessorPerField.java",0,1,0,1,1
"src/java/org/apache/lucene/index/DocFieldProcessorPerThread.java",0,1,0,1,1
"src/java/org/apache/lucene/index/DocInverter.java",0,0.948453608247423,0,2,2
"src/java/org/apache/lucene/index/DocInverterPerField.java",0,0.823809523809524,0,2,2
"src/java/org/apache/lucene/index/DocInverterPerThread.java",0,0.734042553191489,0,2,2
"src/java/org/apache/lucene/index/DocumentsWriter.java",0,0.966731898238748,2,1,3
"src/java/org/apache/lucene/index/DocumentsWriterThreadState.java",0,1,0,1,1
"src/java/org/apache/lucene/index/FieldInfo.java",0,0.561797752808989,2,4,6
"src/java/org/apache/lucene/index/FieldInfos.java",0,0.307486631016043,5,6,11
"src/java/org/apache/lucene/index/FieldInvertState.java",0,0.933962264150943,0,2,2
"src/java/org/apache/lucene/index/FieldReaderException.java",0,1,0,1,1
"src/java/org/apache/lucene/index/FieldSortedTermVectorMapper.java",0,1,0,1,1
"src/java/org/apache/lucene/index/FieldsReader.java",0,0.447488584474886,5,3,8
"src/java/org/apache/lucene/index/FieldsWriter.java",0,0.767527675276753,2,3,5
"src/java/org/apache/lucene/index/FilterIndexReader.java",0,0.412244897959184,4,4,8
"src/java/org/apache/lucene/index/FormatPostingsDocsConsumer.java",0,1,0,1,1
"src/java/org/apache/lucene/index/FormatPostingsDocsWriter.java",0,1,0,1,1
"src/java/org/apache/lucene/index/FormatPostingsFieldsConsumer.java",0,1,0,1,1
"src/java/org/apache/lucene/index/FormatPostingsFieldsWriter.java",0,1,0,1,1
"src/java/org/apache/lucene/index/FormatPostingsPositionsConsumer.java",0,1,0,1,1
"src/java/org/apache/lucene/index/FormatPostingsPositionsWriter.java",0,1,0,1,1
"src/java/org/apache/lucene/index/FormatPostingsTermsConsumer.java",0,1,0,1,1
"src/java/org/apache/lucene/index/FormatPostingsTermsWriter.java",0,1,0,1,1
"src/java/org/apache/lucene/index/FreqProxFieldMergeState.java",0,1,0,1,1
"src/java/org/apache/lucene/index/FreqProxTermsWriter.java",0,0.996598639455782,1,1,2
"src/java/org/apache/lucene/index/FreqProxTermsWriterPerField.java",0,0.84472049689441,0,2,2
"src/java/org/apache/lucene/index/FreqProxTermsWriterPerThread.java",0,1,0,1,1
"src/java/org/apache/lucene/index/IndexCommit.java",0,1,0,1,1
"src/java/org/apache/lucene/index/IndexCommitPoint.java",0,0.803921568627451,0,2,2
"src/java/org/apache/lucene/index/IndexDeletionPolicy.java",0,0.772277227722772,0,2,2
"src/java/org/apache/lucene/index/IndexFileDeleter.java",0,0.934650455927052,2,1,3
"src/java/org/apache/lucene/index/IndexFileNameFilter.java",0,0.585106382978723,1,3,4
"src/java/org/apache/lucene/index/IndexFileNames.java",0,0.757425742574257,3,2,5
"src/java/org/apache/lucene/index/IndexModifier.java",0,0.705400981996727,5,2,7
"src/java/org/apache/lucene/index/IndexReader.java",0,0.48738379814077,10,5,15
"src/java/org/apache/lucene/index/IndexWriter.java",0,0.910064992095556,13,1,14
"src/java/org/apache/lucene/index/IntBlockPool.java",0,1,0,1,1
"src/java/org/apache/lucene/index/InvertedDocConsumer.java",0,1,0,1,1
"src/java/org/apache/lucene/index/InvertedDocConsumerPerField.java",0,0.863636363636364,0,2,2
"src/java/org/apache/lucene/index/InvertedDocConsumerPerThread.java",0,1,0,1,1
"src/java/org/apache/lucene/index/InvertedDocEndConsumer.java",0,1,0,1,1
"src/java/org/apache/lucene/index/InvertedDocEndConsumerPerField.java",0,1,0,1,1
"src/java/org/apache/lucene/index/InvertedDocEndConsumerPerThread.java",0,1,0,1,1
"src/java/org/apache/lucene/index/KeepOnlyLastCommitDeletionPolicy.java",0,1,0,1,1
"src/java/org/apache/lucene/index/LogByteSizeMergePolicy.java",0,0.988095238095238,1,1,2
"src/java/org/apache/lucene/index/LogDocMergePolicy.java",0,1,0,1,1
"src/java/org/apache/lucene/index/LogMergePolicy.java",0,1,0,1,1
"src/java/org/apache/lucene/index/MergeDocIDRemapper.java",0,1,0,1,1
"src/java/org/apache/lucene/index/MergePolicy.java",0,0.996350364963504,1,1,2
"src/java/org/apache/lucene/index/MergeScheduler.java",0,1,0,1,1
"src/java/org/apache/lucene/index/MultiLevelSkipListReader.java",0,1,0,1,1
"src/java/org/apache/lucene/index/MultiLevelSkipListWriter.java",0,0.986754966887417,1,1,2
"src/java/org/apache/lucene/index/MultiReader.java",0,0.665847665847666,6,2,8
"src/java/org/apache/lucene/index/MultipleTermPositions.java",0,0.639269406392694,4,3,7
"src/java/org/apache/lucene/index/NormsWriter.java",0,1,0,1,1
"src/java/org/apache/lucene/index/NormsWriterPerField.java",0,1,0,1,1
"src/java/org/apache/lucene/index/NormsWriterPerThread.java",0,1,0,1,1
"src/java/org/apache/lucene/index/ParallelReader.java",0,0.372019077901431,3,5,8
"src/java/org/apache/lucene/index/Payload.java",0,0.777777777777778,0,2,2
"src/java/org/apache/lucene/index/PositionBasedTermVectorMapper.java",0,0.994011976047904,1,1,2
"src/java/org/apache/lucene/index/RawPostingList.java",0,0.888888888888889,0,2,2
"src/java/org/apache/lucene/index/ReadOnlyDirectoryReader.java",0,1,0,1,1
"src/java/org/apache/lucene/index/ReadOnlySegmentReader.java",0,1,0,1,1
"src/java/org/apache/lucene/index/ReusableStringReader.java",0,1,0,1,1
"src/java/org/apache/lucene/index/SegmentInfo.java",0,0.839779005524862,4,2,6
"src/java/org/apache/lucene/index/SegmentInfos.java",0,0.83864118895966,10,1,11
"src/java/org/apache/lucene/index/SegmentMergeInfo.java",0,0.435294117647059,0,4,4
"src/java/org/apache/lucene/index/SegmentMergeQueue.java",0,0.697674418604651,0,3,3
"src/java/org/apache/lucene/index/SegmentMerger.java",0,0.648614609571788,6,4,10
"src/java/org/apache/lucene/index/SegmentReader.java",0,0.676708302718589,8,4,12
"src/java/org/apache/lucene/index/SegmentTermDocs.java",0,0.268867924528302,3,4,7
"src/java/org/apache/lucene/index/SegmentTermEnum.java",0,0.407582938388626,1,5,6
"src/java/org/apache/lucene/index/SegmentTermPositionVector.java",0,0.892307692307692,1,2,3
"src/java/org/apache/lucene/index/SegmentTermPositions.java",0,0.451776649746193,5,4,9
"src/java/org/apache/lucene/index/SegmentTermVector.java",0,0.685393258426966,1,3,4
"src/java/org/apache/lucene/index/SegmentWriteState.java",0,1,0,1,1
"src/java/org/apache/lucene/index/SerialMergeScheduler.java",0,1,0,1,1
"src/java/org/apache/lucene/index/SnapshotDeletionPolicy.java",0,1,0,1,1
"src/java/org/apache/lucene/index/SortedTermVectorMapper.java",0,1,0,1,1
"src/java/org/apache/lucene/index/StaleReaderException.java",0,1,0,1,1
"src/java/org/apache/lucene/index/StoredFieldsWriter.java",0,1,0,1,1
"src/java/org/apache/lucene/index/StoredFieldsWriterPerThread.java",0,1,0,1,1
"src/java/org/apache/lucene/index/Term.java",0,0.36231884057971,4,6,10
"src/java/org/apache/lucene/index/TermBuffer.java",0,0.553956834532374,1,2,3
"src/java/org/apache/lucene/index/TermDocs.java",0,0.524390243902439,1,4,5
"src/java/org/apache/lucene/index/TermEnum.java",0,0.453125,2,4,6
"src/java/org/apache/lucene/index/TermFreqVector.java",0,0.690140845070423,1,4,5
"src/java/org/apache/lucene/index/TermInfo.java",0,0.627118644067797,0,3,3
"src/java/org/apache/lucene/index/TermInfosReader.java",0,0.301324503311258,4,4,8
"src/java/org/apache/lucene/index/TermInfosWriter.java",0,0.464912280701754,4,4,8
"src/java/org/apache/lucene/index/TermPositionVector.java",0,0.627906976744186,0,3,3
"src/java/org/apache/lucene/index/TermPositions.java",0,0.392405063291139,1,7,8
"src/java/org/apache/lucene/index/TermVectorEntry.java",0,1,0,1,1
"src/java/org/apache/lucene/index/TermVectorEntryFreqSortedComparator.java",0,1,0,1,1
"src/java/org/apache/lucene/index/TermVectorMapper.java",0,1,0,1,1
"src/java/org/apache/lucene/index/TermVectorOffsetInfo.java",0,0.626373626373626,0,3,3
"src/java/org/apache/lucene/index/TermVectorsReader.java",0,0.467445742904841,4,4,8
"src/java/org/apache/lucene/index/TermVectorsTermsWriter.java",0,1,0,1,1
"src/java/org/apache/lucene/index/TermVectorsTermsWriterPerField.java",0,0.908366533864542,2,2,4
"src/java/org/apache/lucene/index/TermVectorsTermsWriterPerThread.java",0,1,0,1,1
"src/java/org/apache/lucene/index/TermVectorsWriter.java",0,0.720183486238532,1,4,5
"src/java/org/apache/lucene/index/TermsHash.java",0,1,0,1,1
"src/java/org/apache/lucene/index/TermsHashConsumer.java",0,1,0,1,1
"src/java/org/apache/lucene/index/TermsHashConsumerPerField.java",0,0.864864864864865,0,2,2
"src/java/org/apache/lucene/index/TermsHashConsumerPerThread.java",0,1,0,1,1
"src/java/org/apache/lucene/index/TermsHashPerField.java",0,0.96036036036036,2,1,3
"src/java/org/apache/lucene/index/TermsHashPerThread.java",0,1,0,1,1
"src/java/org/apache/lucene/messages/Message.java",0,1,0,1,1
"src/java/org/apache/lucene/messages/MessageImpl.java",0,0.985915492957746,1,1,2
"src/java/org/apache/lucene/messages/NLS.java",0,0.947115384615385,0,2,2
"src/java/org/apache/lucene/messages/NLSException.java",0,1,0,1,1
"src/java/org/apache/lucene/queryParser/CharStream.java",0,0.839285714285714,2,2,4
"src/java/org/apache/lucene/queryParser/FastCharStream.java",0,0.854838709677419,3,2,5
"src/java/org/apache/lucene/queryParser/MultiFieldQueryParser.java",0,0.61128526645768,4,3,7
"src/java/org/apache/lucene/queryParser/ParseException.java",0,0.924242424242424,2,1,3
"src/java/org/apache/lucene/queryParser/QueryParser.java",0,0.448072805139186,8,5,13
"src/java/org/apache/lucene/queryParser/QueryParserConstants.java",0,0.408,2,3,5
"src/java/org/apache/lucene/queryParser/QueryParserTokenManager.java",0,0.51984126984127,4,5,9
"src/java/org/apache/lucene/queryParser/Token.java",0,0.556451612903226,1,2,3
"src/java/org/apache/lucene/queryParser/TokenMgrError.java",0,0.864285714285714,1,2,3
"src/java/org/apache/lucene/search/BooleanClause.java",0,0.365217391304348,2,6,8
"src/java/org/apache/lucene/search/BooleanQuery.java",0,0.269811320754717,5,7,12
"src/java/org/apache/lucene/search/BooleanScorer.java",0,0.610810810810811,4,4,8
"src/java/org/apache/lucene/search/BooleanScorer2.java",0,0.395604395604396,5,3,8
"src/java/org/apache/lucene/search/CachingSpanFilter.java",0,0.89010989010989,1,2,3
"src/java/org/apache/lucene/search/CachingWrapperFilter.java",0,0.348148148148148,1,6,7
"src/java/org/apache/lucene/search/Collector.java",0,0.966480446927374,1,1,2
"src/java/org/apache/lucene/search/ComplexExplanation.java",0,0.855072463768116,0,3,3
"src/java/org/apache/lucene/search/ConjunctionScorer.java",0,0.56953642384106,1,3,4
"src/java/org/apache/lucene/search/ConstantScoreQuery.java",0,0.761904761904762,4,2,6
"src/java/org/apache/lucene/search/ConstantScoreRangeQuery.java",0,0.485294117647059,1,4,5
"src/java/org/apache/lucene/search/DefaultSimilarity.java",0,0.478723404255319,0,3,3
"src/java/org/apache/lucene/search/DisjunctionMaxQuery.java",0,0.794871794871795,2,2,4
"src/java/org/apache/lucene/search/DisjunctionMaxScorer.java",0,0.820276497695853,1,2,3
"src/java/org/apache/lucene/search/DisjunctionSumScorer.java",0,0.501607717041801,3,3,6
"src/java/org/apache/lucene/search/DocIdSet.java",0,0.387096774193548,0,3,3
"src/java/org/apache/lucene/search/DocIdSetIterator.java",0,0.827814569536424,1,2,3
"src/java/org/apache/lucene/search/ExactPhraseScorer.java",0,0.545454545454545,1,5,6
"src/java/org/apache/lucene/search/Explanation.java",0,0.624161073825503,3,3,6
"src/java/org/apache/lucene/search/ExtendedFieldCache.java",0,0.34,1,3,4
"src/java/org/apache/lucene/search/FieldCache.java",0,0.335987261146497,2,6,8
"src/java/org/apache/lucene/search/FieldCacheImpl.java",0,0.264947245017585,4,7,11
"src/java/org/apache/lucene/search/FieldCacheRangeFilter.java",0,0.880952380952381,0,2,2
"src/java/org/apache/lucene/search/FieldCacheTermsFilter.java",0,0.972527472527473,1,1,2
"src/java/org/apache/lucene/search/FieldComparator.java",0,0.983926521239954,2,1,3
"src/java/org/apache/lucene/search/FieldComparatorSource.java",0,0.953488372093023,1,1,2
"src/java/org/apache/lucene/search/FieldDoc.java",0,0.426666666666667,1,4,5
"src/java/org/apache/lucene/search/FieldDocSortedHitQueue.java",0,0.386138613861386,0,5,5
"src/java/org/apache/lucene/search/FieldSortedHitQueue.java",0,0.381044487427466,5,6,11
"src/java/org/apache/lucene/search/FieldValueHitQueue.java",0,0.978632478632479,1,1,2
"src/java/org/apache/lucene/search/Filter.java",0,0.415094339622642,2,5,7
"src/java/org/apache/lucene/search/FilterManager.java",0,0.951219512195122,2,1,3
"src/java/org/apache/lucene/search/FilteredDocIdSet.java",0,0.935064935064935,0,2,2
"src/java/org/apache/lucene/search/FilteredDocIdSetIterator.java",0,1,0,1,1
"src/java/org/apache/lucene/search/FilteredQuery.java",0,0.359307359307359,4,6,10
"src/java/org/apache/lucene/search/FilteredTermEnum.java",0,0.69,4,4,8
"src/java/org/apache/lucene/search/FuzzyQuery.java",0,0.325301204819277,3,7,10
"src/java/org/apache/lucene/search/FuzzyTermEnum.java",0,0.843648208469055,5,2,7
"src/java/org/apache/lucene/search/Hit.java",0,0.848484848484849,3,2,5
"src/java/org/apache/lucene/search/HitCollector.java",0,0.357142857142857,1,6,7
"src/java/org/apache/lucene/search/HitCollectorWrapper.java",0,0.894736842105263,0,2,2
"src/java/org/apache/lucene/search/HitIterator.java",0,0.89873417721519,2,2,4
"src/java/org/apache/lucene/search/HitQueue.java",0,0.604651162790698,0,4,4
"src/java/org/apache/lucene/search/Hits.java",0,0.481884057971014,5,5,10
"src/java/org/apache/lucene/search/IndexSearcher.java",0,0.594512195121951,9,3,12
"src/java/org/apache/lucene/search/MatchAllDocsQuery.java",0,0.514792899408284,4,3,7
"src/java/org/apache/lucene/search/MultiPhraseQuery.java",0,0.632707774798928,6,2,8
"src/java/org/apache/lucene/search/MultiSearcher.java",0,0.323353293413174,6,4,10
"src/java/org/apache/lucene/search/MultiTermQuery.java",0,0.827740492170022,7,2,9
"src/java/org/apache/lucene/search/MultiTermQueryWrapperFilter.java",0,0.99438202247191,1,1,2
"src/java/org/apache/lucene/search/NumericRangeFilter.java",0,0.931937172774869,0,2,2
"src/java/org/apache/lucene/search/NumericRangeQuery.java",0,0.902439024390244,2,2,4
"src/java/org/apache/lucene/search/ParallelMultiSearcher.java",0,0.63573883161512,2,3,5
"src/java/org/apache/lucene/search/PhrasePositions.java",0,0.518518518518518,1,4,5
"src/java/org/apache/lucene/search/PhraseQuery.java",0,0.416149068322981,5,5,10
"src/java/org/apache/lucene/search/PhraseQueue.java",0,0.525,0,4,4
"src/java/org/apache/lucene/search/PhraseScorer.java",0,0.50251256281407,5,5,10
"src/java/org/apache/lucene/search/PositiveScoresOnlyCollector.java",0,1,0,1,1
"src/java/org/apache/lucene/search/PrefixFilter.java",0,0.434782608695652,0,3,3
"src/java/org/apache/lucene/search/PrefixQuery.java",0,0.348837209302326,3,5,8
"src/java/org/apache/lucene/search/PrefixTermEnum.java",0,1,0,1,1
"src/java/org/apache/lucene/search/Query.java",0,0.334745762711864,3,6,9
"src/java/org/apache/lucene/search/QueryFilter.java",0,0.477272727272727,1,4,5
"src/java/org/apache/lucene/search/QueryTermVector.java",0,0.831081081081081,2,3,5
"src/java/org/apache/lucene/search/QueryWrapperFilter.java",0,0.702127659574468,2,3,5
"src/java/org/apache/lucene/search/RangeFilter.java",0,1,0,1,1
"src/java/org/apache/lucene/search/RangeQuery.java",0,0.967532467532468,1,1,2
"src/java/org/apache/lucene/search/ReqExclScorer.java",0,0.598591549295775,1,2,3
"src/java/org/apache/lucene/search/ReqOptSumScorer.java",0,0.707547169811321,1,3,4
"src/java/org/apache/lucene/search/ScoreCachingWrappingScorer.java",0,1,0,1,1
"src/java/org/apache/lucene/search/ScoreDoc.java",0,0.5,0,4,4
"src/java/org/apache/lucene/search/ScoreDocComparator.java",0,0.701030927835051,2,4,6
"src/java/org/apache/lucene/search/Scorer.java",0,0.37037037037037,5,5,10
"src/java/org/apache/lucene/search/Searchable.java",0,0.432432432432432,5,3,8
"src/java/org/apache/lucene/search/Searcher.java",0,0.365019011406844,4,5,9
"src/java/org/apache/lucene/search/Similarity.java",0,0.301944728761515,8,4,12
"src/java/org/apache/lucene/search/SimilarityDelegator.java",0,0.735294117647059,3,3,6
"src/java/org/apache/lucene/search/SloppyPhraseScorer.java",0,0.759259259259259,5,3,8
"src/java/org/apache/lucene/search/Sort.java",0,0.410852713178295,2,4,6
"src/java/org/apache/lucene/search/SortComparator.java",0,0.527472527472527,2,3,5
"src/java/org/apache/lucene/search/SortComparatorSource.java",0,0.388888888888889,1,3,4
"src/java/org/apache/lucene/search/SortField.java",0,0.508196721311475,5,4,9
"src/java/org/apache/lucene/search/SpanFilter.java",0,0.973684210526316,1,1,2
"src/java/org/apache/lucene/search/SpanFilterResult.java",0,0.826086956521739,1,2,3
"src/java/org/apache/lucene/search/SpanQueryFilter.java",0,0.95,2,1,3
"src/java/org/apache/lucene/search/TermQuery.java",0,0.53072625698324,5,4,9
"src/java/org/apache/lucene/search/TermRangeFilter.java",0,0.953703703703704,1,1,2
"src/java/org/apache/lucene/search/TermRangeQuery.java",0,0.536945812807882,5,3,8
"src/java/org/apache/lucene/search/TermRangeTermEnum.java",0,0.821192052980132,1,3,4
"src/java/org/apache/lucene/search/TermScorer.java",0,0.379912663755459,6,4,10
"src/java/org/apache/lucene/search/TimeLimitedCollector.java",0,0.894009216589862,2,2,4
"src/java/org/apache/lucene/search/TimeLimitingCollector.java",0,0.995515695067265,1,1,2
"src/java/org/apache/lucene/search/TopDocCollector.java",0,0.602040816326531,0,4,4
"src/java/org/apache/lucene/search/TopDocs.java",0,0.339285714285714,1,4,5
"src/java/org/apache/lucene/search/TopDocsCollector.java",0,0.993197278911565,1,1,2
"src/java/org/apache/lucene/search/TopFieldCollector.java",0,0.996897621509824,1,1,2
"src/java/org/apache/lucene/search/TopFieldDocCollector.java",0,0.675324675324675,1,3,4
"src/java/org/apache/lucene/search/TopFieldDocs.java",0,0.760869565217391,2,2,4
"src/java/org/apache/lucene/search/TopScoreDocCollector.java",0,1,0,1,1
"src/java/org/apache/lucene/search/Weight.java",0,0.669491525423729,4,3,7
"src/java/org/apache/lucene/search/WildcardQuery.java",0,0.475728155339806,2,6,8
"src/java/org/apache/lucene/search/WildcardTermEnum.java",0,0.661375661375661,3,4,7
"src/java/org/apache/lucene/search/function/ByteFieldSource.java",0,0.902654867256637,1,2,3
"src/java/org/apache/lucene/search/function/CustomScoreQuery.java",0,0.792490118577075,2,3,5
"src/java/org/apache/lucene/search/function/DocValues.java",0,0.784210526315789,2,2,4
"src/java/org/apache/lucene/search/function/FieldCacheSource.java",0,0.9,2,2,4
"src/java/org/apache/lucene/search/function/FieldScoreQuery.java",0,0.976377952755906,2,1,3
"src/java/org/apache/lucene/search/function/FloatFieldSource.java",0,0.898148148148148,2,2,4
"src/java/org/apache/lucene/search/function/IntFieldSource.java",0,0.911504424778761,1,2,3
"src/java/org/apache/lucene/search/function/MultiValueSource.java",0,1,0,1,1
"src/java/org/apache/lucene/search/function/OrdFieldSource.java",0,0.900900900900901,2,2,4
"src/java/org/apache/lucene/search/function/ReverseOrdFieldSource.java",0,0.916666666666667,1,2,3
"src/java/org/apache/lucene/search/function/ShortFieldSource.java",0,0.902654867256637,1,2,3
"src/java/org/apache/lucene/search/function/ValueSource.java",0,0.986301369863014,1,1,2
"src/java/org/apache/lucene/search/function/ValueSourceQuery.java",0,0.848484848484849,3,2,5
"src/java/org/apache/lucene/search/payloads/AveragePayloadFunction.java",0,0.69811320754717,0,2,2
"src/java/org/apache/lucene/search/payloads/BoostingTermQuery.java",0,0.844155844155844,1,2,3
"src/java/org/apache/lucene/search/payloads/MaxPayloadFunction.java",0,0.653846153846154,0,2,2
"src/java/org/apache/lucene/search/payloads/MinPayloadFunction.java",0,0.666666666666667,0,2,2
"src/java/org/apache/lucene/search/payloads/PayloadFunction.java",0,0.904761904761905,0,2,2
"src/java/org/apache/lucene/search/payloads/PayloadNearQuery.java",0,0.533333333333333,1,2,3
"src/java/org/apache/lucene/search/payloads/PayloadSpanUtil.java",0,0.978947368421053,2,1,3
"src/java/org/apache/lucene/search/payloads/PayloadTermQuery.java",0,0.643192488262911,1,2,3
"src/java/org/apache/lucene/search/spans/FieldMaskingSpanQuery.java",0,0.974358974358974,2,1,3
"src/java/org/apache/lucene/search/spans/NearSpansOrdered.java",0,0.740298507462687,1,3,4
"src/java/org/apache/lucene/search/spans/NearSpansUnordered.java",0,0.574750830564784,3,4,7
"src/java/org/apache/lucene/search/spans/SpanFirstQuery.java",0,0.416666666666667,0,7,7
"src/java/org/apache/lucene/search/spans/SpanNearQuery.java",0,0.446153846153846,2,6,8
"src/java/org/apache/lucene/search/spans/SpanNotQuery.java",0,0.497512437810945,3,5,8
"src/java/org/apache/lucene/search/spans/SpanOrQuery.java",0,0.469230769230769,1,6,7
"src/java/org/apache/lucene/search/spans/SpanQuery.java",0,0.404255319148936,2,5,7
"src/java/org/apache/lucene/search/spans/SpanScorer.java",0,0.330645161290323,1,5,6
"src/java/org/apache/lucene/search/spans/SpanTermQuery.java",0,0.32967032967033,0,7,7
"src/java/org/apache/lucene/search/spans/SpanWeight.java",0,0.545454545454545,4,4,8
"src/java/org/apache/lucene/search/spans/Spans.java",0,0.466666666666667,0,4,4
"src/java/org/apache/lucene/search/spans/TermSpans.java",0,0.990909090909091,1,1,2
"src/java/org/apache/lucene/store/AlreadyClosedException.java",0,1,0,1,1
"src/java/org/apache/lucene/store/BufferedIndexInput.java",0,0.381188118811881,1,3,4
"src/java/org/apache/lucene/store/BufferedIndexOutput.java",0,0.818181818181818,2,2,4
"src/java/org/apache/lucene/store/ChecksumIndexInput.java",0,1,0,1,1
"src/java/org/apache/lucene/store/ChecksumIndexOutput.java",0,1,0,1,1
"src/java/org/apache/lucene/store/Directory.java",0,0.49802371541502,2,5,7
"src/java/org/apache/lucene/store/FSDirectory.java",0,0.416467780429594,4,7,11
"src/java/org/apache/lucene/store/FSLockFactory.java",0,1,0,1,1
"src/java/org/apache/lucene/store/FileSwitchDirectory.java",0,0.992857142857143,1,1,2
"src/java/org/apache/lucene/store/IndexInput.java",0,0.609053497942387,2,3,5
"src/java/org/apache/lucene/store/IndexOutput.java",0,0.555066079295154,2,2,4
"src/java/org/apache/lucene/store/Lock.java",0,0.36734693877551,1,5,6
"src/java/org/apache/lucene/store/LockFactory.java",0,0.77027027027027,1,2,3
"src/java/org/apache/lucene/store/LockObtainFailedException.java",0,1,0,1,1
"src/java/org/apache/lucene/store/LockReleaseFailedException.java",0,1,0,1,1
"src/java/org/apache/lucene/store/LockStressTest.java",0,1,0,1,1
"src/java/org/apache/lucene/store/LockVerifyServer.java",0,1,0,1,1
"src/java/org/apache/lucene/store/MMapDirectory.java",0,0.497572815533981,4,2,6
"src/java/org/apache/lucene/store/NIOFSDirectory.java",0,0.856353591160221,0,3,3
"src/java/org/apache/lucene/store/NativeFSLockFactory.java",0,0.672839506172839,1,3,4
"src/java/org/apache/lucene/store/NoLockFactory.java",0,0.984126984126984,1,1,2
"src/java/org/apache/lucene/store/NoSuchDirectoryException.java",0,1,0,1,1
"src/java/org/apache/lucene/store/RAMDirectory.java",0,0.41897233201581,5,4,9
"src/java/org/apache/lucene/store/RAMFile.java",0,0.571428571428571,0,5,5
"src/java/org/apache/lucene/store/RAMInputStream.java",0,0.456896551724138,0,5,5
"src/java/org/apache/lucene/store/RAMOutputStream.java",0,0.462025316455696,2,3,5
"src/java/org/apache/lucene/store/SimpleFSDirectory.java",0,0.907488986784141,1,2,3
"src/java/org/apache/lucene/store/SimpleFSLockFactory.java",0,0.60431654676259,2,3,5
"src/java/org/apache/lucene/store/SingleInstanceLockFactory.java",0,0.917647058823529,0,2,2
"src/java/org/apache/lucene/store/VerifyingLockFactory.java",0,1,0,1,1
"src/java/org/apache/lucene/util/ArrayUtil.java",0,0.504201680672269,1,2,3
"src/java/org/apache/lucene/util/Attribute.java",0,1,0,1,1
"src/java/org/apache/lucene/util/AttributeImpl.java",0,0.909836065573771,0,2,2
"src/java/org/apache/lucene/util/AttributeSource.java",0,0.773420479302832,2,2,4
"src/java/org/apache/lucene/util/AverageGuessMemoryModel.java",0,1,0,1,1
"src/java/org/apache/lucene/util/BitUtil.java",0,0.97671568627451,2,1,3
"src/java/org/apache/lucene/util/BitVector.java",0,0.367041198501873,3,3,6
"src/java/org/apache/lucene/util/CloseableThreadLocal.java",0,0.989247311827957,1,1,2
"src/java/org/apache/lucene/util/Constants.java",0,0.469879518072289,2,3,5
"src/java/org/apache/lucene/util/DocIdBitSet.java",0,0.705263157894737,0,3,3
"src/java/org/apache/lucene/util/FieldCacheSanityChecker.java",0,1,0,1,1
"src/java/org/apache/lucene/util/IndexableBinaryStringTools.java",0,0.996825396825397,1,1,2
"src/java/org/apache/lucene/util/MapOfSets.java",0,1,0,1,1
"src/java/org/apache/lucene/util/MemoryModel.java",0,1,0,1,1
"src/java/org/apache/lucene/util/NumericUtils.java",0,0.929336188436831,1,2,3
"src/java/org/apache/lucene/util/OpenBitSet.java",0,0.940886699507389,2,2,4
"src/java/org/apache/lucene/util/OpenBitSetDISI.java",0,0.862745098039216,0,2,2
"src/java/org/apache/lucene/util/OpenBitSetIterator.java",0,0.729468599033816,0,2,2
"src/java/org/apache/lucene/util/Parameter.java",0,0.891891891891892,1,2,3
"src/java/org/apache/lucene/util/PriorityQueue.java",0,0.581560283687943,4,3,7
"src/java/org/apache/lucene/util/RamUsageEstimator.java",0,1,0,1,1
"src/java/org/apache/lucene/util/ReaderUtil.java",0,0.945945945945946,0,2,2
"src/java/org/apache/lucene/util/ScorerDocQueue.java",0,0.963133640552995,1,1,2
"src/java/org/apache/lucene/util/SimpleStringInterner.java",0,1,0,1,1
"src/java/org/apache/lucene/util/SmallFloat.java",0,1,0,1,1
"src/java/org/apache/lucene/util/SortedVIntList.java",0,0.834008097165992,1,2,3
"src/java/org/apache/lucene/util/SorterTemplate.java",0,1,0,1,1
"src/java/org/apache/lucene/util/StringHelper.java",0,0.324675324675325,0,4,4
"src/java/org/apache/lucene/util/StringInterner.java",0,1,0,1,1
"src/java/org/apache/lucene/util/ToStringUtils.java",0,0.645161290322581,0,4,4
"src/java/org/apache/lucene/util/UnicodeUtil.java",0,0.995525727069351,1,1,2
"src/java/org/apache/lucene/util/Version.java",0,1,0,1,1
"src/java/org/apache/lucene/util/cache/Cache.java",0,1,0,1,1
"src/java/org/apache/lucene/util/cache/SimpleLRUCache.java",0,1,0,1,1
"src/java/org/apache/lucene/util/cache/SimpleMapCache.java",0,1,0,1,1
"src/test/org/apache/lucene/TestDemo.java",0,0.6875,1,5,6
"src/test/org/apache/lucene/TestHitIterator.java",0,0.670588235294118,0,3,3
"src/test/org/apache/lucene/TestMergeSchedulerExternal.java",0,1,0,1,1
"src/test/org/apache/lucene/TestSearch.java",0,0.746478873239437,5,2,7
"src/test/org/apache/lucene/TestSearchForDuplicates.java",0,0.699346405228758,4,3,7
"src/test/org/apache/lucene/TestSnapshotDeletionPolicy.java",0,0.995575221238938,1,1,2
"src/test/org/apache/lucene/analysis/BaseTokenStreamTestCase.java",0,1,0,1,1
"src/test/org/apache/lucene/analysis/TestASCIIFoldingFilter.java",0,0.953305351521511,2,1,3
"src/test/org/apache/lucene/analysis/TestAnalyzers.java",0,0.387096774193548,1,5,6
"src/test/org/apache/lucene/analysis/TestCachingTokenFilter.java",0,0.981651376146789,2,1,3
"src/test/org/apache/lucene/analysis/TestCharArraySet.java",0,0.741573033707865,0,3,3
"src/test/org/apache/lucene/analysis/TestCharFilter.java",0,0.970149253731343,1,1,2
"src/test/org/apache/lucene/analysis/TestCharacterCache.java",0,0.941176470588235,0,2,2
"src/test/org/apache/lucene/analysis/TestISOLatin1AccentFilter.java",0,0.90990990990991,2,2,4
"src/test/org/apache/lucene/analysis/TestKeywordAnalyzer.java",0,0.416666666666667,1,5,6
"src/test/org/apache/lucene/analysis/TestLengthFilter.java",0,0.585365853658537,1,3,4
"src/test/org/apache/lucene/analysis/TestMappingCharFilter.java",0,0.720496894409938,0,2,2
"src/test/org/apache/lucene/analysis/TestNumericTokenStream.java",0,0.972602739726027,1,1,2
"src/test/org/apache/lucene/analysis/TestPerFieldAnalzyerWrapper.java",0,0.520833333333333,1,4,5
"src/test/org/apache/lucene/analysis/TestStandardAnalyzer.java",0,0.734782608695652,2,3,5
"src/test/org/apache/lucene/analysis/TestStopAnalyzer.java",0,0.323809523809524,2,7,9
"src/test/org/apache/lucene/analysis/TestStopFilter.java",0,0.934306569343066,2,2,4
"src/test/org/apache/lucene/analysis/TestTeeSinkTokenFilter.java",0,0.996240601503759,1,1,2
"src/test/org/apache/lucene/analysis/TestTeeTokenFilter.java",0,0.75968992248062,2,2,4
"src/test/org/apache/lucene/analysis/TestToken.java",0,0.783783783783784,0,2,2
"src/test/org/apache/lucene/analysis/TestTokenStreamBWComp.java",0,0.743002544529262,0,2,2
"src/test/org/apache/lucene/analysis/tokenattributes/TestSimpleAttributeImpls.java",0,1,0,1,1
"src/test/org/apache/lucene/analysis/tokenattributes/TestTermAttributeImpl.java",0,1,0,1,1
"src/test/org/apache/lucene/document/TestBinaryDocument.java",0,0.598484848484849,1,3,4
"src/test/org/apache/lucene/document/TestDateTools.java",0,0.924242424242424,4,1,5
"src/test/org/apache/lucene/document/TestDocument.java",0,0.276595744680851,3,5,8
"src/test/org/apache/lucene/document/TestNumberTools.java",0,0.902439024390244,1,2,3
"src/test/org/apache/lucene/index/DocHelper.java",0,0.250965250965251,1,5,6
"src/test/org/apache/lucene/index/MockIndexInput.java",0,0.583333333333333,0,4,4
"src/test/org/apache/lucene/index/TestAddIndexesNoOptimize.java",0,0.633752244165171,1,2,3
"src/test/org/apache/lucene/index/TestAtomicUpdate.java",0,1,0,1,1
"src/test/org/apache/lucene/index/TestBackwardsCompatibility.java",0,0.880294659300184,2,2,4
"src/test/org/apache/lucene/index/TestByteSlices.java",0,1,0,1,1
"src/test/org/apache/lucene/index/TestCheckIndex.java",0,0.99009900990099,1,1,2
"src/test/org/apache/lucene/index/TestCompoundFile.java",0,0.605504587155963,6,4,10
"src/test/org/apache/lucene/index/TestConcurrentMergeScheduler.java",0,1,0,1,1
"src/test/org/apache/lucene/index/TestCrash.java",0,1,0,1,1
"src/test/org/apache/lucene/index/TestDeletionPolicy.java",0,0.969855832241153,1,1,2
"src/test/org/apache/lucene/index/TestDirectoryReader.java",0,0.673267326732673,0,3,3
"src/test/org/apache/lucene/index/TestDoc.java",0,0.56,5,3,8
"src/test/org/apache/lucene/index/TestDocumentWriter.java",0,0.263665594855305,2,6,8
"src/test/org/apache/lucene/index/TestFieldInfos.java",0,0.590909090909091,0,4,4
"src/test/org/apache/lucene/index/TestFieldsReader.java",0,0.438228438228438,3,3,6
"src/test/org/apache/lucene/index/TestFilterIndexReader.java",0,0.785714285714286,4,2,6
"src/test/org/apache/lucene/index/TestIndexFileDeleter.java",0,0.924444444444444,0,2,2
"src/test/org/apache/lucene/index/TestIndexInput.java",0,0.459016393442623,1,4,5
"src/test/org/apache/lucene/index/TestIndexModifier.java",0,0.843416370106762,2,3,5
"src/test/org/apache/lucene/index/TestIndexReader.java",0,0.6625,10,3,13
"src/test/org/apache/lucene/index/TestIndexReaderClone.java",0,0.93796992481203,0,2,2
"src/test/org/apache/lucene/index/TestIndexReaderCloneNorms.java",0,1,0,1,1
"src/test/org/apache/lucene/index/TestIndexReaderReopen.java",0,0.614728682170543,2,3,5
"src/test/org/apache/lucene/index/TestIndexWriter.java",0,0.902533276084156,6,2,8
"src/test/org/apache/lucene/index/TestIndexWriterDelete.java",0,0.972716488730724,1,1,2
"src/test/org/apache/lucene/index/TestIndexWriterExceptions.java",0,1,0,1,1
"src/test/org/apache/lucene/index/TestIndexWriterLockRelease.java",0,0.8,0,2,2
"src/test/org/apache/lucene/index/TestIndexWriterMergePolicy.java",0,0.816793893129771,0,3,3
"src/test/org/apache/lucene/index/TestIndexWriterMerging.java",0,0.990740740740741,1,1,2
"src/test/org/apache/lucene/index/TestIndexWriterReader.java",0,1,0,1,1
"src/test/org/apache/lucene/index/TestLazyBug.java",0,0.9375,0,2,2
"src/test/org/apache/lucene/index/TestLazyProxSkipping.java",0,0.711229946524064,0,3,3
"src/test/org/apache/lucene/index/TestMultiLevelSkipList.java",0,0.9875,1,1,2
"src/test/org/apache/lucene/index/TestMultiReader.java",0,0.468085106382979,0,5,5
"src/test/org/apache/lucene/index/TestNRTReaderWithThreads.java",0,1,0,1,1
"src/test/org/apache/lucene/index/TestNorms.java",0,0.870833333333333,1,3,4
"src/test/org/apache/lucene/index/TestOmitTf.java",0,1,0,1,1
"src/test/org/apache/lucene/index/TestParallelReader.java",0,0.262798634812287,1,5,6
"src/test/org/apache/lucene/index/TestParallelReaderEmptyIndex.java",0,1,0,1,1
"src/test/org/apache/lucene/index/TestParallelTermEnum.java",0,0.850828729281768,0,3,3
"src/test/org/apache/lucene/index/TestPayloads.java",0,0.955249569707401,1,1,2
"src/test/org/apache/lucene/index/TestPositionBasedTermVectorMapper.java",0,0.951923076923077,1,1,2
"src/test/org/apache/lucene/index/TestSegmentMerger.java",0,0.469026548672566,2,4,6
"src/test/org/apache/lucene/index/TestSegmentReader.java",0,0.365853658536585,3,4,7
"src/test/org/apache/lucene/index/TestSegmentTermDocs.java",0,0.545081967213115,2,3,5
"src/test/org/apache/lucene/index/TestSegmentTermEnum.java",0,0.398373983739837,0,5,5
"src/test/org/apache/lucene/index/TestStressIndexing.java",0,1,0,1,1
"src/test/org/apache/lucene/index/TestStressIndexing2.java",0,0.98780487804878,2,1,3
"src/test/org/apache/lucene/index/TestTerm.java",0,0.472222222222222,0,3,3
"src/test/org/apache/lucene/index/TestTermVectorsReader.java",0,0.456221198156682,2,5,7
"src/test/org/apache/lucene/index/TestTermdocPerf.java",0,0.983471074380165,1,1,2
"src/test/org/apache/lucene/index/TestThreadedOptimize.java",0,1,0,1,1
"src/test/org/apache/lucene/index/TestTransactionRollback.java",0,0.985915492957746,1,1,2
"src/test/org/apache/lucene/index/TestTransactions.java",0,1,0,1,1
"src/test/org/apache/lucene/index/TestWordlistLoader.java",0,0.678571428571429,1,3,4
"src/test/org/apache/lucene/messages/MessagesTestBundle.java",0,1,0,1,1
"src/test/org/apache/lucene/messages/TestNLS.java",0,0.938271604938272,0,2,2
"src/test/org/apache/lucene/queryParser/TestMultiAnalyzer.java",0,0.558823529411765,3,3,6
"src/test/org/apache/lucene/queryParser/TestMultiFieldQueryParser.java",0,0.694189602446483,4,3,7
"src/test/org/apache/lucene/queryParser/TestQueryParser.java",0,0.303834808259587,6,8,14
"src/test/org/apache/lucene/search/BaseTestRangeFilter.java",0,0.586206896551724,1,4,5
"src/test/org/apache/lucene/search/CachingWrapperFilterHelper.java",0,0.916666666666667,2,1,3
"src/test/org/apache/lucene/search/CheckHits.java",0,0.377690802348337,4,5,9
"src/test/org/apache/lucene/search/JustCompileSearch.java",0,0.978260869565217,2,1,3
"src/test/org/apache/lucene/search/MockFilter.java",0,0.58974358974359,0,4,4
"src/test/org/apache/lucene/search/QueryUtils.java",0,0.554744525547445,2,3,5
"src/test/org/apache/lucene/search/SampleComparable.java",0,0.885906040268456,2,2,4
"src/test/org/apache/lucene/search/SingleDocTestFilter.java",0,0.763157894736842,0,3,3
"src/test/org/apache/lucene/search/TestBoolean2.java",0,0.486607142857143,1,3,4
"src/test/org/apache/lucene/search/TestBooleanMinShouldMatch.java",0,0.91025641025641,2,1,3
"src/test/org/apache/lucene/search/TestBooleanOr.java",0,0.9125,3,1,4
"src/test/org/apache/lucene/search/TestBooleanPrefixQuery.java",0,0.710280373831776,2,3,5
"src/test/org/apache/lucene/search/TestBooleanQuery.java",0,0.463157894736842,0,4,4
"src/test/org/apache/lucene/search/TestBooleanScorer.java",0,0.565217391304348,2,3,5
"src/test/org/apache/lucene/search/TestCachingWrapperFilter.java",0,0.480392156862745,1,5,6
"src/test/org/apache/lucene/search/TestComplexExplanations.java",0,0.950943396226415,2,1,3
"src/test/org/apache/lucene/search/TestComplexExplanationsOfNonMatches.java",0,0.890909090909091,0,2,2
"src/test/org/apache/lucene/search/TestCustomSearcherSort.java",0,0.927536231884058,0,2,2
"src/test/org/apache/lucene/search/TestDateFilter.java",0,0.602409638554217,4,3,7
"src/test/org/apache/lucene/search/TestDateSort.java",0,0.915966386554622,3,1,4
"src/test/org/apache/lucene/search/TestDisjunctionMaxQuery.java",0,0.739219712525667,2,3,5
"src/test/org/apache/lucene/search/TestDocBoost.java",0,0.557894736842105,1,4,5
"src/test/org/apache/lucene/search/TestDocIdSet.java",0,1,0,1,1
"src/test/org/apache/lucene/search/TestElevationComparator.java",0,1,0,1,1
"src/test/org/apache/lucene/search/TestExplanations.java",0,0.934156378600823,3,1,4
"src/test/org/apache/lucene/search/TestFieldCache.java",0,0.893939393939394,0,2,2
"src/test/org/apache/lucene/search/TestFieldCacheRangeFilter.java",0,0.729636048526863,0,2,2
"src/test/org/apache/lucene/search/TestFieldCacheTermsFilter.java",0,0.960526315789474,1,1,2
"src/test/org/apache/lucene/search/TestFilteredQuery.java",0,0.362385321100917,4,6,10
"src/test/org/apache/lucene/search/TestFilteredSearch.java",0,0.967391304347826,2,1,3
"src/test/org/apache/lucene/search/TestFuzzyQuery.java",0,0.341379310344828,2,4,6
"src/test/org/apache/lucene/search/TestMatchAllDocsQuery.java",0,0.414814814814815,1,5,6
"src/test/org/apache/lucene/search/TestMultiPhraseQuery.java",0,0.748917748917749,3,3,6
"src/test/org/apache/lucene/search/TestMultiSearcher.java",0,0.318181818181818,2,6,8
"src/test/org/apache/lucene/search/TestMultiSearcherRanking.java",0,0.826347305389222,0,4,4
"src/test/org/apache/lucene/search/TestMultiTermConstantScore.java",0,0.994177583697234,1,1,2
"src/test/org/apache/lucene/search/TestMultiThreadTermVectors.java",0,0.723958333333333,3,2,5
"src/test/org/apache/lucene/search/TestMultiValuedNumericRangeQuery.java",0,1,0,1,1
"src/test/org/apache/lucene/search/TestNot.java",0,0.684210526315789,2,4,6
"src/test/org/apache/lucene/search/TestNumericRangeQuery32.java",0,0.997679814385151,1,1,2
"src/test/org/apache/lucene/search/TestNumericRangeQuery64.java",0,0.997821350762527,1,1,2
"src/test/org/apache/lucene/search/TestParallelMultiSearcher.java",0,0.833333333333333,0,2,2
"src/test/org/apache/lucene/search/TestPhrasePrefixQuery.java",0,0.657142857142857,2,4,6
"src/test/org/apache/lucene/search/TestPhraseQuery.java",0,0.268551236749117,3,7,10
"src/test/org/apache/lucene/search/TestPositionIncrement.java",0,0.537433155080214,4,5,9
"src/test/org/apache/lucene/search/TestPositiveScoresOnlyCollector.java",0,1,0,1,1
"src/test/org/apache/lucene/search/TestPrefixFilter.java",0,0.786407766990291,1,2,3
"src/test/org/apache/lucene/search/TestPrefixQuery.java",0,0.625,0,5,5
"src/test/org/apache/lucene/search/TestQueryTermVector.java",0,0.866666666666667,1,2,3
"src/test/org/apache/lucene/search/TestQueryWrapperFilter.java",0,0.843373493975904,0,2,2
"src/test/org/apache/lucene/search/TestScoreCachingWrappingScorer.java",0,1,0,1,1
"src/test/org/apache/lucene/search/TestScorerPerf.java",0,0.904878048780488,2,2,4
"src/test/org/apache/lucene/search/TestSearchHitsWithDeletions.java",0,0.967032967032967,3,1,4
"src/test/org/apache/lucene/search/TestSetNorm.java",0,0.626373626373626,0,4,4
"src/test/org/apache/lucene/search/TestSimilarity.java",0,0.536423841059603,4,2,6
"src/test/org/apache/lucene/search/TestSimpleExplanations.java",0,0.778378378378378,1,2,3
"src/test/org/apache/lucene/search/TestSimpleExplanationsOfNonMatches.java",0,0.890909090909091,0,2,2
"src/test/org/apache/lucene/search/TestSloppyPhraseQuery.java",0,0.980645161290323,2,1,3
"src/test/org/apache/lucene/search/TestSort.java",0,0.773946360153257,5,3,8
"src/test/org/apache/lucene/search/TestSpanQueryFilter.java",0,0.666666666666667,0,3,3
"src/test/org/apache/lucene/search/TestStressSort.java",0,0.896464646464647,0,2,2
"src/test/org/apache/lucene/search/TestTermRangeFilter.java",0,0.377672209026128,2,5,7
"src/test/org/apache/lucene/search/TestTermRangeQuery.java",0,0.403183023872679,2,5,7
"src/test/org/apache/lucene/search/TestTermScorer.java",0,0.724770642201835,2,3,5
"src/test/org/apache/lucene/search/TestTermVectors.java",0,0.408878504672897,2,5,7
"src/test/org/apache/lucene/search/TestThreadSafe.java",0,0.937106918238994,1,2,3
"src/test/org/apache/lucene/search/TestTimeLimitedCollector.java",0,0.939024390243902,2,2,4
"src/test/org/apache/lucene/search/TestTimeLimitingCollector.java",0,0.994169096209913,1,1,2
"src/test/org/apache/lucene/search/TestTopDocsCollector.java",0,1,0,1,1
"src/test/org/apache/lucene/search/TestTopScoreDocCollector.java",0,1,0,1,1
"src/test/org/apache/lucene/search/TestWildcard.java",0,0.392996108949416,6,4,10
"src/test/org/apache/lucene/search/function/FunctionTestSetup.java",0,0.942675159235669,0,2,2
"src/test/org/apache/lucene/search/function/JustCompileSearchSpans.java",0,1,0,1,1
"src/test/org/apache/lucene/search/function/TestCustomScoreQuery.java",0,1,0,1,1
"src/test/org/apache/lucene/search/function/TestDocValues.java",0,0.991379310344828,1,1,2
"src/test/org/apache/lucene/search/function/TestFieldScoreQuery.java",0,0.786026200873362,1,2,3
"src/test/org/apache/lucene/search/function/TestOrdValues.java",0,0.759336099585062,1,3,4
"src/test/org/apache/lucene/search/function/TestValueSource.java",0,1,0,1,1
"src/test/org/apache/lucene/search/payloads/PayloadHelper.java",0,0.747967479674797,1,3,4
"src/test/org/apache/lucene/search/payloads/TestBoostingTermQuery.java",0,0.828571428571429,1,3,4
"src/test/org/apache/lucene/search/payloads/TestPayloadNearQuery.java",0,0.941176470588235,0,2,2
"src/test/org/apache/lucene/search/payloads/TestPayloadTermQuery.java",0,0.922360248447205,0,2,2
"src/test/org/apache/lucene/search/spans/JustCompileSearchSpans.java",0,0.917910447761194,0,2,2
"src/test/org/apache/lucene/search/spans/TestBasics.java",0,0.629156010230179,4,3,7
"src/test/org/apache/lucene/search/spans/TestFieldMaskingSpanQuery.java",0,1,0,1,1
"src/test/org/apache/lucene/search/spans/TestNearSpansOrdered.java",0,0.860335195530726,2,2,4
"src/test/org/apache/lucene/search/spans/TestPayloadSpans.java",0,0.631578947368421,3,2,5
"src/test/org/apache/lucene/search/spans/TestSpanExplanations.java",0,0.969072164948454,1,1,2
"src/test/org/apache/lucene/search/spans/TestSpanExplanationsOfNonMatches.java",0,0.85,0,2,2
"src/test/org/apache/lucene/search/spans/TestSpans.java",0,0.375782881002088,2,5,7
"src/test/org/apache/lucene/search/spans/TestSpansAdvanced.java",0,0.686746987951807,1,2,3
"src/test/org/apache/lucene/search/spans/TestSpansAdvanced2.java",0,0.820754716981132,1,2,3
"src/test/org/apache/lucene/store/MockRAMDirectory.java",0,0.994219653179191,1,1,2
"src/test/org/apache/lucene/store/MockRAMInputStream.java",0,0.9375,0,2,2
"src/test/org/apache/lucene/store/MockRAMOutputStream.java",0,0.912621359223301,0,2,2
"src/test/org/apache/lucene/store/TestBufferedIndexInput.java",0,0.710875331564987,1,3,4
"src/test/org/apache/lucene/store/TestDirectory.java",0,0.571428571428571,1,2,3
"src/test/org/apache/lucene/store/TestFileSwitchDirectory.java",0,1,0,1,1
"src/test/org/apache/lucene/store/TestHugeRamFile.java",0,0.98019801980198,1,1,2
"src/test/org/apache/lucene/store/TestLock.java",0,0.653846153846154,2,2,4
"src/test/org/apache/lucene/store/TestLockFactory.java",0,0.728695652173913,3,3,6
"src/test/org/apache/lucene/store/TestRAMDirectory.java",0,0.564655172413793,2,3,5
"src/test/org/apache/lucene/store/TestWindowsMMap.java",0,1,0,1,1
"src/test/org/apache/lucene/store/_TestHelper.java",0,0.461538461538462,2,3,5
"src/test/org/apache/lucene/util/ArrayUtilTest.java",0,0.743243243243243,1,2,3
"src/test/org/apache/lucene/util/English.java",0,0.941747572815534,0,2,2
"src/test/org/apache/lucene/util/LocalizedTestCase.java",0,1,0,1,1
"src/test/org/apache/lucene/util/LuceneTestCase.java",0,0.579646017699115,1,3,4
"src/test/org/apache/lucene/util/TestAttributeSource.java",0,0.9453125,0,2,2
"src/test/org/apache/lucene/util/TestBitVector.java",0,0.564459930313589,2,3,5
"src/test/org/apache/lucene/util/TestCloseableThreadLocal.java",0,1,0,1,1
"src/test/org/apache/lucene/util/TestFieldCacheSanityChecker.java",0,1,0,1,1
"src/test/org/apache/lucene/util/TestIndexableBinaryStringTools.java",0,1,0,1,1
"src/test/org/apache/lucene/util/TestNumericUtils.java",0,1,0,1,1
"src/test/org/apache/lucene/util/TestOpenBitSet.java",0,0.95,0,2,2
"src/test/org/apache/lucene/util/TestPriorityQueue.java",0,0.565891472868217,2,4,6
"src/test/org/apache/lucene/util/TestRamUsageEstimator.java",0,1,0,1,1
"src/test/org/apache/lucene/util/TestSmallFloat.java",0,0.991071428571429,1,1,2
"src/test/org/apache/lucene/util/TestSortedVIntList.java",0,0.969387755102041,2,1,3
"src/test/org/apache/lucene/util/TestStringHelper.java",0,0.8,0,3,3
"src/test/org/apache/lucene/util/TestStringIntern.java",0,1,0,1,1
"src/test/org/apache/lucene/util/_TestUtil.java",0,0.833333333333333,1,2,3
"src/test/org/apache/lucene/util/cache/TestSimpleLRUCache.java",0,0.968253968253968,1,1,2
