"Filename","X","LineOWN","LineMinor","LineMajor","LineNumDev"
"archetypes/quickstart/src/main/resources/archetype-resources/src/main/java/HomePage.java",0,0.714285714285714,0,4,4
"archetypes/quickstart/src/main/resources/archetype-resources/src/main/java/WicketApplication.java",0,0.483870967741935,1,3,4
"archetypes/quickstart/src/main/resources/archetype-resources/src/test/java/Start.java",0,0.921052631578947,1,2,3
"archetypes/quickstart/src/main/resources/archetype-resources/src/test/java/TestHomePage.java",0,0.724137931034483,2,2,4
"testing/wicket-threadtest/src/main/java/org/apache/wicket/threadtest/App1Test1.java",0,0.755102040816326,2,4,6
"testing/wicket-threadtest/src/main/java/org/apache/wicket/threadtest/App1Test2.java",0,0.822222222222222,1,3,4
"testing/wicket-threadtest/src/main/java/org/apache/wicket/threadtest/App1Test3.java",0,0.764705882352941,1,3,4
"testing/wicket-threadtest/src/main/java/org/apache/wicket/threadtest/App2Test1.java",0,0.849056603773585,1,3,4
"testing/wicket-threadtest/src/main/java/org/apache/wicket/threadtest/apps/app1/Contact.java",0,0.727777777777778,1,2,3
"testing/wicket-threadtest/src/main/java/org/apache/wicket/threadtest/apps/app1/ContactDataProvider.java",0,0.649350649350649,1,3,4
"testing/wicket-threadtest/src/main/java/org/apache/wicket/threadtest/apps/app1/ContactGenerator.java",0,0.646551724137931,1,2,3
"testing/wicket-threadtest/src/main/java/org/apache/wicket/threadtest/apps/app1/ContactsDatabase.java",0,0.666666666666667,2,2,4
"testing/wicket-threadtest/src/main/java/org/apache/wicket/threadtest/apps/app1/DatabaseLocator.java",0,0.852941176470588,1,2,3
"testing/wicket-threadtest/src/main/java/org/apache/wicket/threadtest/apps/app1/DetachableContactModel.java",0,0.54954954954955,0,3,3
"testing/wicket-threadtest/src/main/java/org/apache/wicket/threadtest/apps/app1/FormInputModel.java",0,0.723744292237443,2,2,4
"testing/wicket-threadtest/src/main/java/org/apache/wicket/threadtest/apps/app1/Home.java",0,0.410958904109589,3,5,8
"testing/wicket-threadtest/src/main/java/org/apache/wicket/threadtest/apps/app1/ResourceTestPage.java",0,0.525252525252525,2,4,6
"testing/wicket-threadtest/src/main/java/org/apache/wicket/threadtest/apps/app1/TestApp1.java",0,0.43956043956044,2,3,5
"testing/wicket-threadtest/src/main/java/org/apache/wicket/threadtest/apps/app1/UsPhoneNumber.java",0,0.767123287671233,1,2,3
"testing/wicket-threadtest/src/main/java/org/apache/wicket/threadtest/apps/app2/Connection.java",0,0.6,1,2,3
"testing/wicket-threadtest/src/main/java/org/apache/wicket/threadtest/apps/app2/Home.java",0,0.5625,2,3,5
"testing/wicket-threadtest/src/main/java/org/apache/wicket/threadtest/apps/app2/Pool.java",0,0.596899224806202,2,2,4
"testing/wicket-threadtest/src/main/java/org/apache/wicket/threadtest/apps/app2/TestApp2.java",0,0.40506329113924,1,4,5
"testing/wicket-threadtest/src/main/java/org/apache/wicket/threadtest/apps/app2/TestFilter.java",0,0.783333333333333,1,2,3
"testing/wicket-threadtest/src/main/java/org/apache/wicket/threadtest/tester/AbstractCommand.java",0,0.818181818181818,2,2,4
"testing/wicket-threadtest/src/main/java/org/apache/wicket/threadtest/tester/AbstractGetCommand.java",0,0.753424657534247,2,2,4
"testing/wicket-threadtest/src/main/java/org/apache/wicket/threadtest/tester/Command.java",0,0.916666666666667,1,2,3
"testing/wicket-threadtest/src/main/java/org/apache/wicket/threadtest/tester/CommandRunner.java",0,0.666666666666667,2,3,5
"testing/wicket-threadtest/src/main/java/org/apache/wicket/threadtest/tester/SimpleGetCommand.java",0,0.689075630252101,3,2,5
"testing/wicket-threadtest/src/main/java/org/apache/wicket/threadtest/tester/Tester.java",0,0.672185430463576,3,2,5
"testing/wicket-threadtest/src/test/java/org/apache/wicket/util/license/ApacheLicenceHeaderTest.java",0,0.72972972972973,1,2,3
"wicket-auth-roles/src/main/java/org/apache/wicket/authroles/authentication/AbstractAuthenticatedWebSession.java",0,1,0,1,1
"wicket-auth-roles/src/main/java/org/apache/wicket/authroles/authentication/AuthenticatedWebApplication.java",0,0.366459627329193,4,6,10
"wicket-auth-roles/src/main/java/org/apache/wicket/authroles/authentication/AuthenticatedWebSession.java",0,0.512820512820513,3,5,8
"wicket-auth-roles/src/main/java/org/apache/wicket/authroles/authentication/pages/SignInPage.java",0,0.627450980392157,3,2,5
"wicket-auth-roles/src/main/java/org/apache/wicket/authroles/authentication/pages/SignOutPage.java",0,0.63265306122449,4,2,6
"wicket-auth-roles/src/main/java/org/apache/wicket/authroles/authentication/panel/SignInPanel.java",0,0.515625,6,2,8
"wicket-auth-roles/src/main/java/org/apache/wicket/authroles/authorization/strategies/role/AbstractRoleAuthorizationStrategy.java",0,0.674157303370786,3,3,6
"wicket-auth-roles/src/main/java/org/apache/wicket/authroles/authorization/strategies/role/IRoleCheckingStrategy.java",0,0.317073170731707,1,4,5
"wicket-auth-roles/src/main/java/org/apache/wicket/authroles/authorization/strategies/role/RoleAuthorizationStrategy.java",0,0.452380952380952,1,4,5
"wicket-auth-roles/src/main/java/org/apache/wicket/authroles/authorization/strategies/role/Roles.java",0,0.63448275862069,3,3,6
"wicket-auth-roles/src/main/java/org/apache/wicket/authroles/authorization/strategies/role/annotations/AnnotationsRoleAuthorizationStrategy.java",0,0.401408450704225,3,4,7
"wicket-auth-roles/src/main/java/org/apache/wicket/authroles/authorization/strategies/role/annotations/AuthorizeAction.java",0,0.585714285714286,1,4,5
"wicket-auth-roles/src/main/java/org/apache/wicket/authroles/authorization/strategies/role/annotations/AuthorizeActions.java",0,0.633333333333333,1,4,5
"wicket-auth-roles/src/main/java/org/apache/wicket/authroles/authorization/strategies/role/annotations/AuthorizeInstantiation.java",0,0.553571428571429,1,5,6
"wicket-auth-roles/src/main/java/org/apache/wicket/authroles/authorization/strategies/role/metadata/ActionPermissions.java",0,0.731034482758621,3,4,7
"wicket-auth-roles/src/main/java/org/apache/wicket/authroles/authorization/strategies/role/metadata/InstantiationPermissions.java",0,0.621951219512195,3,4,7
"wicket-auth-roles/src/main/java/org/apache/wicket/authroles/authorization/strategies/role/metadata/MetaDataRoleAuthorizationStrategy.java",0,0.365217391304348,3,4,7
"wicket-auth-roles/src/test/java/org/apache/wicket/authroles/authentication/panel/SignInPanelTest.java",0,1,0,1,1
"wicket-auth-roles/src/test/java/org/apache/wicket/authroles/authorization/strategies/role/annotations/AdminPage.java",0,0.552631578947368,2,3,5
"wicket-auth-roles/src/test/java/org/apache/wicket/authroles/authorization/strategies/role/annotations/AnnotationsRoleTest.java",0,0.579310344827586,4,4,8
"wicket-auth-roles/src/test/java/org/apache/wicket/authroles/authorization/strategies/role/annotations/NormalPage.java",0,0.555555555555556,3,2,5
"wicket-auth-roles/src/test/java/org/apache/wicket/authroles/authorization/strategies/role/metadata/ActionPermissionsTest.java",0,0.341085271317829,3,5,8
"wicket-auth-roles/src/test/java/org/apache/wicket/authroles/authorization/strategies/role/metadata/InstantiationPermissionsTest.java",0,0.672,1,3,4
"wicket-auth-roles/src/test/java/org/apache/wicket/util/license/ApacheLicenceHeaderTest.java",0,0.714285714285714,2,3,5
"wicket-auth-roles/src/test/java/org/apache/wicket/util/markup/xhtml/WellFormedXmlTest.java",0,0.941176470588235,0,2,2
"wicket-core/src/main/java/org/apache/wicket/Application.java",0,0.387213510253317,11,6,17
"wicket-core/src/main/java/org/apache/wicket/ApplicationListenerCollection.java",0,1,0,1,1
"wicket-core/src/main/java/org/apache/wicket/AttributeModifier.java",0,0.309278350515464,7,4,11
"wicket-core/src/main/java/org/apache/wicket/BehaviorInstantiationListenerCollection.java",0,1,0,1,1
"wicket-core/src/main/java/org/apache/wicket/Behaviors.java",0,0.986970684039088,2,1,3
"wicket-core/src/main/java/org/apache/wicket/Component.java",0,0.235623181919893,11,6,17
"wicket-core/src/main/java/org/apache/wicket/ComponentEvent.java",0,0.858407079646018,0,2,2
"wicket-core/src/main/java/org/apache/wicket/ComponentEventSender.java",0,0.981308411214953,3,1,4
"wicket-core/src/main/java/org/apache/wicket/ComponentSourceEntry.java",0,0.919504643962848,1,2,3
"wicket-core/src/main/java/org/apache/wicket/ConverterLocator.java",0,0.238461538461538,4,7,11
"wicket-core/src/main/java/org/apache/wicket/DefaultExceptionMapper.java",0,0.658031088082902,1,3,4
"wicket-core/src/main/java/org/apache/wicket/DefaultMapperContext.java",0,0.940298507462687,0,2,2
"wicket-core/src/main/java/org/apache/wicket/DefaultPageManagerProvider.java",0,0.977777777777778,1,1,2
"wicket-core/src/main/java/org/apache/wicket/IApplicationListener.java",0,1,0,1,1
"wicket-core/src/main/java/org/apache/wicket/IBehaviorInstantiationListener.java",0,1,0,1,1
"wicket-core/src/main/java/org/apache/wicket/IComponentAwareEventSink.java",0,1,0,1,1
"wicket-core/src/main/java/org/apache/wicket/IComponentSource.java",0,0.886363636363636,0,2,2
"wicket-core/src/main/java/org/apache/wicket/IConverterLocator.java",0,0.295454545454545,3,5,8
"wicket-core/src/main/java/org/apache/wicket/IDetachListener.java",0,1,0,1,1
"wicket-core/src/main/java/org/apache/wicket/IEventDispatcher.java",0,1,0,1,1
"wicket-core/src/main/java/org/apache/wicket/IInitializer.java",0,0.285714285714286,2,5,7
"wicket-core/src/main/java/org/apache/wicket/IPageFactory.java",0,0.308641975308642,3,6,9
"wicket-core/src/main/java/org/apache/wicket/IPageManagerProvider.java",0,1,0,1,1
"wicket-core/src/main/java/org/apache/wicket/IPageRendererProvider.java",0,0.8,0,3,3
"wicket-core/src/main/java/org/apache/wicket/IRedirectListener.java",0,0.382352941176471,1,4,5
"wicket-core/src/main/java/org/apache/wicket/IRequestCycleProvider.java",0,0.933333333333333,0,2,2
"wicket-core/src/main/java/org/apache/wicket/IRequestListener.java",0,0.382352941176471,0,5,5
"wicket-core/src/main/java/org/apache/wicket/IResourceFactory.java",0,0.446808510638298,2,5,7
"wicket-core/src/main/java/org/apache/wicket/IResourceListener.java",0,0.295454545454545,1,5,6
"wicket-core/src/main/java/org/apache/wicket/ISessionListener.java",0,1,0,1,1
"wicket-core/src/main/java/org/apache/wicket/Initializer.java",0,0.403225806451613,3,5,8
"wicket-core/src/main/java/org/apache/wicket/Localizer.java",0,0.610561056105611,5,4,9
"wicket-core/src/main/java/org/apache/wicket/MarkupContainer.java",0,0.254789272030651,6,6,12
"wicket-core/src/main/java/org/apache/wicket/MetaDataEntry.java",0,0.526315789473684,3,4,7
"wicket-core/src/main/java/org/apache/wicket/MetaDataKey.java",0,0.35,4,6,10
"wicket-core/src/main/java/org/apache/wicket/Page.java",0,0.169040835707502,5,7,12
"wicket-core/src/main/java/org/apache/wicket/PageReference.java",0,0.840425531914894,0,3,3
"wicket-core/src/main/java/org/apache/wicket/RequestListenerInterface.java",0,0.377142857142857,6,4,10
"wicket-core/src/main/java/org/apache/wicket/RestartResponseAtInterceptPageException.java",0,0.53921568627451,1,4,5
"wicket-core/src/main/java/org/apache/wicket/RestartResponseException.java",0,0.51063829787234,3,3,6
"wicket-core/src/main/java/org/apache/wicket/RuntimeConfigurationType.java",0,1,0,1,1
"wicket-core/src/main/java/org/apache/wicket/Session.java",0,0.298642533936652,6,6,12
"wicket-core/src/main/java/org/apache/wicket/SessionListenerCollection.java",0,1,0,1,1
"wicket-core/src/main/java/org/apache/wicket/SharedResources.java",0,0.598765432098765,0,4,4
"wicket-core/src/main/java/org/apache/wicket/SystemMapper.java",0,0.485436893203884,0,4,4
"wicket-core/src/main/java/org/apache/wicket/ThreadContext.java",0,0.513157894736842,0,3,3
"wicket-core/src/main/java/org/apache/wicket/WicketRuntimeException.java",0,0.508474576271186,1,4,5
"wicket-core/src/main/java/org/apache/wicket/ajax/AbstractAjaxTimerBehavior.java",0,0.295454545454545,3,6,9
"wicket-core/src/main/java/org/apache/wicket/ajax/AbstractDefaultAjaxBehavior.java",0,0.422651933701657,7,5,12
"wicket-core/src/main/java/org/apache/wicket/ajax/AjaxChannel.java",0,1,0,1,1
"wicket-core/src/main/java/org/apache/wicket/ajax/AjaxEventBehavior.java",0,0.563063063063063,7,3,10
"wicket-core/src/main/java/org/apache/wicket/ajax/AjaxRequestTarget.java",0,0.294491525423729,9,6,15
"wicket-core/src/main/java/org/apache/wicket/ajax/AjaxRequestTargetListenerCollection.java",0,1,0,1,1
"wicket-core/src/main/java/org/apache/wicket/ajax/AjaxSelfUpdatingTimerBehavior.java",0,0.40625,2,4,6
"wicket-core/src/main/java/org/apache/wicket/ajax/IAjaxCallDecorator.java",0,0.594059405940594,3,5,8
"wicket-core/src/main/java/org/apache/wicket/ajax/IAjaxIndicatorAware.java",0,0.414634146341463,1,3,4
"wicket-core/src/main/java/org/apache/wicket/ajax/IAjaxRegionMarkupIdProvider.java",0,0.96039603960396,1,1,2
"wicket-core/src/main/java/org/apache/wicket/ajax/WicketAjaxReference.java",0,0.925,1,2,3
"wicket-core/src/main/java/org/apache/wicket/ajax/calldecorator/AjaxCallDecorator.java",0,0.517857142857143,0,4,4
"wicket-core/src/main/java/org/apache/wicket/ajax/calldecorator/AjaxCallThrottlingDecorator.java",0,0.632183908045977,2,4,6
"wicket-core/src/main/java/org/apache/wicket/ajax/calldecorator/AjaxPostprocessingCallDecorator.java",0,0.594594594594595,2,4,6
"wicket-core/src/main/java/org/apache/wicket/ajax/calldecorator/AjaxPreprocessingCallDecorator.java",0,0.699029126213592,2,3,5
"wicket-core/src/main/java/org/apache/wicket/ajax/calldecorator/CancelEventIfNoAjaxDecorator.java",0,0.5625,4,3,7
"wicket-core/src/main/java/org/apache/wicket/ajax/form/AjaxFormChoiceComponentUpdatingBehavior.java",0,0.73469387755102,3,3,6
"wicket-core/src/main/java/org/apache/wicket/ajax/form/AjaxFormComponentUpdatingBehavior.java",0,0.454976303317536,1,6,7
"wicket-core/src/main/java/org/apache/wicket/ajax/form/AjaxFormSubmitBehavior.java",0,0.709821428571429,2,4,6
"wicket-core/src/main/java/org/apache/wicket/ajax/form/AjaxFormValidatingBehavior.java",0,0.696,1,4,5
"wicket-core/src/main/java/org/apache/wicket/ajax/form/OnChangeAjaxBehavior.java",0,0.737704918032787,2,3,5
"wicket-core/src/main/java/org/apache/wicket/ajax/markup/html/AjaxFallbackLink.java",0,0.300613496932515,3,5,8
"wicket-core/src/main/java/org/apache/wicket/ajax/markup/html/AjaxLink.java",0,0.485148514851485,2,6,8
"wicket-core/src/main/java/org/apache/wicket/ajax/markup/html/IAjaxLink.java",0,0.394736842105263,1,4,5
"wicket-core/src/main/java/org/apache/wicket/ajax/markup/html/form/AjaxButton.java",0,0.467592592592593,2,4,6
"wicket-core/src/main/java/org/apache/wicket/ajax/markup/html/form/AjaxCheckBox.java",0,0.466666666666667,1,4,5
"wicket-core/src/main/java/org/apache/wicket/ajax/markup/html/form/AjaxFallbackButton.java",0,0.636871508379888,3,4,7
"wicket-core/src/main/java/org/apache/wicket/ajax/markup/html/form/AjaxSubmitLink.java",0,0.566666666666667,2,5,7
"wicket-core/src/main/java/org/apache/wicket/ajax/markup/html/navigation/paging/AjaxPagingNavigation.java",0,0.458823529411765,2,4,6
"wicket-core/src/main/java/org/apache/wicket/ajax/markup/html/navigation/paging/AjaxPagingNavigationBehavior.java",0,0.376146788990826,1,6,7
"wicket-core/src/main/java/org/apache/wicket/ajax/markup/html/navigation/paging/AjaxPagingNavigationIncrementLink.java",0,0.453846153846154,2,5,7
"wicket-core/src/main/java/org/apache/wicket/ajax/markup/html/navigation/paging/AjaxPagingNavigationLink.java",0,0.442105263157895,3,5,8
"wicket-core/src/main/java/org/apache/wicket/ajax/markup/html/navigation/paging/AjaxPagingNavigator.java",0,0.58125,1,6,7
"wicket-core/src/main/java/org/apache/wicket/application/AbstractClassResolver.java",0,1,0,1,1
"wicket-core/src/main/java/org/apache/wicket/application/ComponentInitializationListenerCollection.java",0,0.880952380952381,0,2,2
"wicket-core/src/main/java/org/apache/wicket/application/ComponentInstantiationListenerCollection.java",0,0.875,0,2,2
"wicket-core/src/main/java/org/apache/wicket/application/ComponentOnAfterRenderListenerCollection.java",0,0.875,0,2,2
"wicket-core/src/main/java/org/apache/wicket/application/ComponentOnBeforeRenderListenerCollection.java",0,0.883720930232558,0,2,2
"wicket-core/src/main/java/org/apache/wicket/application/CompoundClassResolver.java",0,1,0,1,1
"wicket-core/src/main/java/org/apache/wicket/application/DefaultClassResolver.java",0,0.282608695652174,0,5,5
"wicket-core/src/main/java/org/apache/wicket/application/HeaderContributorListenerCollection.java",0,1,0,1,1
"wicket-core/src/main/java/org/apache/wicket/application/IClassResolver.java",0,0.24,1,6,7
"wicket-core/src/main/java/org/apache/wicket/application/IComponentInitializationListener.java",0,1,0,1,1
"wicket-core/src/main/java/org/apache/wicket/application/IComponentInstantiationListener.java",0,0.463414634146341,2,4,6
"wicket-core/src/main/java/org/apache/wicket/application/IComponentOnAfterRenderListener.java",0,0.857142857142857,2,2,4
"wicket-core/src/main/java/org/apache/wicket/application/IComponentOnBeforeRenderListener.java",0,0.833333333333333,1,3,4
"wicket-core/src/main/java/org/apache/wicket/application/ReloadingClassLoader.java",0,0.649732620320856,5,2,7
"wicket-core/src/main/java/org/apache/wicket/application/WildcardMatcherHelper.java",0,0.767337807606264,2,3,5
"wicket-core/src/main/java/org/apache/wicket/authentication/IAuthenticationStrategy.java",0,0.981481481481482,1,1,2
"wicket-core/src/main/java/org/apache/wicket/authentication/strategy/DefaultAuthenticationStrategy.java",0,0.888888888888889,0,2,2
"wicket-core/src/main/java/org/apache/wicket/authentication/strategy/NoOpAuthenticationStrategy.java",0,1,0,1,1
"wicket-core/src/main/java/org/apache/wicket/authorization/Action.java",0,0.59047619047619,3,3,6
"wicket-core/src/main/java/org/apache/wicket/authorization/AuthorizationException.java",0,0.746268656716418,2,2,4
"wicket-core/src/main/java/org/apache/wicket/authorization/IAuthorizationStrategy.java",0,0.463157894736842,0,6,6
"wicket-core/src/main/java/org/apache/wicket/authorization/IUnauthorizedComponentInstantiationListener.java",0,0.432432432432432,1,4,5
"wicket-core/src/main/java/org/apache/wicket/authorization/UnauthorizedActionException.java",0,0.26865671641791,3,4,7
"wicket-core/src/main/java/org/apache/wicket/authorization/UnauthorizedInstantiationException.java",0,0.379310344827586,4,5,9
"wicket-core/src/main/java/org/apache/wicket/authorization/strategies/CompoundAuthorizationStrategy.java",0,0.482352941176471,4,5,9
"wicket-core/src/main/java/org/apache/wicket/authorization/strategies/action/ActionAuthorizationStrategy.java",0,0.547945205479452,2,5,7
"wicket-core/src/main/java/org/apache/wicket/authorization/strategies/action/IActionAuthorizer.java",0,0.478260869565217,1,4,5
"wicket-core/src/main/java/org/apache/wicket/authorization/strategies/page/AbstractPageAuthorizationStrategy.java",0,0.482758620689655,3,5,8
"wicket-core/src/main/java/org/apache/wicket/authorization/strategies/page/SimplePageAuthorizationStrategy.java",0,0.348837209302326,3,6,9
"wicket-core/src/main/java/org/apache/wicket/behavior/AbstractAjaxBehavior.java",0,0.326923076923077,4,6,10
"wicket-core/src/main/java/org/apache/wicket/behavior/AbstractBehavior.java",0,0.427272727272727,1,5,6
"wicket-core/src/main/java/org/apache/wicket/behavior/AttributeAppender.java",0,0.670520231213873,4,3,7
"wicket-core/src/main/java/org/apache/wicket/behavior/Behavior.java",0,0.477611940298507,6,3,9
"wicket-core/src/main/java/org/apache/wicket/behavior/IBehaviorListener.java",0,0.325,2,5,7
"wicket-core/src/main/java/org/apache/wicket/behavior/InvalidBehaviorIdException.java",0,1,0,1,1
"wicket-core/src/main/java/org/apache/wicket/behavior/SimpleAttributeModifier.java",0,0.325581395348837,6,4,10
"wicket-core/src/main/java/org/apache/wicket/css/ICssCompressor.java",0,1,0,1,1
"wicket-core/src/main/java/org/apache/wicket/event/Broadcast.java",0,0.982456140350877,1,1,2
"wicket-core/src/main/java/org/apache/wicket/event/IEvent.java",0,1,0,1,1
"wicket-core/src/main/java/org/apache/wicket/event/IEventSink.java",0,1,0,1,1
"wicket-core/src/main/java/org/apache/wicket/event/IEventSource.java",0,0.975609756097561,1,1,2
"wicket-core/src/main/java/org/apache/wicket/feedback/ComponentFeedbackMessageFilter.java",0,0.519230769230769,1,5,6
"wicket-core/src/main/java/org/apache/wicket/feedback/ContainerFeedbackMessageFilter.java",0,0.433333333333333,0,6,6
"wicket-core/src/main/java/org/apache/wicket/feedback/ErrorLevelFeedbackMessageFilter.java",0,0.490909090909091,0,5,5
"wicket-core/src/main/java/org/apache/wicket/feedback/FeedbackMessage.java",0,0.284132841328413,4,4,8
"wicket-core/src/main/java/org/apache/wicket/feedback/FeedbackMessages.java",0,0.380577427821522,6,3,9
"wicket-core/src/main/java/org/apache/wicket/feedback/FeedbackMessagesModel.java",0,0.589887640449438,4,5,9
"wicket-core/src/main/java/org/apache/wicket/feedback/IFeedback.java",0,0.419354838709677,1,3,4
"wicket-core/src/main/java/org/apache/wicket/feedback/IFeedbackMessageFilter.java",0,0.340425531914894,0,4,4
"wicket-core/src/main/java/org/apache/wicket/javascript/DefaultJavaScriptCompressor.java",0,1,0,1,1
"wicket-core/src/main/java/org/apache/wicket/javascript/IJavaScriptCompressor.java",0,0.892857142857143,0,2,2
"wicket-core/src/main/java/org/apache/wicket/markup/AbstractMarkupParser.java",0,0.960526315789474,2,1,3
"wicket-core/src/main/java/org/apache/wicket/markup/ComponentTag.java",0,0.454162276080084,7,4,11
"wicket-core/src/main/java/org/apache/wicket/markup/ContainerInfo.java",0,0.716535433070866,3,3,6
"wicket-core/src/main/java/org/apache/wicket/markup/DefaultMarkupCacheKeyProvider.java",0,0.625,2,3,5
"wicket-core/src/main/java/org/apache/wicket/markup/DefaultMarkupResourceStreamProvider.java",0,0.718446601941748,3,4,7
"wicket-core/src/main/java/org/apache/wicket/markup/HtmlSpecialTag.java",0,1,0,1,1
"wicket-core/src/main/java/org/apache/wicket/markup/IMarkup.java",0,0.737373737373737,2,3,5
"wicket-core/src/main/java/org/apache/wicket/markup/IMarkupCache.java",0,0.851351351351351,1,2,3
"wicket-core/src/main/java/org/apache/wicket/markup/IMarkupCacheKeyProvider.java",0,0.75,2,2,4
"wicket-core/src/main/java/org/apache/wicket/markup/IMarkupFragment.java",0,1,0,1,1
"wicket-core/src/main/java/org/apache/wicket/markup/IMarkupResourceStreamProvider.java",0,0.703703703703704,0,4,4
"wicket-core/src/main/java/org/apache/wicket/markup/Markup.java",0,0.741818181818182,6,3,9
"wicket-core/src/main/java/org/apache/wicket/markup/MarkupCache.java",0,0.772853185595568,5,3,8
"wicket-core/src/main/java/org/apache/wicket/markup/MarkupElement.java",0,0.41025641025641,0,5,5
"wicket-core/src/main/java/org/apache/wicket/markup/MarkupException.java",0,0.404411764705882,2,4,6
"wicket-core/src/main/java/org/apache/wicket/markup/MarkupFactory.java",0,0.955789473684211,2,1,3
"wicket-core/src/main/java/org/apache/wicket/markup/MarkupFragment.java",0,0.932489451476793,0,2,2
"wicket-core/src/main/java/org/apache/wicket/markup/MarkupIterator.java",0,1,0,1,1
"wicket-core/src/main/java/org/apache/wicket/markup/MarkupNotFoundException.java",0,0.705882352941177,1,2,3
"wicket-core/src/main/java/org/apache/wicket/markup/MarkupParser.java",0,0.759656652360515,6,3,9
"wicket-core/src/main/java/org/apache/wicket/markup/MarkupResourceStream.java",0,0.802083333333333,7,1,8
"wicket-core/src/main/java/org/apache/wicket/markup/MarkupStream.java",0,0.511504424778761,6,3,9
"wicket-core/src/main/java/org/apache/wicket/markup/MarkupType.java",0,0.9875,1,1,2
"wicket-core/src/main/java/org/apache/wicket/markup/MergedMarkup.java",0,0.858139534883721,5,1,6
"wicket-core/src/main/java/org/apache/wicket/markup/RawMarkup.java",0,0.663793103448276,2,4,6
"wicket-core/src/main/java/org/apache/wicket/markup/TagUtils.java",0,0.917127071823204,2,2,4
"wicket-core/src/main/java/org/apache/wicket/markup/WicketParseException.java",0,1,0,1,1
"wicket-core/src/main/java/org/apache/wicket/markup/WicketTag.java",0,0.517241379310345,3,6,9
"wicket-core/src/main/java/org/apache/wicket/markup/html/DecoratingHeaderResponse.java",0,0.653266331658292,0,3,3
"wicket-core/src/main/java/org/apache/wicket/markup/html/GenericWebPage.java",0,1,0,1,1
"wicket-core/src/main/java/org/apache/wicket/markup/html/HeaderPartContainer.java",0,0.551020408163265,2,3,5
"wicket-core/src/main/java/org/apache/wicket/markup/html/IComponentAwareHeaderContributor.java",0,1,0,1,1
"wicket-core/src/main/java/org/apache/wicket/markup/html/IHeaderContributor.java",0,0.240740740740741,1,6,7
"wicket-core/src/main/java/org/apache/wicket/markup/html/IHeaderResponse.java",0,0.417867435158501,6,4,10
"wicket-core/src/main/java/org/apache/wicket/markup/html/IHeaderResponseDecorator.java",0,1,0,1,1
"wicket-core/src/main/java/org/apache/wicket/markup/html/IPackageResourceGuard.java",0,0.476190476190476,1,4,5
"wicket-core/src/main/java/org/apache/wicket/markup/html/MarkupUtil.java",0,0.863013698630137,0,2,2
"wicket-core/src/main/java/org/apache/wicket/markup/html/PackageResourceGuard.java",0,0.374468085106383,2,4,6
"wicket-core/src/main/java/org/apache/wicket/markup/html/SecurePackageResourceGuard.java",0,0.990632318501171,2,1,3
"wicket-core/src/main/java/org/apache/wicket/markup/html/TransparentWebMarkupContainer.java",0,0.82258064516129,0,2,2
"wicket-core/src/main/java/org/apache/wicket/markup/html/WebComponent.java",0,0.275862068965517,2,5,7
"wicket-core/src/main/java/org/apache/wicket/markup/html/WebMarkupContainer.java",0,0.257142857142857,0,7,7
"wicket-core/src/main/java/org/apache/wicket/markup/html/WebPage.java",0,0.535603715170279,6,5,11
"wicket-core/src/main/java/org/apache/wicket/markup/html/WicketEventReference.java",0,0.880952380952381,4,1,5
"wicket-core/src/main/java/org/apache/wicket/markup/html/basic/EnclosureContainer.java",0,0.8875,0,2,2
"wicket-core/src/main/java/org/apache/wicket/markup/html/basic/EnumLabel.java",0,0.957317073170732,1,1,2
"wicket-core/src/main/java/org/apache/wicket/markup/html/basic/Label.java",0,0.353846153846154,1,6,7
"wicket-core/src/main/java/org/apache/wicket/markup/html/basic/MultiLineLabel.java",0,0.233333333333333,3,7,10
"wicket-core/src/main/java/org/apache/wicket/markup/html/border/Body.java",0,1,0,1,1
"wicket-core/src/main/java/org/apache/wicket/markup/html/border/Border.java",0,0.63495145631068,8,2,10
"wicket-core/src/main/java/org/apache/wicket/markup/html/border/BorderBehavior.java",0,0.996240601503759,1,1,2
"wicket-core/src/main/java/org/apache/wicket/markup/html/border/BorderPanel.java",0,0.954198473282443,1,1,2
"wicket-core/src/main/java/org/apache/wicket/markup/html/border/BoxBorder.java",0,0.371428571428571,1,5,6
"wicket-core/src/main/java/org/apache/wicket/markup/html/border/MarkupComponentBorder.java",0,0.888888888888889,0,2,2
"wicket-core/src/main/java/org/apache/wicket/markup/html/debug/PageView.java",0,0.269911504424779,1,7,8
"wicket-core/src/main/java/org/apache/wicket/markup/html/form/AbstractCheckSelector.java",0,1,0,1,1
"wicket-core/src/main/java/org/apache/wicket/markup/html/form/AbstractChoice.java",0,0.296629213483146,8,5,13
"wicket-core/src/main/java/org/apache/wicket/markup/html/form/AbstractSingleSelectChoice.java",0,0.352941176470588,2,6,8
"wicket-core/src/main/java/org/apache/wicket/markup/html/form/AbstractSubmitLink.java",0,0.793103448275862,3,3,6
"wicket-core/src/main/java/org/apache/wicket/markup/html/form/AbstractTextComponent.java",0,0.259067357512953,2,8,10
"wicket-core/src/main/java/org/apache/wicket/markup/html/form/AutoLabelResolver.java",0,0.822966507177033,1,2,3
"wicket-core/src/main/java/org/apache/wicket/markup/html/form/AutoLabelTagHandler.java",0,0.722222222222222,0,2,2
"wicket-core/src/main/java/org/apache/wicket/markup/html/form/AutoLabelTextResolver.java",0,1,0,1,1
"wicket-core/src/main/java/org/apache/wicket/markup/html/form/Button.java",0,0.391705069124424,4,6,10
"wicket-core/src/main/java/org/apache/wicket/markup/html/form/Check.java",0,0.760942760942761,9,2,11
"wicket-core/src/main/java/org/apache/wicket/markup/html/form/CheckBox.java",0,0.293877551020408,3,6,9
"wicket-core/src/main/java/org/apache/wicket/markup/html/form/CheckBoxMultipleChoice.java",0,0.483370288248337,6,3,9
"wicket-core/src/main/java/org/apache/wicket/markup/html/form/CheckBoxSelector.java",0,1,0,1,1
"wicket-core/src/main/java/org/apache/wicket/markup/html/form/CheckGroup.java",0,0.490825688073394,8,4,12
"wicket-core/src/main/java/org/apache/wicket/markup/html/form/CheckGroupSelector.java",0,0.474074074074074,4,3,7
"wicket-core/src/main/java/org/apache/wicket/markup/html/form/CheckboxMultipleChoiceSelector.java",0,1,0,1,1
"wicket-core/src/main/java/org/apache/wicket/markup/html/form/ChoiceRenderer.java",0,0.431372549019608,1,6,7
"wicket-core/src/main/java/org/apache/wicket/markup/html/form/DropDownChoice.java",0,0.246621621621622,4,6,10
"wicket-core/src/main/java/org/apache/wicket/markup/html/form/EmailTextField.java",0,0.887755102040816,0,2,2
"wicket-core/src/main/java/org/apache/wicket/markup/html/form/EnumChoiceRenderer.java",0,1,0,1,1
"wicket-core/src/main/java/org/apache/wicket/markup/html/form/Form.java",0,0.372413793103448,8,6,14
"wicket-core/src/main/java/org/apache/wicket/markup/html/form/FormComponent.java",0,0.321935483870968,12,4,16
"wicket-core/src/main/java/org/apache/wicket/markup/html/form/FormComponentLabel.java",0,0.519480519480519,3,5,8
"wicket-core/src/main/java/org/apache/wicket/markup/html/form/FormComponentPanel.java",0,0.644067796610169,2,4,6
"wicket-core/src/main/java/org/apache/wicket/markup/html/form/HiddenField.java",0,0.66,1,4,5
"wicket-core/src/main/java/org/apache/wicket/markup/html/form/IChoiceRenderer.java",0,0.358490566037736,0,5,5
"wicket-core/src/main/java/org/apache/wicket/markup/html/form/IFormModelUpdateListener.java",0,1,0,1,1
"wicket-core/src/main/java/org/apache/wicket/markup/html/form/IFormSubmitListener.java",0,0.351351351351351,1,5,6
"wicket-core/src/main/java/org/apache/wicket/markup/html/form/IFormSubmitter.java",0,1,0,1,1
"wicket-core/src/main/java/org/apache/wicket/markup/html/form/IFormSubmittingComponent.java",0,0.6,4,2,6
"wicket-core/src/main/java/org/apache/wicket/markup/html/form/IFormVisitorParticipant.java",0,0.714285714285714,2,3,5
"wicket-core/src/main/java/org/apache/wicket/markup/html/form/ILabelProvider.java",0,0.837837837837838,0,2,2
"wicket-core/src/main/java/org/apache/wicket/markup/html/form/IOnChangeListener.java",0,0.325,1,5,6
"wicket-core/src/main/java/org/apache/wicket/markup/html/form/ImageButton.java",0,0.5,4,5,9
"wicket-core/src/main/java/org/apache/wicket/markup/html/form/LabeledWebMarkupContainer.java",0,0.638297872340426,2,3,5
"wicket-core/src/main/java/org/apache/wicket/markup/html/form/ListChoice.java",0,0.29296875,1,5,6
"wicket-core/src/main/java/org/apache/wicket/markup/html/form/ListMultipleChoice.java",0,0.321782178217822,6,6,12
"wicket-core/src/main/java/org/apache/wicket/markup/html/form/NumberTextField.java",0,1,0,1,1
"wicket-core/src/main/java/org/apache/wicket/markup/html/form/PasswordTextField.java",0,0.276422764227642,1,6,7
"wicket-core/src/main/java/org/apache/wicket/markup/html/form/Radio.java",0,0.759717314487632,8,2,10
"wicket-core/src/main/java/org/apache/wicket/markup/html/form/RadioChoice.java",0,0.225352112676056,3,7,10
"wicket-core/src/main/java/org/apache/wicket/markup/html/form/RadioGroup.java",0,0.491228070175439,5,5,10
"wicket-core/src/main/java/org/apache/wicket/markup/html/form/RangeTextField.java",0,1,0,1,1
"wicket-core/src/main/java/org/apache/wicket/markup/html/form/RequiredTextField.java",0,0.552631578947368,0,5,5
"wicket-core/src/main/java/org/apache/wicket/markup/html/form/SimpleFormComponentLabel.java",0,0.557377049180328,3,4,7
"wicket-core/src/main/java/org/apache/wicket/markup/html/form/StatelessForm.java",0,0.449275362318841,1,4,5
"wicket-core/src/main/java/org/apache/wicket/markup/html/form/SubmitLink.java",0,0.253112033195021,3,7,10
"wicket-core/src/main/java/org/apache/wicket/markup/html/form/TextArea.java",0,0.247058823529412,3,5,8
"wicket-core/src/main/java/org/apache/wicket/markup/html/form/TextField.java",0,0.330645161290323,2,5,7
"wicket-core/src/main/java/org/apache/wicket/markup/html/form/UrlTextField.java",0,1,0,1,1
"wicket-core/src/main/java/org/apache/wicket/markup/html/form/ValidationErrorFeedback.java",0,0.95,2,1,3
"wicket-core/src/main/java/org/apache/wicket/markup/html/form/upload/FileUpload.java",0,0.249027237354086,2,7,9
"wicket-core/src/main/java/org/apache/wicket/markup/html/form/upload/FileUploadField.java",0,0.260683760683761,4,7,11
"wicket-core/src/main/java/org/apache/wicket/markup/html/form/upload/MultiFileUploadField.java",0,0.632596685082873,5,4,9
"wicket-core/src/main/java/org/apache/wicket/markup/html/form/validation/AbstractFormValidator.java",0,0.455555555555556,1,5,6
"wicket-core/src/main/java/org/apache/wicket/markup/html/form/validation/EqualInputValidator.java",0,0.533333333333333,0,5,5
"wicket-core/src/main/java/org/apache/wicket/markup/html/form/validation/EqualPasswordInputValidator.java",0,0.461538461538462,0,5,5
"wicket-core/src/main/java/org/apache/wicket/markup/html/form/validation/FormComponentFeedbackBorder.java",0,0.317307692307692,1,6,7
"wicket-core/src/main/java/org/apache/wicket/markup/html/form/validation/FormComponentFeedbackIndicator.java",0,0.55,1,5,6
"wicket-core/src/main/java/org/apache/wicket/markup/html/form/validation/FormValidatorAdapter.java",0,0.952380952380952,1,1,2
"wicket-core/src/main/java/org/apache/wicket/markup/html/form/validation/IFormValidator.java",0,0.48,1,4,5
"wicket-core/src/main/java/org/apache/wicket/markup/html/image/ContextImage.java",0,0.708333333333333,1,2,3
"wicket-core/src/main/java/org/apache/wicket/markup/html/image/ContextPathGenerator.java",0,0.975903614457831,1,1,2
"wicket-core/src/main/java/org/apache/wicket/markup/html/image/Image.java",0,0.315112540192926,5,6,11
"wicket-core/src/main/java/org/apache/wicket/markup/html/image/NonCachingImage.java",0,0.701492537313433,6,2,8
"wicket-core/src/main/java/org/apache/wicket/markup/html/image/resource/BlobImageResource.java",0,0.423913043478261,2,4,6
"wicket-core/src/main/java/org/apache/wicket/markup/html/image/resource/BufferedDynamicImageResource.java",0,0.573333333333333,4,3,7
"wicket-core/src/main/java/org/apache/wicket/markup/html/image/resource/DefaultButtonImageResource.java",0,0.62589928057554,5,2,7
"wicket-core/src/main/java/org/apache/wicket/markup/html/image/resource/DefaultButtonImageResourceFactory.java",0,0.681034482758621,5,4,9
"wicket-core/src/main/java/org/apache/wicket/markup/html/image/resource/LocalizedImageResource.java",0,0.381443298969072,3,6,9
"wicket-core/src/main/java/org/apache/wicket/markup/html/image/resource/RenderedDynamicImageResource.java",0,0.582978723404255,4,4,8
"wicket-core/src/main/java/org/apache/wicket/markup/html/include/Include.java",0,0.508620689655172,3,5,8
"wicket-core/src/main/java/org/apache/wicket/markup/html/internal/Enclosure.java",0,0.465116279069767,3,4,7
"wicket-core/src/main/java/org/apache/wicket/markup/html/internal/HeaderResponse.java",0,0.268472906403941,4,6,10
"wicket-core/src/main/java/org/apache/wicket/markup/html/internal/HtmlHeaderContainer.java",0,0.664705882352941,9,3,12
"wicket-core/src/main/java/org/apache/wicket/markup/html/internal/InlineEnclosure.java",0,0.704347826086957,0,2,2
"wicket-core/src/main/java/org/apache/wicket/markup/html/internal/ResponseBufferZone.java",0,1,0,1,1
"wicket-core/src/main/java/org/apache/wicket/markup/html/link/AbstractLink.java",0,0.576,3,4,7
"wicket-core/src/main/java/org/apache/wicket/markup/html/link/BookmarkablePageLink.java",0,0.4739336492891,4,7,11
"wicket-core/src/main/java/org/apache/wicket/markup/html/link/ClientSideImageMap.java",0,0.787313432835821,1,2,3
"wicket-core/src/main/java/org/apache/wicket/markup/html/link/DownloadLink.java",0,0.27027027027027,2,5,7
"wicket-core/src/main/java/org/apache/wicket/markup/html/link/ExternalLink.java",0,0.298755186721992,2,7,9
"wicket-core/src/main/java/org/apache/wicket/markup/html/link/ILinkListener.java",0,0.351351351351351,1,5,6
"wicket-core/src/main/java/org/apache/wicket/markup/html/link/IPageLink.java",0,0.356164383561644,2,5,7
"wicket-core/src/main/java/org/apache/wicket/markup/html/link/InlineFrame.java",0,0.514285714285714,5,4,9
"wicket-core/src/main/java/org/apache/wicket/markup/html/link/Link.java",0,0.271739130434783,4,6,10
"wicket-core/src/main/java/org/apache/wicket/markup/html/link/PopupCloseLink.java",0,0.492957746478873,3,5,8
"wicket-core/src/main/java/org/apache/wicket/markup/html/link/PopupSettings.java",0,0.54639175257732,3,4,7
"wicket-core/src/main/java/org/apache/wicket/markup/html/link/ResourceLink.java",0,0.413793103448276,4,5,9
"wicket-core/src/main/java/org/apache/wicket/markup/html/link/StatelessLink.java",0,0.470588235294118,2,4,6
"wicket-core/src/main/java/org/apache/wicket/markup/html/list/AbstractItem.java",0,1,0,1,1
"wicket-core/src/main/java/org/apache/wicket/markup/html/list/ListItem.java",0,0.365217391304348,2,6,8
"wicket-core/src/main/java/org/apache/wicket/markup/html/list/ListItemModel.java",0,0.276315789473684,3,5,8
"wicket-core/src/main/java/org/apache/wicket/markup/html/list/ListView.java",0,0.32078313253012,7,6,13
"wicket-core/src/main/java/org/apache/wicket/markup/html/list/Loop.java",0,0.325842696629214,1,6,7
"wicket-core/src/main/java/org/apache/wicket/markup/html/list/LoopItem.java",0,0.991452991452991,1,1,2
"wicket-core/src/main/java/org/apache/wicket/markup/html/list/OddEvenListItem.java",0,1,0,1,1
"wicket-core/src/main/java/org/apache/wicket/markup/html/list/PageableListView.java",0,0.36697247706422,2,6,8
"wicket-core/src/main/java/org/apache/wicket/markup/html/list/PropertyListView.java",0,0.56043956043956,3,3,6
"wicket-core/src/main/java/org/apache/wicket/markup/html/navigation/paging/IPageable.java",0,0.372549019607843,2,5,7
"wicket-core/src/main/java/org/apache/wicket/markup/html/navigation/paging/IPageableItems.java",0,1,0,1,1
"wicket-core/src/main/java/org/apache/wicket/markup/html/navigation/paging/IPagingLabelProvider.java",0,0.371428571428571,0,5,5
"wicket-core/src/main/java/org/apache/wicket/markup/html/navigation/paging/PagingNavigation.java",0,0.259860788863109,3,6,9
"wicket-core/src/main/java/org/apache/wicket/markup/html/navigation/paging/PagingNavigationIncrementLink.java",0,0.25,3,5,8
"wicket-core/src/main/java/org/apache/wicket/markup/html/navigation/paging/PagingNavigationLink.java",0,0.308823529411765,2,6,8
"wicket-core/src/main/java/org/apache/wicket/markup/html/navigation/paging/PagingNavigator.java",0,0.385,2,6,8
"wicket-core/src/main/java/org/apache/wicket/markup/html/pages/AbstractErrorPage.java",0,1,0,1,1
"wicket-core/src/main/java/org/apache/wicket/markup/html/pages/AccessDeniedPage.java",0,0.521739130434783,4,3,7
"wicket-core/src/main/java/org/apache/wicket/markup/html/pages/BrowserInfoForm.java",0,0.895752895752896,5,2,7
"wicket-core/src/main/java/org/apache/wicket/markup/html/pages/BrowserInfoPage.java",0,0.436619718309859,4,4,8
"wicket-core/src/main/java/org/apache/wicket/markup/html/pages/ExceptionErrorPage.java",0,0.561068702290076,3,4,7
"wicket-core/src/main/java/org/apache/wicket/markup/html/pages/InternalErrorPage.java",0,0.41304347826087,5,3,8
"wicket-core/src/main/java/org/apache/wicket/markup/html/pages/PageExpiredErrorPage.java",0,0.434782608695652,4,4,8
"wicket-core/src/main/java/org/apache/wicket/markup/html/pages/RedirectPage.java",0,0.371134020618557,1,5,6
"wicket-core/src/main/java/org/apache/wicket/markup/html/panel/AbstractMarkupSourcingStrategy.java",0,0.710743801652893,0,2,2
"wicket-core/src/main/java/org/apache/wicket/markup/html/panel/AssociatedMarkupSourcingStrategy.java",0,0.589285714285714,4,2,6
"wicket-core/src/main/java/org/apache/wicket/markup/html/panel/BorderMarkupSourcingStrategy.java",0,1,0,1,1
"wicket-core/src/main/java/org/apache/wicket/markup/html/panel/ComponentFeedbackPanel.java",0,0.41304347826087,2,4,6
"wicket-core/src/main/java/org/apache/wicket/markup/html/panel/DefaultMarkupSourcingStrategy.java",0,0.941176470588235,1,2,3
"wicket-core/src/main/java/org/apache/wicket/markup/html/panel/EmptyPanel.java",0,0.897435897435897,0,3,3
"wicket-core/src/main/java/org/apache/wicket/markup/html/panel/FeedbackPanel.java",0,0.310897435897436,3,5,8
"wicket-core/src/main/java/org/apache/wicket/markup/html/panel/Fragment.java",0,0.368421052631579,1,5,6
"wicket-core/src/main/java/org/apache/wicket/markup/html/panel/FragmentMarkupSourcingStrategy.java",0,1,0,1,1
"wicket-core/src/main/java/org/apache/wicket/markup/html/panel/GenericPanel.java",0,1,0,1,1
"wicket-core/src/main/java/org/apache/wicket/markup/html/panel/IMarkupSourcingStrategy.java",0,0.955555555555556,1,1,2
"wicket-core/src/main/java/org/apache/wicket/markup/html/panel/Panel.java",0,0.433333333333333,3,5,8
"wicket-core/src/main/java/org/apache/wicket/markup/html/panel/PanelMarkupSourcingStrategy.java",0,0.912280701754386,0,2,2
"wicket-core/src/main/java/org/apache/wicket/markup/html/tree/AbstractTree.java",0,0.516351118760757,8,3,11
"wicket-core/src/main/java/org/apache/wicket/markup/html/tree/BaseTree.java",0,0.818947368421053,3,3,6
"wicket-core/src/main/java/org/apache/wicket/markup/html/tree/DefaultTreeState.java",0,0.48943661971831,4,4,8
"wicket-core/src/main/java/org/apache/wicket/markup/html/tree/ITreeState.java",0,0.614173228346457,4,3,7
"wicket-core/src/main/java/org/apache/wicket/markup/html/tree/ITreeStateListener.java",0,0.588235294117647,2,4,6
"wicket-core/src/main/java/org/apache/wicket/markup/html/tree/LabelIconPanel.java",0,0.914893617021277,3,1,4
"wicket-core/src/main/java/org/apache/wicket/markup/html/tree/LabelTree.java",0,0.669724770642202,3,2,5
"wicket-core/src/main/java/org/apache/wicket/markup/html/tree/LinkIconPanel.java",0,0.909090909090909,1,2,3
"wicket-core/src/main/java/org/apache/wicket/markup/html/tree/LinkTree.java",0,0.8,3,3,6
"wicket-core/src/main/java/org/apache/wicket/markup/html/tree/LinkType.java",0,1,0,1,1
"wicket-core/src/main/java/org/apache/wicket/markup/html/tree/WicketTreeModel.java",0,0.6,0,2,2
"wicket-core/src/main/java/org/apache/wicket/markup/loader/DefaultMarkupLoader.java",0,0.981481481481482,1,1,2
"wicket-core/src/main/java/org/apache/wicket/markup/loader/IMarkupLoader.java",0,0.969230769230769,1,1,2
"wicket-core/src/main/java/org/apache/wicket/markup/loader/InheritedMarkupMarkupLoader.java",0,0.891666666666667,3,2,5
"wicket-core/src/main/java/org/apache/wicket/markup/loader/SimpleMarkupLoader.java",0,0.980769230769231,1,1,2
"wicket-core/src/main/java/org/apache/wicket/markup/parser/AbstractMarkupFilter.java",0,0.706293706293706,2,3,5
"wicket-core/src/main/java/org/apache/wicket/markup/parser/IMarkupFilter.java",0,0.579710144927536,1,4,5
"wicket-core/src/main/java/org/apache/wicket/markup/parser/IXmlPullParser.java",0,0.56,1,5,6
"wicket-core/src/main/java/org/apache/wicket/markup/parser/TagAttributes.java",0,0.733333333333333,1,2,3
"wicket-core/src/main/java/org/apache/wicket/markup/parser/TagStack.java",0,1,0,1,1
"wicket-core/src/main/java/org/apache/wicket/markup/parser/XmlPullParser.java",0,0.770250368188513,8,2,10
"wicket-core/src/main/java/org/apache/wicket/markup/parser/XmlTag.java",0,0.740963855421687,6,3,9
"wicket-core/src/main/java/org/apache/wicket/markup/parser/filter/ConditionalCommentFilter.java",0,1,0,1,1
"wicket-core/src/main/java/org/apache/wicket/markup/parser/filter/EnclosureHandler.java",0,0.622754491017964,4,2,6
"wicket-core/src/main/java/org/apache/wicket/markup/parser/filter/HeadForceTagIdHandler.java",0,0.566929133858268,3,4,7
"wicket-core/src/main/java/org/apache/wicket/markup/parser/filter/HtmlHandler.java",0,0.523076923076923,4,3,7
"wicket-core/src/main/java/org/apache/wicket/markup/parser/filter/HtmlHeaderSectionHandler.java",0,0.807407407407407,3,2,5
"wicket-core/src/main/java/org/apache/wicket/markup/parser/filter/HtmlProblemFinder.java",0,0.448275862068966,4,4,8
"wicket-core/src/main/java/org/apache/wicket/markup/parser/filter/InlineEnclosureHandler.java",0,1,0,1,1
"wicket-core/src/main/java/org/apache/wicket/markup/parser/filter/OpenCloseTagExpander.java",0,0.622222222222222,2,2,4
"wicket-core/src/main/java/org/apache/wicket/markup/parser/filter/RelativePathPrefixHandler.java",0,0.546666666666667,2,3,5
"wicket-core/src/main/java/org/apache/wicket/markup/parser/filter/RootMarkupFilter.java",0,1,0,1,1
"wicket-core/src/main/java/org/apache/wicket/markup/parser/filter/StyleAndScriptIdentifier.java",0,0.954128440366973,1,1,2
"wicket-core/src/main/java/org/apache/wicket/markup/parser/filter/WicketLinkTagHandler.java",0,0.381818181818182,5,6,11
"wicket-core/src/main/java/org/apache/wicket/markup/parser/filter/WicketMessageTagHandler.java",0,0.641618497109827,5,5,10
"wicket-core/src/main/java/org/apache/wicket/markup/parser/filter/WicketNamespaceHandler.java",0,0.752136752136752,4,3,7
"wicket-core/src/main/java/org/apache/wicket/markup/parser/filter/WicketRemoveTagHandler.java",0,0.428571428571429,3,4,7
"wicket-core/src/main/java/org/apache/wicket/markup/parser/filter/WicketTagIdentifier.java",0,0.551948051948052,5,4,9
"wicket-core/src/main/java/org/apache/wicket/markup/renderStrategy/AbstractHeaderRenderStrategy.java",0,0.947019867549669,2,1,3
"wicket-core/src/main/java/org/apache/wicket/markup/renderStrategy/ChildFirstHeaderRenderStrategy.java",0,0.870967741935484,1,2,3
"wicket-core/src/main/java/org/apache/wicket/markup/renderStrategy/DeepChildFirstVisitor.java",0,0.517857142857143,1,2,3
"wicket-core/src/main/java/org/apache/wicket/markup/renderStrategy/IHeaderRenderStrategy.java",0,0.926829268292683,0,2,2
"wicket-core/src/main/java/org/apache/wicket/markup/renderStrategy/ParentFirstHeaderRenderStrategy.java",0,0.917808219178082,1,2,3
"wicket-core/src/main/java/org/apache/wicket/markup/repeater/AbstractPageableView.java",0,0.667519181585678,4,4,8
"wicket-core/src/main/java/org/apache/wicket/markup/repeater/AbstractRepeater.java",0,0.506410256410256,2,4,6
"wicket-core/src/main/java/org/apache/wicket/markup/repeater/DefaultItemReuseStrategy.java",0,0.810126582278481,3,2,5
"wicket-core/src/main/java/org/apache/wicket/markup/repeater/IItemFactory.java",0,0.782608695652174,1,3,4
"wicket-core/src/main/java/org/apache/wicket/markup/repeater/IItemReuseStrategy.java",0,0.709090909090909,1,4,5
"wicket-core/src/main/java/org/apache/wicket/markup/repeater/Item.java",0,0.682692307692308,2,4,6
"wicket-core/src/main/java/org/apache/wicket/markup/repeater/OddEvenItem.java",0,0.830508474576271,0,3,3
"wicket-core/src/main/java/org/apache/wicket/markup/repeater/RefreshingView.java",0,0.714876033057851,1,3,4
"wicket-core/src/main/java/org/apache/wicket/markup/repeater/RepeatingView.java",0,0.739495798319328,1,3,4
"wicket-core/src/main/java/org/apache/wicket/markup/repeater/ReuseIfModelsEqualStrategy.java",0,0.778846153846154,1,3,4
"wicket-core/src/main/java/org/apache/wicket/markup/repeater/data/DataView.java",0,0.783018867924528,4,2,6
"wicket-core/src/main/java/org/apache/wicket/markup/repeater/data/DataViewBase.java",0,0.735099337748344,5,2,7
"wicket-core/src/main/java/org/apache/wicket/markup/repeater/data/EmptyDataProvider.java",0,0.734177215189873,3,3,6
"wicket-core/src/main/java/org/apache/wicket/markup/repeater/data/GridView.java",0,0.770149253731343,3,3,6
"wicket-core/src/main/java/org/apache/wicket/markup/repeater/data/IDataProvider.java",0,0.541666666666667,2,3,5
"wicket-core/src/main/java/org/apache/wicket/markup/repeater/data/ListDataProvider.java",0,0.626086956521739,1,5,6
"wicket-core/src/main/java/org/apache/wicket/markup/repeater/util/ArrayIteratorAdapter.java",0,0.83695652173913,1,3,4
"wicket-core/src/main/java/org/apache/wicket/markup/repeater/util/ModelIteratorAdapter.java",0,0.827160493827161,2,2,4
"wicket-core/src/main/java/org/apache/wicket/markup/resolver/AutoLinkResolver.java",0,0.438695163104612,7,4,11
"wicket-core/src/main/java/org/apache/wicket/markup/resolver/ComponentResolvers.java",0,0.525179856115108,1,2,3
"wicket-core/src/main/java/org/apache/wicket/markup/resolver/FragmentResolver.java",0,0.571428571428571,3,4,7
"wicket-core/src/main/java/org/apache/wicket/markup/resolver/HtmlHeaderResolver.java",0,0.732824427480916,4,3,7
"wicket-core/src/main/java/org/apache/wicket/markup/resolver/IComponentResolver.java",0,0.26,1,5,6
"wicket-core/src/main/java/org/apache/wicket/markup/resolver/MarkupInheritanceResolver.java",0,0.657534246575342,3,3,6
"wicket-core/src/main/java/org/apache/wicket/markup/resolver/WicketContainerResolver.java",0,0.709302325581395,2,2,4
"wicket-core/src/main/java/org/apache/wicket/markup/resolver/WicketMessageResolver.java",0,0.818407960199005,7,2,9
"wicket-core/src/main/java/org/apache/wicket/markup/transformer/AbstractOutputTransformerContainer.java",0,0.702247191011236,1,4,5
"wicket-core/src/main/java/org/apache/wicket/markup/transformer/AbstractTransformerBehavior.java",0,0.490909090909091,3,5,8
"wicket-core/src/main/java/org/apache/wicket/markup/transformer/ITransformer.java",0,0.414634146341463,2,3,5
"wicket-core/src/main/java/org/apache/wicket/markup/transformer/NoopOutputTransformerContainer.java",0,0.596491228070175,1,4,5
"wicket-core/src/main/java/org/apache/wicket/markup/transformer/XsltOutputTransformerContainer.java",0,0.554621848739496,3,5,8
"wicket-core/src/main/java/org/apache/wicket/markup/transformer/XsltTransformer.java",0,0.781456953642384,5,2,7
"wicket-core/src/main/java/org/apache/wicket/markup/transformer/XsltTransformerBehavior.java",0,0.56701030927835,2,4,6
"wicket-core/src/main/java/org/apache/wicket/mock/MockApplication.java",0,0.458333333333333,0,5,5
"wicket-core/src/main/java/org/apache/wicket/mock/MockHomePage.java",0,0.857142857142857,0,2,2
"wicket-core/src/main/java/org/apache/wicket/mock/MockPageManager.java",0,0.361702127659574,0,4,4
"wicket-core/src/main/java/org/apache/wicket/mock/MockRequestParameters.java",0,0.897959183673469,1,2,3
"wicket-core/src/main/java/org/apache/wicket/mock/MockSessionStore.java",0,0.630434782608696,2,2,4
"wicket-core/src/main/java/org/apache/wicket/mock/MockWebRequest.java",0,0.591176470588235,1,3,4
"wicket-core/src/main/java/org/apache/wicket/mock/MockWebResponse.java",0,0.627249357326478,2,3,5
"wicket-core/src/main/java/org/apache/wicket/model/AbstractPropertyModel.java",0,0.262536873156342,8,5,13
"wicket-core/src/main/java/org/apache/wicket/model/AbstractReadOnlyModel.java",0,0.314285714285714,1,5,6
"wicket-core/src/main/java/org/apache/wicket/model/AbstractWrapModel.java",0,0.951612903225806,1,1,2
"wicket-core/src/main/java/org/apache/wicket/model/ComponentDetachableModel.java",0,0.905940594059406,1,2,3
"wicket-core/src/main/java/org/apache/wicket/model/ComponentModel.java",0,0.91304347826087,1,2,3
"wicket-core/src/main/java/org/apache/wicket/model/ComponentPropertyModel.java",0,0.666666666666667,2,2,4
"wicket-core/src/main/java/org/apache/wicket/model/CompoundPropertyModel.java",0,0.481327800829876,6,5,11
"wicket-core/src/main/java/org/apache/wicket/model/IChainingModel.java",0,0.821428571428571,2,2,4
"wicket-core/src/main/java/org/apache/wicket/model/IComponentAssignedModel.java",0,0.790322580645161,3,3,6
"wicket-core/src/main/java/org/apache/wicket/model/IComponentInheritedModel.java",0,0.458333333333333,1,4,5
"wicket-core/src/main/java/org/apache/wicket/model/IDetachable.java",0,0.4,1,4,5
"wicket-core/src/main/java/org/apache/wicket/model/IModel.java",0,0.226666666666667,1,5,6
"wicket-core/src/main/java/org/apache/wicket/model/IModelComparator.java",0,0.431818181818182,3,3,6
"wicket-core/src/main/java/org/apache/wicket/model/IObjectClassAwareModel.java",0,0.823529411764706,0,3,3
"wicket-core/src/main/java/org/apache/wicket/model/IPropertyReflectionAwareModel.java",0,0.745454545454545,1,2,3
"wicket-core/src/main/java/org/apache/wicket/model/IWrapModel.java",0,0.707317073170732,0,4,4
"wicket-core/src/main/java/org/apache/wicket/model/LoadableDetachableModel.java",0,0.418848167539267,2,5,7
"wicket-core/src/main/java/org/apache/wicket/model/Model.java",0,0.358024691358025,4,8,12
"wicket-core/src/main/java/org/apache/wicket/model/PropertyModel.java",0,0.335714285714286,2,7,9
"wicket-core/src/main/java/org/apache/wicket/model/ResourceModel.java",0,0.455882352941176,3,4,7
"wicket-core/src/main/java/org/apache/wicket/model/StringResourceModel.java",0,0.232289950576606,5,8,13
"wicket-core/src/main/java/org/apache/wicket/model/util/CollectionModel.java",0,0.525423728813559,0,2,2
"wicket-core/src/main/java/org/apache/wicket/model/util/GenericBaseModel.java",0,0.949579831932773,2,1,3
"wicket-core/src/main/java/org/apache/wicket/model/util/ListModel.java",0,0.523076923076923,0,2,2
"wicket-core/src/main/java/org/apache/wicket/model/util/MapModel.java",0,0.508474576271186,0,2,2
"wicket-core/src/main/java/org/apache/wicket/model/util/SetModel.java",0,0.53448275862069,0,2,2
"wicket-core/src/main/java/org/apache/wicket/model/util/WildcardCollectionModel.java",0,0.543859649122807,0,2,2
"wicket-core/src/main/java/org/apache/wicket/model/util/WildcardListModel.java",0,0.5,0,3,3
"wicket-core/src/main/java/org/apache/wicket/model/util/WildcardSetModel.java",0,0.543859649122807,0,2,2
"wicket-core/src/main/java/org/apache/wicket/page/AbstractPageManager.java",0,0.891472868217054,3,2,5
"wicket-core/src/main/java/org/apache/wicket/page/CouldNotLockPageException.java",0,0.7,0,2,2
"wicket-core/src/main/java/org/apache/wicket/page/DefaultPageManagerContext.java",0,0.884210526315789,1,2,3
"wicket-core/src/main/java/org/apache/wicket/page/IManageablePage.java",0,0.450704225352113,1,3,4
"wicket-core/src/main/java/org/apache/wicket/page/IPageManager.java",0,0.927710843373494,0,2,2
"wicket-core/src/main/java/org/apache/wicket/page/IPageManagerContext.java",0,0.787878787878788,0,3,3
"wicket-core/src/main/java/org/apache/wicket/page/PageAccessSynchronizer.java",0,0.746987951807229,1,2,3
"wicket-core/src/main/java/org/apache/wicket/page/PageManagerDecorator.java",0,1,0,1,1
"wicket-core/src/main/java/org/apache/wicket/page/PageStoreManager.java",0,0.745283018867924,3,2,5
"wicket-core/src/main/java/org/apache/wicket/page/RequestAdapter.java",0,0.48,0,3,3
"wicket-core/src/main/java/org/apache/wicket/pageStore/AsynchronousDataStore.java",0,0.708446866485014,1,3,4
"wicket-core/src/main/java/org/apache/wicket/pageStore/DefaultPageStore.java",0,0.575317604355717,1,3,4
"wicket-core/src/main/java/org/apache/wicket/pageStore/DiskDataStore.java",0,0.617821782178218,0,3,3
"wicket-core/src/main/java/org/apache/wicket/pageStore/IDataStore.java",0,1,0,1,1
"wicket-core/src/main/java/org/apache/wicket/pageStore/IPageStore.java",0,0.527777777777778,0,3,3
"wicket-core/src/main/java/org/apache/wicket/pageStore/PageWindowManager.java",0,0.893223819301848,1,2,3
"wicket-core/src/main/java/org/apache/wicket/pageStore/memory/DataStoreEvictionStrategy.java",0,0.970588235294118,1,1,2
"wicket-core/src/main/java/org/apache/wicket/pageStore/memory/HttpSessionDataStore.java",0,1,0,1,1
"wicket-core/src/main/java/org/apache/wicket/pageStore/memory/MemorySizeEvictionStrategy.java",0,1,0,1,1
"wicket-core/src/main/java/org/apache/wicket/pageStore/memory/PageNumberEvictionStrategy.java",0,1,0,1,1
"wicket-core/src/main/java/org/apache/wicket/pageStore/memory/PageTable.java",0,1,0,1,1
"wicket-core/src/main/java/org/apache/wicket/pageStore/memory/PageTableCleaner.java",0,1,0,1,1
"wicket-core/src/main/java/org/apache/wicket/protocol/http/AbstractRequestLogger.java",0,0.974559686888454,1,1,2
"wicket-core/src/main/java/org/apache/wicket/protocol/http/AjaxEnclosureListener.java",0,1,0,1,1
"wicket-core/src/main/java/org/apache/wicket/protocol/http/BufferedHttpServletResponse.java",0,0.680194805194805,8,3,11
"wicket-core/src/main/java/org/apache/wicket/protocol/http/BufferedWebResponse.java",0,0.611195158850227,7,4,11
"wicket-core/src/main/java/org/apache/wicket/protocol/http/ClientProperties.java",0,0.529616724738676,6,3,9
"wicket-core/src/main/java/org/apache/wicket/protocol/http/ContextParamWebApplicationFactory.java",0,0.327272727272727,2,6,8
"wicket-core/src/main/java/org/apache/wicket/protocol/http/HeaderBufferingWebResponse.java",0,0.812206572769953,1,3,4
"wicket-core/src/main/java/org/apache/wicket/protocol/http/IMetaDataBufferingWebResponse.java",0,0.72972972972973,0,2,2
"wicket-core/src/main/java/org/apache/wicket/protocol/http/IMultipartWebRequest.java",0,0.533333333333333,0,4,4
"wicket-core/src/main/java/org/apache/wicket/protocol/http/IRequestLogger.java",0,0.513409961685824,5,5,10
"wicket-core/src/main/java/org/apache/wicket/protocol/http/IStagedRequestLogger.java",0,1,0,1,1
"wicket-core/src/main/java/org/apache/wicket/protocol/http/IWebApplicationFactory.java",0,0.236363636363636,3,6,9
"wicket-core/src/main/java/org/apache/wicket/protocol/http/PageExpiredException.java",0,0.5,1,3,4
"wicket-core/src/main/java/org/apache/wicket/protocol/http/ReloadingWicketFilter.java",0,0.47752808988764,1,3,4
"wicket-core/src/main/java/org/apache/wicket/protocol/http/ReloadingWicketServlet.java",0,0.818181818181818,2,3,5
"wicket-core/src/main/java/org/apache/wicket/protocol/http/RequestLogger.java",0,0.553030303030303,1,3,4
"wicket-core/src/main/java/org/apache/wicket/protocol/http/RequestLoggerRequestCycleListener.java",0,0.924812030075188,0,2,2
"wicket-core/src/main/java/org/apache/wicket/protocol/http/RequestUtils.java",0,0.309178743961353,4,4,8
"wicket-core/src/main/java/org/apache/wicket/protocol/http/StoredResponsesMap.java",0,0.993333333333333,1,1,2
"wicket-core/src/main/java/org/apache/wicket/protocol/http/WebApplication.java",0,0.322198275862069,9,6,15
"wicket-core/src/main/java/org/apache/wicket/protocol/http/WebApplicationFactoryCreationException.java",0,0.302325581395349,1,5,6
"wicket-core/src/main/java/org/apache/wicket/protocol/http/WebSession.java",0,0.282157676348548,5,5,10
"wicket-core/src/main/java/org/apache/wicket/protocol/http/WicketFilter.java",0,0.256637168141593,5,6,11
"wicket-core/src/main/java/org/apache/wicket/protocol/http/WicketServlet.java",0,0.224615384615385,2,6,8
"wicket-core/src/main/java/org/apache/wicket/protocol/http/documentvalidation/Comment.java",0,0.5,3,4,7
"wicket-core/src/main/java/org/apache/wicket/protocol/http/documentvalidation/DocumentElement.java",0,0.5,1,4,5
"wicket-core/src/main/java/org/apache/wicket/protocol/http/documentvalidation/HtmlDocumentParser.java",0,0.72108843537415,6,3,9
"wicket-core/src/main/java/org/apache/wicket/protocol/http/documentvalidation/HtmlDocumentValidator.java",0,0.751953125,5,3,8
"wicket-core/src/main/java/org/apache/wicket/protocol/http/documentvalidation/Tag.java",0,0.676056338028169,4,3,7
"wicket-core/src/main/java/org/apache/wicket/protocol/http/documentvalidation/TextContent.java",0,0.491525423728814,3,4,7
"wicket-core/src/main/java/org/apache/wicket/protocol/http/mock/MockHttpServletRequest.java",0,0.884399551066218,3,2,5
"wicket-core/src/main/java/org/apache/wicket/protocol/http/mock/MockHttpServletResponse.java",0,0.982142857142857,2,1,3
"wicket-core/src/main/java/org/apache/wicket/protocol/http/mock/MockHttpSession.java",0,0.98936170212766,2,1,3
"wicket-core/src/main/java/org/apache/wicket/protocol/http/mock/MockServletContext.java",0,0.984240687679083,2,1,3
"wicket-core/src/main/java/org/apache/wicket/protocol/http/request/UserAgent.java",0,0.958677685950413,1,1,2
"wicket-core/src/main/java/org/apache/wicket/protocol/http/request/WebClientInfo.java",0,0.442675159235669,6,4,10
"wicket-core/src/main/java/org/apache/wicket/protocol/http/servlet/AbstractRequestWrapperFactory.java",0,0.987951807228916,1,1,2
"wicket-core/src/main/java/org/apache/wicket/protocol/http/servlet/ErrorAttributes.java",0,1,0,1,1
"wicket-core/src/main/java/org/apache/wicket/protocol/http/servlet/FilterFactoryManager.java",0,1,0,1,1
"wicket-core/src/main/java/org/apache/wicket/protocol/http/servlet/ForwardAttributes.java",0,1,0,1,1
"wicket-core/src/main/java/org/apache/wicket/protocol/http/servlet/MultipartServletWebRequest.java",0,0.352941176470588,3,5,8
"wicket-core/src/main/java/org/apache/wicket/protocol/http/servlet/MultipartServletWebRequestImpl.java",0,0.737179487179487,3,3,6
"wicket-core/src/main/java/org/apache/wicket/protocol/http/servlet/ResponseIOException.java",0,1,0,1,1
"wicket-core/src/main/java/org/apache/wicket/protocol/http/servlet/SecuredRemoteAddressRequestWrapperFactory.java",0,0.990338164251208,1,1,2
"wicket-core/src/main/java/org/apache/wicket/protocol/http/servlet/ServletWebRequest.java",0,0.817796610169492,9,2,11
"wicket-core/src/main/java/org/apache/wicket/protocol/http/servlet/ServletWebResponse.java",0,0.578947368421053,2,4,6
"wicket-core/src/main/java/org/apache/wicket/protocol/http/servlet/UploadInfo.java",0,0.892857142857143,0,2,2
"wicket-core/src/main/java/org/apache/wicket/protocol/http/servlet/WicketSessionFilter.java",0,0.586666666666667,3,3,6
"wicket-core/src/main/java/org/apache/wicket/protocol/http/servlet/XForwardedRequestWrapper.java",0,0.987301587301587,1,1,2
"wicket-core/src/main/java/org/apache/wicket/protocol/http/servlet/XForwardedRequestWrapperFactory.java",0,1,0,1,1
"wicket-core/src/main/java/org/apache/wicket/protocol/https/HttpsConfig.java",0,0.958333333333333,1,1,2
"wicket-core/src/main/java/org/apache/wicket/protocol/https/HttpsMapper.java",0,0.870503597122302,0,2,2
"wicket-core/src/main/java/org/apache/wicket/protocol/https/HttpsRequestChecker.java",0,0.888111888111888,0,2,2
"wicket-core/src/main/java/org/apache/wicket/protocol/https/Protocol.java",0,1,0,1,1
"wicket-core/src/main/java/org/apache/wicket/protocol/https/RequireHttps.java",0,1,0,1,1
"wicket-core/src/main/java/org/apache/wicket/protocol/https/SwitchProtocolRequestHandler.java",0,0.8,1,3,4
"wicket-core/src/main/java/org/apache/wicket/request/ClientInfo.java",0,0.583333333333333,0,3,3
"wicket-core/src/main/java/org/apache/wicket/request/component/IRequestableComponent.java",0,0.939655172413793,2,1,3
"wicket-core/src/main/java/org/apache/wicket/request/component/IRequestablePage.java",0,0.893333333333333,0,3,3
"wicket-core/src/main/java/org/apache/wicket/request/cycle/AbstractRequestCycleListener.java",0,0.815384615384615,1,2,3
"wicket-core/src/main/java/org/apache/wicket/request/cycle/IRequestCycleListener.java",0,0.470588235294118,0,3,3
"wicket-core/src/main/java/org/apache/wicket/request/cycle/RequestCycle.java",0,0.503916449086162,3,4,7
"wicket-core/src/main/java/org/apache/wicket/request/cycle/RequestCycleContext.java",0,0.496062992125984,0,3,3
"wicket-core/src/main/java/org/apache/wicket/request/cycle/RequestCycleListenerCollection.java",0,0.712820512820513,1,2,3
"wicket-core/src/main/java/org/apache/wicket/request/handler/BookmarkableListenerInterfaceRequestHandler.java",0,0.701149425287356,2,3,5
"wicket-core/src/main/java/org/apache/wicket/request/handler/BookmarkablePageRequestHandler.java",0,0.655913978494624,1,3,4
"wicket-core/src/main/java/org/apache/wicket/request/handler/BufferedResponseRequestHandler.java",0,0.377358490566038,1,3,4
"wicket-core/src/main/java/org/apache/wicket/request/handler/ComponentNotFoundException.java",0,0.388059701492537,0,3,3
"wicket-core/src/main/java/org/apache/wicket/request/handler/ComponentRenderingRequestHandler.java",0,0.753623188405797,0,4,4
"wicket-core/src/main/java/org/apache/wicket/request/handler/EmptyAjaxRequestHandler.java",0,0.740384615384615,2,3,5
"wicket-core/src/main/java/org/apache/wicket/request/handler/IComponentRequestHandler.java",0,0.761904761904762,1,2,3
"wicket-core/src/main/java/org/apache/wicket/request/handler/IIntrospectablePageProvider.java",0,1,0,1,1
"wicket-core/src/main/java/org/apache/wicket/request/handler/IPageAndComponentProvider.java",0,0.837209302325581,0,3,3
"wicket-core/src/main/java/org/apache/wicket/request/handler/IPageClassRequestHandler.java",0,0.902439024390244,1,2,3
"wicket-core/src/main/java/org/apache/wicket/request/handler/IPageProvider.java",0,0.5,0,5,5
"wicket-core/src/main/java/org/apache/wicket/request/handler/IPageRequestHandler.java",0,0.684210526315789,1,3,4
"wicket-core/src/main/java/org/apache/wicket/request/handler/ListenerInterfaceRequestHandler.java",0,0.561224489795918,2,4,6
"wicket-core/src/main/java/org/apache/wicket/request/handler/ListenerInvocationNotAllowedException.java",0,1,0,1,1
"wicket-core/src/main/java/org/apache/wicket/request/handler/PageAndComponentProvider.java",0,0.742424242424242,1,3,4
"wicket-core/src/main/java/org/apache/wicket/request/handler/PageProvider.java",0,0.602977667493797,0,4,4
"wicket-core/src/main/java/org/apache/wicket/request/handler/RenderPageRequestHandler.java",0,0.691489361702128,3,3,6
"wicket-core/src/main/java/org/apache/wicket/request/handler/logger/ListenerInterfaceLogData.java",0,0.686813186813187,0,2,2
"wicket-core/src/main/java/org/apache/wicket/request/handler/logger/PageLogData.java",0,0.840909090909091,0,2,2
"wicket-core/src/main/java/org/apache/wicket/request/handler/logger/ResourceReferenceLogData.java",0,1,0,1,1
"wicket-core/src/main/java/org/apache/wicket/request/handler/logger/ResourceStreamLogData.java",0,1,0,1,1
"wicket-core/src/main/java/org/apache/wicket/request/handler/render/PageRenderer.java",0,0.462686567164179,0,4,4
"wicket-core/src/main/java/org/apache/wicket/request/handler/render/WebPageRenderer.java",0,0.57037037037037,1,4,5
"wicket-core/src/main/java/org/apache/wicket/request/handler/resource/ResourceLogData.java",0,1,0,1,1
"wicket-core/src/main/java/org/apache/wicket/request/handler/resource/ResourceReferenceRequestHandler.java",0,0.482014388489209,0,4,4
"wicket-core/src/main/java/org/apache/wicket/request/handler/resource/ResourceRequestHandler.java",0,0.813953488372093,0,3,3
"wicket-core/src/main/java/org/apache/wicket/request/handler/resource/ResourceStreamRequestHandler.java",0,0.322429906542056,5,6,11
"wicket-core/src/main/java/org/apache/wicket/request/handler/resource/WebExternalResourceRequestHandler.java",0,0.558558558558559,5,4,9
"wicket-core/src/main/java/org/apache/wicket/request/mapper/AbstractBookmarkableMapper.java",0,0.6475,1,5,6
"wicket-core/src/main/java/org/apache/wicket/request/mapper/AbstractComponentMapper.java",0,0.814102564102564,0,2,2
"wicket-core/src/main/java/org/apache/wicket/request/mapper/AbstractResourceReferenceMapper.java",0,0.590643274853801,0,4,4
"wicket-core/src/main/java/org/apache/wicket/request/mapper/BasicResourceReferenceMapper.java",0,0.617886178861789,2,3,5
"wicket-core/src/main/java/org/apache/wicket/request/mapper/BookmarkableMapper.java",0,0.714285714285714,0,3,3
"wicket-core/src/main/java/org/apache/wicket/request/mapper/BufferedResponseMapper.java",0,0.574626865671642,1,3,4
"wicket-core/src/main/java/org/apache/wicket/request/mapper/CryptoMapper.java",0,0.432432432432432,0,3,3
"wicket-core/src/main/java/org/apache/wicket/request/mapper/HomePageMapper.java",0,0.672727272727273,1,2,3
"wicket-core/src/main/java/org/apache/wicket/request/mapper/IMapperContext.java",0,0.779220779220779,1,2,3
"wicket-core/src/main/java/org/apache/wicket/request/mapper/IPageSource.java",0,0.46,0,3,3
"wicket-core/src/main/java/org/apache/wicket/request/mapper/MountedMapper.java",0,0.413926499032882,3,3,6
"wicket-core/src/main/java/org/apache/wicket/request/mapper/PackageMapper.java",0,0.895522388059702,0,2,2
"wicket-core/src/main/java/org/apache/wicket/request/mapper/PageInstanceMapper.java",0,0.775757575757576,1,3,4
"wicket-core/src/main/java/org/apache/wicket/request/mapper/ResourceMapper.java",0,0.826415094339623,1,3,4
"wicket-core/src/main/java/org/apache/wicket/request/mapper/ResourceReferenceMapper.java",0,0.890909090909091,2,2,4
"wicket-core/src/main/java/org/apache/wicket/request/mapper/StalePageException.java",0,0.849056603773585,0,2,2
"wicket-core/src/main/java/org/apache/wicket/request/resource/AbstractResource.java",0,0.444279346210996,1,4,5
"wicket-core/src/main/java/org/apache/wicket/request/resource/ByteArrayResource.java",0,0.606060606060606,3,2,5
"wicket-core/src/main/java/org/apache/wicket/request/resource/ClassScanner.java",0,0.658823529411765,1,2,3
"wicket-core/src/main/java/org/apache/wicket/request/resource/ContentDisposition.java",0,0.5,0,2,2
"wicket-core/src/main/java/org/apache/wicket/request/resource/ContextRelativeResource.java",0,0.688741721854305,0,3,3
"wicket-core/src/main/java/org/apache/wicket/request/resource/CssPackageResource.java",0,1,0,1,1
"wicket-core/src/main/java/org/apache/wicket/request/resource/CssResourceReference.java",0,1,0,1,1
"wicket-core/src/main/java/org/apache/wicket/request/resource/DynamicImageResource.java",0,0.795454545454545,3,2,5
"wicket-core/src/main/java/org/apache/wicket/request/resource/IResource.java",0,0.834782608695652,2,2,4
"wicket-core/src/main/java/org/apache/wicket/request/resource/JavaScriptPackageResource.java",0,1,0,1,1
"wicket-core/src/main/java/org/apache/wicket/request/resource/JavaScriptResourceReference.java",0,0.356164383561644,1,5,6
"wicket-core/src/main/java/org/apache/wicket/request/resource/MetaInfStaticResourceReference.java",0,0.990476190476191,1,1,2
"wicket-core/src/main/java/org/apache/wicket/request/resource/PackageResource.java",0,0.312292358803987,1,4,5
"wicket-core/src/main/java/org/apache/wicket/request/resource/PackageResourceReference.java",0,0.397515527950311,1,5,6
"wicket-core/src/main/java/org/apache/wicket/request/resource/ResourceReference.java",0,0.3640081799591,0,5,5
"wicket-core/src/main/java/org/apache/wicket/request/resource/ResourceReferenceRegistry.java",0,0.741935483870968,1,3,4
"wicket-core/src/main/java/org/apache/wicket/request/resource/ResourceStreamResource.java",0,0.724324324324324,2,3,5
"wicket-core/src/main/java/org/apache/wicket/request/resource/SharedResourceReference.java",0,0.631147540983607,1,3,4
"wicket-core/src/main/java/org/apache/wicket/request/resource/caching/FilenameWithVersionResourceCachingStrategy.java",0,1,0,1,1
"wicket-core/src/main/java/org/apache/wicket/request/resource/caching/IResourceCachingStrategy.java",0,0.796875,0,2,2
"wicket-core/src/main/java/org/apache/wicket/request/resource/caching/IStaticCacheableResource.java",0,0.836734693877551,0,2,2
"wicket-core/src/main/java/org/apache/wicket/request/resource/caching/NoOpResourceCachingStrategy.java",0,0.916666666666667,0,2,2
"wicket-core/src/main/java/org/apache/wicket/request/resource/caching/QueryStringWithVersionResourceCachingStrategy.java",0,0.932773109243697,0,2,2
"wicket-core/src/main/java/org/apache/wicket/request/resource/caching/ResourceUrl.java",0,0.933333333333333,0,2,2
"wicket-core/src/main/java/org/apache/wicket/request/resource/caching/version/CachingResourceVersion.java",0,1,0,1,1
"wicket-core/src/main/java/org/apache/wicket/request/resource/caching/version/IResourceVersion.java",0,1,0,1,1
"wicket-core/src/main/java/org/apache/wicket/request/resource/caching/version/LastModifiedResourceVersion.java",0,1,0,1,1
"wicket-core/src/main/java/org/apache/wicket/request/resource/caching/version/MessageDigestResourceVersion.java",0,0.96039603960396,1,1,2
"wicket-core/src/main/java/org/apache/wicket/request/resource/caching/version/RequestCycleCachedResourceVersion.java",0,1,0,1,1
"wicket-core/src/main/java/org/apache/wicket/request/resource/caching/version/StaticResourceVersion.java",0,1,0,1,1
"wicket-core/src/main/java/org/apache/wicket/resource/IPropertiesChangeListener.java",0,0.484848484848485,2,3,5
"wicket-core/src/main/java/org/apache/wicket/resource/IPropertiesFactory.java",0,0.453125,1,4,5
"wicket-core/src/main/java/org/apache/wicket/resource/IPropertiesFactoryContext.java",0,1,0,1,1
"wicket-core/src/main/java/org/apache/wicket/resource/IPropertiesLoader.java",0,1,0,1,1
"wicket-core/src/main/java/org/apache/wicket/resource/ITextResourceCompressor.java",0,1,0,1,1
"wicket-core/src/main/java/org/apache/wicket/resource/IsoPropertiesFilePropertiesLoader.java",0,1,0,1,1
"wicket-core/src/main/java/org/apache/wicket/resource/NoOpTextCompressor.java",0,0.794117647058823,0,2,2
"wicket-core/src/main/java/org/apache/wicket/resource/Properties.java",0,0.765432098765432,2,2,4
"wicket-core/src/main/java/org/apache/wicket/resource/PropertiesFactory.java",0,0.720538720538721,6,3,9
"wicket-core/src/main/java/org/apache/wicket/resource/ResourceUtil.java",0,0.365482233502538,0,4,4
"wicket-core/src/main/java/org/apache/wicket/resource/TextTemplateResourceReference.java",0,0.915730337078652,0,2,2
"wicket-core/src/main/java/org/apache/wicket/resource/UtfPropertiesFilePropertiesLoader.java",0,0.991228070175439,1,1,2
"wicket-core/src/main/java/org/apache/wicket/resource/XmlFilePropertiesLoader.java",0,1,0,1,1
"wicket-core/src/main/java/org/apache/wicket/resource/aggregation/AbstractDependencyRespectingResourceAggregatingHeaderResponse.java",0,0.912087912087912,0,2,2
"wicket-core/src/main/java/org/apache/wicket/resource/aggregation/AbstractResourceAggregatingHeaderResponse.java",0,0.686075949367089,1,2,3
"wicket-core/src/main/java/org/apache/wicket/resource/aggregation/ResourceReferenceAndStringData.java",0,0.656765676567657,0,2,2
"wicket-core/src/main/java/org/apache/wicket/resource/aggregation/ResourceReferenceCollection.java",0,1,0,1,1
"wicket-core/src/main/java/org/apache/wicket/resource/dependencies/AbstractResourceDependentResourceReference.java",0,0.833333333333333,1,2,3
"wicket-core/src/main/java/org/apache/wicket/resource/dependencies/IResourceReferenceDependencyConfigurationService.java",0,0.979166666666667,1,1,2
"wicket-core/src/main/java/org/apache/wicket/resource/dependencies/ResourceDependentResourceReference.java",0,0.881720430107527,1,2,3
"wicket-core/src/main/java/org/apache/wicket/resource/dependencies/ResourceReferenceDependencyInjectingHeaderResponse.java",0,0.979865771812081,2,1,3
"wicket-core/src/main/java/org/apache/wicket/resource/filtering/AbstractHeaderResponseFilter.java",0,0.96875,2,1,3
"wicket-core/src/main/java/org/apache/wicket/resource/filtering/CssAcceptingHeaderResponseFilter.java",0,0.957142857142857,2,1,3
"wicket-core/src/main/java/org/apache/wicket/resource/filtering/HeaderResponseContainerFilteringHeaderResponse.java",0,0.799107142857143,0,3,3
"wicket-core/src/main/java/org/apache/wicket/resource/filtering/HeaderResponseFilteredResponseContainer.java",0,0.958904109589041,1,1,2
"wicket-core/src/main/java/org/apache/wicket/resource/filtering/JavaScriptAcceptingHeaderResponseFilter.java",0,0.947368421052632,0,2,2
"wicket-core/src/main/java/org/apache/wicket/resource/filtering/JavaScriptFilteredIntoFooterHeaderResponse.java",0,0.91044776119403,0,2,2
"wicket-core/src/main/java/org/apache/wicket/resource/filtering/OppositeHeaderResponseFilter.java",0,0.956521739130435,2,1,3
"wicket-core/src/main/java/org/apache/wicket/resource/loader/BundleStringResourceLoader.java",0,0.521739130434783,3,4,7
"wicket-core/src/main/java/org/apache/wicket/resource/loader/ClassStringResourceLoader.java",0,0.682926829268293,1,4,5
"wicket-core/src/main/java/org/apache/wicket/resource/loader/ComponentStringResourceLoader.java",0,0.463343108504399,5,4,9
"wicket-core/src/main/java/org/apache/wicket/resource/loader/IStringResourceLoader.java",0,0.372340425531915,2,4,6
"wicket-core/src/main/java/org/apache/wicket/resource/loader/JarStringResourceLoader.java",0,1,0,1,1
"wicket-core/src/main/java/org/apache/wicket/resource/loader/PackageStringResourceLoader.java",0,0.912751677852349,0,2,2
"wicket-core/src/main/java/org/apache/wicket/resource/loader/ValidatorStringResourceLoader.java",0,0.863157894736842,0,2,2
"wicket-core/src/main/java/org/apache/wicket/response/ByteArrayResponse.java",0,0.876811594202899,1,2,3
"wicket-core/src/main/java/org/apache/wicket/response/NullResponse.java",0,0.350649350649351,2,6,8
"wicket-core/src/main/java/org/apache/wicket/response/StringResponse.java",0,0.235294117647059,3,6,9
"wicket-core/src/main/java/org/apache/wicket/response/filter/AjaxServerAndClientTimeFilter.java",0,0.957264957264957,1,1,2
"wicket-core/src/main/java/org/apache/wicket/response/filter/EmptySrcAttributeCheckFilter.java",0,0.859154929577465,1,2,3
"wicket-core/src/main/java/org/apache/wicket/response/filter/IResponseFilter.java",0,0.41304347826087,2,4,6
"wicket-core/src/main/java/org/apache/wicket/response/filter/ServerAndClientTimeFilter.java",0,0.947916666666667,0,2,2
"wicket-core/src/main/java/org/apache/wicket/serialize/java/JavaSerializer.java",0,0.783687943262411,0,2,2
"wicket-core/src/main/java/org/apache/wicket/session/DefaultPageFactory.java",0,0.271698113207547,4,5,9
"wicket-core/src/main/java/org/apache/wicket/session/HttpSessionStore.java",0,0.528571428571429,1,3,4
"wicket-core/src/main/java/org/apache/wicket/session/ISessionStore.java",0,0.278688524590164,3,6,9
"wicket-core/src/main/java/org/apache/wicket/settings/IApplicationSettings.java",0,0.444444444444444,2,5,7
"wicket-core/src/main/java/org/apache/wicket/settings/IDebugSettings.java",0,0.262068965517241,5,5,10
"wicket-core/src/main/java/org/apache/wicket/settings/IExceptionSettings.java",0,0.413793103448276,3,5,8
"wicket-core/src/main/java/org/apache/wicket/settings/IFrameworkSettings.java",0,0.320512820512821,2,5,7
"wicket-core/src/main/java/org/apache/wicket/settings/IMarkupSettings.java",0,0.331395348837209,4,5,9
"wicket-core/src/main/java/org/apache/wicket/settings/IPageSettings.java",0,0.310344827586207,1,5,6
"wicket-core/src/main/java/org/apache/wicket/settings/IRequestCycleSettings.java",0,0.23469387755102,3,6,9
"wicket-core/src/main/java/org/apache/wicket/settings/IRequestLoggerSettings.java",0,0.53968253968254,1,3,4
"wicket-core/src/main/java/org/apache/wicket/settings/IResourceSettings.java",0,0.313218390804598,4,6,10
"wicket-core/src/main/java/org/apache/wicket/settings/ISecuritySettings.java",0,0.342342342342342,1,6,7
"wicket-core/src/main/java/org/apache/wicket/settings/ISessionSettings.java",0,0.421052631578947,1,5,6
"wicket-core/src/main/java/org/apache/wicket/settings/IStoreSettings.java",0,1,0,1,1
"wicket-core/src/main/java/org/apache/wicket/settings/def/ApplicationSettings.java",0,0.994535519125683,1,1,2
"wicket-core/src/main/java/org/apache/wicket/settings/def/DebugSettings.java",0,0.994011976047904,1,1,2
"wicket-core/src/main/java/org/apache/wicket/settings/def/ExceptionSettings.java",0,0.775280898876405,1,2,3
"wicket-core/src/main/java/org/apache/wicket/settings/def/FrameworkSettings.java",0,0.43046357615894,0,3,3
"wicket-core/src/main/java/org/apache/wicket/settings/def/MarkupSettings.java",0,0.995433789954338,1,1,2
"wicket-core/src/main/java/org/apache/wicket/settings/def/PageSettings.java",0,0.986486486486487,1,1,2
"wicket-core/src/main/java/org/apache/wicket/settings/def/RequestCycleSettings.java",0,0.976076555023923,2,1,3
"wicket-core/src/main/java/org/apache/wicket/settings/def/RequestLoggerSettings.java",0,0.988372093023256,1,1,2
"wicket-core/src/main/java/org/apache/wicket/settings/def/ResourceSettings.java",0,0.728846153846154,1,4,5
"wicket-core/src/main/java/org/apache/wicket/settings/def/SecuritySettings.java",0,0.994082840236686,1,1,2
"wicket-core/src/main/java/org/apache/wicket/settings/def/SessionSettings.java",0,0.774193548387097,1,2,3
"wicket-core/src/main/java/org/apache/wicket/settings/def/StoreSettings.java",0,1,0,1,1
"wicket-core/src/main/java/org/apache/wicket/util/cookies/CookieDefaults.java",0,0.679012345679012,1,5,6
"wicket-core/src/main/java/org/apache/wicket/util/cookies/CookieUtils.java",0,0.602702702702703,6,3,9
"wicket-core/src/main/java/org/apache/wicket/util/crypt/KeyInSessionSunJceCryptFactory.java",0,1,0,1,1
"wicket-core/src/main/java/org/apache/wicket/util/file/WebApplicationPath.java",0,0.529850746268657,3,5,8
"wicket-core/src/main/java/org/apache/wicket/util/io/SerializableChecker.java",0,0.798050139275766,6,2,8
"wicket-core/src/main/java/org/apache/wicket/util/io/WicketSerializeableException.java",0,0.760869565217391,0,3,3
"wicket-core/src/main/java/org/apache/wicket/util/iterator/AbstractHierarchyIterator.java",0,1,0,1,1
"wicket-core/src/main/java/org/apache/wicket/util/iterator/AbstractHierarchyIteratorWithFilter.java",0,1,0,1,1
"wicket-core/src/main/java/org/apache/wicket/util/iterator/ComponentHierarchyIterator.java",0,1,0,1,1
"wicket-core/src/main/java/org/apache/wicket/util/iterator/GenericComponentHierarchyIterator.java",0,1,0,1,1
"wicket-core/src/main/java/org/apache/wicket/util/iterator/IteratorFilter.java",0,1,0,1,1
"wicket-core/src/main/java/org/apache/wicket/util/lang/PropertyResolver.java",0,0.677887788778878,9,3,12
"wicket-core/src/main/java/org/apache/wicket/util/lang/PropertyResolverConverter.java",0,0.722222222222222,0,3,3
"wicket-core/src/main/java/org/apache/wicket/util/lang/WicketObjects.java",0,0.92822966507177,1,2,3
"wicket-core/src/main/java/org/apache/wicket/util/resource/AbstractResourceStreamWriter.java",0,0.669642857142857,1,2,3
"wicket-core/src/main/java/org/apache/wicket/util/resource/IResourceStreamWriter.java",0,0.926829268292683,2,1,3
"wicket-core/src/main/java/org/apache/wicket/util/resource/PackageResourceStream.java",0,0.770833333333333,1,3,4
"wicket-core/src/main/java/org/apache/wicket/util/resource/UrlResourceStream.java",0,0.320987654320988,2,6,8
"wicket-core/src/main/java/org/apache/wicket/util/resource/WebExternalResourceStream.java",0,0.736363636363636,5,2,7
"wicket-core/src/main/java/org/apache/wicket/util/resource/locator/ExtensionResourceNameIterator.java",0,0.923076923076923,2,1,3
"wicket-core/src/main/java/org/apache/wicket/util/resource/locator/IResourceStreamLocator.java",0,0.282608695652174,0,7,7
"wicket-core/src/main/java/org/apache/wicket/util/resource/locator/LocaleResourceNameIterator.java",0,0.76158940397351,2,3,5
"wicket-core/src/main/java/org/apache/wicket/util/resource/locator/OsgiResourceStreamLocator.java",0,0.607142857142857,0,4,4
"wicket-core/src/main/java/org/apache/wicket/util/resource/locator/ResourceNameIterator.java",0,0.936619718309859,4,1,5
"wicket-core/src/main/java/org/apache/wicket/util/resource/locator/ResourceStreamLocator.java",0,0.845238095238095,3,2,5
"wicket-core/src/main/java/org/apache/wicket/util/resource/locator/StyleAndVariationResourceNameIterator.java",0,0.957983193277311,2,1,3
"wicket-core/src/main/java/org/apache/wicket/util/resource/locator/caching/AbstractResourceStreamReference.java",0,1,0,1,1
"wicket-core/src/main/java/org/apache/wicket/util/resource/locator/caching/CachingResourceStreamLocator.java",0,1,0,1,1
"wicket-core/src/main/java/org/apache/wicket/util/resource/locator/caching/FileResourceStreamReference.java",0,1,0,1,1
"wicket-core/src/main/java/org/apache/wicket/util/resource/locator/caching/IResourceStreamReference.java",0,1,0,1,1
"wicket-core/src/main/java/org/apache/wicket/util/resource/locator/caching/NullResourceStreamReference.java",0,1,0,1,1
"wicket-core/src/main/java/org/apache/wicket/util/resource/locator/caching/UrlResourceStreamReference.java",0,1,0,1,1
"wicket-core/src/main/java/org/apache/wicket/util/string/ComponentStrings.java",0,0.922413793103448,1,2,3
"wicket-core/src/main/java/org/apache/wicket/util/string/CssUtils.java",0,0.578947368421053,1,3,4
"wicket-core/src/main/java/org/apache/wicket/util/string/JavaScriptStripper.java",0,0.84070796460177,5,2,7
"wicket-core/src/main/java/org/apache/wicket/util/string/JavaScriptUtils.java",0,0.44047619047619,3,6,9
"wicket-core/src/main/java/org/apache/wicket/util/string/UrlUtils.java",0,0.94,2,1,3
"wicket-core/src/main/java/org/apache/wicket/util/string/interpolator/PropertyVariableInterpolator.java",0,0.275590551181102,2,6,8
"wicket-core/src/main/java/org/apache/wicket/util/template/CssTemplate.java",0,0.46,3,4,7
"wicket-core/src/main/java/org/apache/wicket/util/template/JavaScriptTemplate.java",0,0.34,3,5,8
"wicket-core/src/main/java/org/apache/wicket/util/template/PackageTextTemplate.java",0,0.555555555555556,5,5,10
"wicket-core/src/main/java/org/apache/wicket/util/template/TextTemplate.java",0,0.53921568627451,4,4,8
"wicket-core/src/main/java/org/apache/wicket/util/template/TextTemplateDecorator.java",0,0.684931506849315,4,4,8
"wicket-core/src/main/java/org/apache/wicket/util/tester/BaseWicketTester.java",0,0.344877344877345,9,5,14
"wicket-core/src/main/java/org/apache/wicket/util/tester/ComponentInPage.java",0,1,0,1,1
"wicket-core/src/main/java/org/apache/wicket/util/tester/DiffUtil.java",0,0.492307692307692,7,2,9
"wicket-core/src/main/java/org/apache/wicket/util/tester/DummyHomePage.java",0,0.637362637362637,3,3,6
"wicket-core/src/main/java/org/apache/wicket/util/tester/DummyPanelPage.java",0,0.5,2,3,5
"wicket-core/src/main/java/org/apache/wicket/util/tester/FormTester.java",0,0.287076271186441,7,4,11
"wicket-core/src/main/java/org/apache/wicket/util/tester/ITestPageSource.java",0,0.421052631578947,3,4,7
"wicket-core/src/main/java/org/apache/wicket/util/tester/ITestPanelSource.java",0,0.414634146341463,2,5,7
"wicket-core/src/main/java/org/apache/wicket/util/tester/Result.java",0,0.759036144578313,2,2,4
"wicket-core/src/main/java/org/apache/wicket/util/tester/TagTester.java",0,0.562610229276896,4,4,8
"wicket-core/src/main/java/org/apache/wicket/util/tester/WicketTester.java",0,0.419485791610284,7,6,13
"wicket-core/src/main/java/org/apache/wicket/util/tester/WicketTesterHelper.java",0,0.477832512315271,3,4,7
"wicket-core/src/main/java/org/apache/wicket/validation/CompoundValidator.java",0,0.623529411764706,1,4,5
"wicket-core/src/main/java/org/apache/wicket/validation/IErrorMessageSource.java",0,0.711864406779661,0,3,3
"wicket-core/src/main/java/org/apache/wicket/validation/INullAcceptingValidator.java",0,0.65,0,3,3
"wicket-core/src/main/java/org/apache/wicket/validation/IValidatable.java",0,0.444444444444444,1,4,5
"wicket-core/src/main/java/org/apache/wicket/validation/IValidationError.java",0,0.351351351351351,0,4,4
"wicket-core/src/main/java/org/apache/wicket/validation/IValidator.java",0,0.302325581395349,3,4,7
"wicket-core/src/main/java/org/apache/wicket/validation/Validatable.java",0,0.503184713375796,0,4,4
"wicket-core/src/main/java/org/apache/wicket/validation/ValidationError.java",0,0.490909090909091,3,3,6
"wicket-core/src/main/java/org/apache/wicket/validation/ValidatorAdapter.java",0,0.952380952380952,1,1,2
"wicket-core/src/main/java/org/apache/wicket/validation/validator/AbstractValidator.java",0,0.690821256038647,3,3,6
"wicket-core/src/main/java/org/apache/wicket/validation/validator/CreditCardValidator.java",0,0.886217948717949,4,2,6
"wicket-core/src/main/java/org/apache/wicket/validation/validator/DateValidator.java",0,0.476190476190476,0,4,4
"wicket-core/src/main/java/org/apache/wicket/validation/validator/EmailAddressValidator.java",0,0.28125,3,5,8
"wicket-core/src/main/java/org/apache/wicket/validation/validator/MaximumValidator.java",0,0.791208791208791,0,2,2
"wicket-core/src/main/java/org/apache/wicket/validation/validator/MinimumValidator.java",0,0.758620689655172,0,2,2
"wicket-core/src/main/java/org/apache/wicket/validation/validator/PatternValidator.java",0,0.301675977653631,0,7,7
"wicket-core/src/main/java/org/apache/wicket/validation/validator/RangeValidator.java",0,0.846774193548387,0,2,2
"wicket-core/src/main/java/org/apache/wicket/validation/validator/StringValidator.java",0,0.346062052505967,2,5,7
"wicket-core/src/main/java/org/apache/wicket/validation/validator/UrlValidator.java",0,0.780366056572379,2,3,5
"wicket-core/src/test/java/org/apache/wicket/ApplicationSettingsTest.java",0,0.279761904761905,5,6,11
"wicket-core/src/test/java/org/apache/wicket/AttributeModifierComponentPage.java",0,0.253968253968254,5,5,10
"wicket-core/src/test/java/org/apache/wicket/AttributeModifierComponentTest.java",0,0.414141414141414,2,6,8
"wicket-core/src/test/java/org/apache/wicket/AttributeModifierTest.java",0,0.434650455927052,7,3,10
"wicket-core/src/test/java/org/apache/wicket/AuthorizationTest.java",0,0.626198083067093,6,4,10
"wicket-core/src/test/java/org/apache/wicket/BehaviorRequestTest.java",0,0.708074534161491,2,3,5
"wicket-core/src/test/java/org/apache/wicket/BehaviorUrlTest.java",0,0.406417112299465,1,3,4
"wicket-core/src/test/java/org/apache/wicket/CachingDisabledLocalizerTest.java",0,0.9,0,2,2
"wicket-core/src/test/java/org/apache/wicket/ComponentConfigurationTest.java",0,0.872340425531915,1,2,3
"wicket-core/src/test/java/org/apache/wicket/ComponentEventsTest.java",0,0.996987951807229,1,1,2
"wicket-core/src/test/java/org/apache/wicket/ComponentInitializationIntegrationTest.java",0,0.91,1,2,3
"wicket-core/src/test/java/org/apache/wicket/ComponentInitializationTest.java",0,0.881944444444444,1,2,3
"wicket-core/src/test/java/org/apache/wicket/ComponentTest.java",0,0.33695652173913,3,5,8
"wicket-core/src/test/java/org/apache/wicket/ComponentWithLazyModelCreationTest.java",0,0.834586466165414,2,2,4
"wicket-core/src/test/java/org/apache/wicket/ConverterLocatorTest.java",0,0.914893617021277,0,2,2
"wicket-core/src/test/java/org/apache/wicket/DefaultExceptionMapperTest.java",0,1,0,1,1
"wicket-core/src/test/java/org/apache/wicket/DisabledComponentPage1.java",0,0.549019607843137,1,4,5
"wicket-core/src/test/java/org/apache/wicket/DisabledComponentPage2.java",0,0.571428571428571,1,3,4
"wicket-core/src/test/java/org/apache/wicket/DisabledComponentTest.java",0,0.403846153846154,2,4,6
"wicket-core/src/test/java/org/apache/wicket/EventDispatcherTest.java",0,0.738095238095238,1,3,4
"wicket-core/src/test/java/org/apache/wicket/ExceptionMapperTest.java",0,0.938775510204082,2,1,3
"wicket-core/src/test/java/org/apache/wicket/FeedbackMessagesTest.java",0,0.9375,0,2,2
"wicket-core/src/test/java/org/apache/wicket/FormDispatchEventTest.java",0,0.391304347826087,0,5,5
"wicket-core/src/test/java/org/apache/wicket/LocalizerTest.java",0,0.384615384615385,7,3,10
"wicket-core/src/test/java/org/apache/wicket/LoginPage.java",0,1,0,1,1
"wicket-core/src/test/java/org/apache/wicket/MarkupContainerTest.java",0,0.489247311827957,5,3,8
"wicket-core/src/test/java/org/apache/wicket/MarkupIdTestPage.java",0,0.842105263157895,0,2,2
"wicket-core/src/test/java/org/apache/wicket/MetaDataTest.java",0,0.880952380952381,2,2,4
"wicket-core/src/test/java/org/apache/wicket/MockComponent.java",0,0.781818181818182,0,3,3
"wicket-core/src/test/java/org/apache/wicket/MockPage.java",0,0.826347305389222,2,2,4
"wicket-core/src/test/java/org/apache/wicket/MockPageParametersAware.java",0,1,0,1,1
"wicket-core/src/test/java/org/apache/wicket/MockPageWithForm.java",0,0.567307692307692,3,4,7
"wicket-core/src/test/java/org/apache/wicket/MockPageWithLink.java",0,0.6,3,2,5
"wicket-core/src/test/java/org/apache/wicket/MockPageWithLinkAndComponent.java",0,0.518518518518518,2,3,5
"wicket-core/src/test/java/org/apache/wicket/MockPageWithOneComponent.java",0,0.393939393939394,1,4,5
"wicket-core/src/test/java/org/apache/wicket/MockPanelWithLink.java",0,1,0,1,1
"wicket-core/src/test/java/org/apache/wicket/MyPage0.java",0,0.571428571428571,2,3,5
"wicket-core/src/test/java/org/apache/wicket/MyPage1.java",0,0.470588235294118,1,4,5
"wicket-core/src/test/java/org/apache/wicket/MyPage2.java",0,0.457142857142857,1,4,5
"wicket-core/src/test/java/org/apache/wicket/MyPage3.java",0,0.444444444444444,1,4,5
"wicket-core/src/test/java/org/apache/wicket/MyPage4.java",0,0.444444444444444,1,4,5
"wicket-core/src/test/java/org/apache/wicket/MyPage5.java",0,0.5,1,4,5
"wicket-core/src/test/java/org/apache/wicket/PageFactoryTest.java",0,0.75886524822695,6,3,9
"wicket-core/src/test/java/org/apache/wicket/PageMarkupLoadingTest.java",0,0.878260869565217,0,3,3
"wicket-core/src/test/java/org/apache/wicket/ParentResourceEscapePathTest.java",0,0.611940298507463,2,4,6
"wicket-core/src/test/java/org/apache/wicket/ParentResourceEscapePathTestPage.java",0,0.884615384615385,1,2,3
"wicket-core/src/test/java/org/apache/wicket/PlaceholderTagIdTest.java",0,1,0,1,1
"wicket-core/src/test/java/org/apache/wicket/ProtectedPage.java",0,0.944444444444444,0,2,2
"wicket-core/src/test/java/org/apache/wicket/RedirectA.java",0,0.890909090909091,1,2,3
"wicket-core/src/test/java/org/apache/wicket/RedirectApplication.java",0,0.901960784313726,1,2,3
"wicket-core/src/test/java/org/apache/wicket/RedirectB.java",0,0.852459016393443,1,2,3
"wicket-core/src/test/java/org/apache/wicket/RedirectHomePage.java",0,0.894736842105263,1,2,3
"wicket-core/src/test/java/org/apache/wicket/RemoveTest.java",0,0.984126984126984,1,1,2
"wicket-core/src/test/java/org/apache/wicket/RemoveTestPage.java",0,0.982456140350877,1,1,2
"wicket-core/src/test/java/org/apache/wicket/RequestEncodingTest.java",0,0.612903225806452,0,4,4
"wicket-core/src/test/java/org/apache/wicket/ResourceTest.java",0,0.471910112359551,2,5,7
"wicket-core/src/test/java/org/apache/wicket/RestartResponseAtInterceptPageExceptionTest.java",0,1,0,1,1
"wicket-core/src/test/java/org/apache/wicket/RestartResponseExceptionTest.java",0,1,0,1,1
"wicket-core/src/test/java/org/apache/wicket/RestartWithMountedPageTest.java",0,0.871794871794872,0,2,2
"wicket-core/src/test/java/org/apache/wicket/SetResponsePageTest.java",0,0.739130434782609,2,3,5
"wicket-core/src/test/java/org/apache/wicket/SharedResourceUrlTest.java",0,0.307692307692308,3,4,7
"wicket-core/src/test/java/org/apache/wicket/TestDetachPage.java",0,0.777272727272727,2,3,5
"wicket-core/src/test/java/org/apache/wicket/TestPage_1.java",0,0.637931034482759,2,3,5
"wicket-core/src/test/java/org/apache/wicket/TesterTest.java",0,0.623376623376623,3,4,7
"wicket-core/src/test/java/org/apache/wicket/VisitorTest.java",0,0.836633663366337,0,3,3
"wicket-core/src/test/java/org/apache/wicket/WicketJUnitRunner.java",0,1,0,1,1
"wicket-core/src/test/java/org/apache/wicket/WicketTestCase.java",0,0.556650246305419,2,6,8
"wicket-core/src/test/java/org/apache/wicket/ajax/AjaxBehaviorAndMetaDataPage.java",0,0.941176470588235,0,2,2
"wicket-core/src/test/java/org/apache/wicket/ajax/AjaxBehaviorAndMetaDataTest.java",0,0.853658536585366,1,2,3
"wicket-core/src/test/java/org/apache/wicket/ajax/AjaxBehaviorEnabledPage.java",0,0.907692307692308,0,2,2
"wicket-core/src/test/java/org/apache/wicket/ajax/AjaxBehaviorEnabledTest.java",0,0.827586206896552,2,2,4
"wicket-core/src/test/java/org/apache/wicket/ajax/AjaxChannelTest.java",0,1,0,1,1
"wicket-core/src/test/java/org/apache/wicket/ajax/AjaxComponentVisibilityTest.java",0,0.859375,0,2,2
"wicket-core/src/test/java/org/apache/wicket/ajax/AjaxHeaderContribution.java",0,0.888888888888889,2,2,4
"wicket-core/src/test/java/org/apache/wicket/ajax/AjaxHeaderContribution2.java",0,0.911111111111111,0,2,2
"wicket-core/src/test/java/org/apache/wicket/ajax/AjaxHeaderContributionPage.java",0,0.803571428571429,1,2,3
"wicket-core/src/test/java/org/apache/wicket/ajax/AjaxHeaderContributionPage2.java",0,0.742424242424242,1,2,3
"wicket-core/src/test/java/org/apache/wicket/ajax/AjaxHeaderContributionTest.java",0,0.758620689655172,1,3,4
"wicket-core/src/test/java/org/apache/wicket/ajax/AjaxPostprocessingCallDecoratorTest.java",0,0.852941176470588,0,2,2
"wicket-core/src/test/java/org/apache/wicket/ajax/AjaxPreprocessingCallDecoratorTest.java",0,0.852941176470588,0,2,2
"wicket-core/src/test/java/org/apache/wicket/ajax/AjaxRequestTargetTest.java",0,0.340782122905028,4,5,9
"wicket-core/src/test/java/org/apache/wicket/ajax/AjaxTimerBehaviorTest.java",0,0.510373443983402,6,3,9
"wicket-core/src/test/java/org/apache/wicket/ajax/DomReadyOrderPage.java",0,0.895522388059702,1,2,3
"wicket-core/src/test/java/org/apache/wicket/ajax/DomReadyOrderTest.java",0,0.488636363636364,1,3,4
"wicket-core/src/test/java/org/apache/wicket/ajax/HomePage.java",0,0.938053097345133,0,2,2
"wicket-core/src/test/java/org/apache/wicket/ajax/HomePage2.java",0,0.959459459459459,1,1,2
"wicket-core/src/test/java/org/apache/wicket/ajax/InternalErrorCallsAjaxOnFailurePage.java",0,0.875,0,2,2
"wicket-core/src/test/java/org/apache/wicket/ajax/InternalErrorCallsAjaxOnFailureTest.java",0,0.980582524271845,1,1,2
"wicket-core/src/test/java/org/apache/wicket/ajax/MockComponent1.java",0,0.5,1,3,4
"wicket-core/src/test/java/org/apache/wicket/ajax/MockComponent2.java",0,0.5,1,3,4
"wicket-core/src/test/java/org/apache/wicket/ajax/MockComponent3.java",0,0.425531914893617,1,3,4
"wicket-core/src/test/java/org/apache/wicket/ajax/VarargsAddComponentPage.java",0,0.987341772151899,1,1,2
"wicket-core/src/test/java/org/apache/wicket/ajax/form/AjaxFormSubmitBehaviorTest.java",0,0.86046511627907,1,2,3
"wicket-core/src/test/java/org/apache/wicket/ajax/form/AjaxFormSubmitBehaviorTestPage.java",0,0.883333333333333,0,2,2
"wicket-core/src/test/java/org/apache/wicket/ajax/form/AjaxFormSubmitTest.java",0,0.643835616438356,1,5,6
"wicket-core/src/test/java/org/apache/wicket/ajax/form/AjaxFormSubmitTestPage.java",0,0.827956989247312,1,3,4
"wicket-core/src/test/java/org/apache/wicket/ajax/form/HomePage.java",0,1,0,1,1
"wicket-core/src/test/java/org/apache/wicket/ajax/form/OnChangeAjaxBehaviorTest.java",0,0.532258064516129,2,3,5
"wicket-core/src/test/java/org/apache/wicket/ajax/form/OnChangeAjaxBehaviorTestPage.java",0,0.805970149253731,1,3,4
"wicket-core/src/test/java/org/apache/wicket/ajax/form/SecondPage.java",0,1,0,1,1
"wicket-core/src/test/java/org/apache/wicket/ajax/form/ThirdPage.java",0,1,0,1,1
"wicket-core/src/test/java/org/apache/wicket/ajax/markup/html/ajaxLink/AjaxLinkPage.java",0,0.603174603174603,1,4,5
"wicket-core/src/test/java/org/apache/wicket/ajax/markup/html/ajaxLink/AjaxLinkPageToNormalPage.java",0,0.914893617021277,0,2,2
"wicket-core/src/test/java/org/apache/wicket/ajax/markup/html/ajaxLink/AjaxLinkTest.java",0,0.290598290598291,2,5,7
"wicket-core/src/test/java/org/apache/wicket/ajax/markup/html/ajaxLink/AjaxLinkWithBorderPage.java",0,0.582089552238806,2,4,6
"wicket-core/src/test/java/org/apache/wicket/ajax/markup/html/ajaxLink/AjaxPage2.java",0,0.545454545454545,1,4,5
"wicket-core/src/test/java/org/apache/wicket/ajax/markup/html/ajaxLink/AjaxTestBorder.java",0,0.567567567567568,1,3,4
"wicket-core/src/test/java/org/apache/wicket/ajax/markup/html/ajaxLink/NormalPage.java",0,0.941176470588235,2,1,3
"wicket-core/src/test/java/org/apache/wicket/ajax/markup/html/componentMap/SimpleTestPage.java",0,0.555555555555556,1,3,4
"wicket-core/src/test/java/org/apache/wicket/ajax/markup/html/componentMap/SimpleTestPanel.java",0,0.691176470588235,2,3,5
"wicket-core/src/test/java/org/apache/wicket/ajax/markup/html/componentMap/SimpleTestPanelBase.java",0,0.627906976744186,0,3,3
"wicket-core/src/test/java/org/apache/wicket/ajax/markup/html/componentMap/SimpleTestPanelTest.java",0,0.395833333333333,3,5,8
"wicket-core/src/test/java/org/apache/wicket/ajax/markup/html/form/AjaxButtonTest.java",0,0.7,0,3,3
"wicket-core/src/test/java/org/apache/wicket/ajax/markup/html/form/HomePage.java",0,0.504950495049505,0,2,2
"wicket-core/src/test/java/org/apache/wicket/behavior/ImmutableBehaviorIdsTest.java",0,0.870646766169154,1,2,3
"wicket-core/src/test/java/org/apache/wicket/intercept/HomePage.java",0,1,0,1,1
"wicket-core/src/test/java/org/apache/wicket/intercept/InterceptDataCleanedAfterReadTest.java",0,1,0,1,1
"wicket-core/src/test/java/org/apache/wicket/intercept/LoginPage.java",0,1,0,1,1
"wicket-core/src/test/java/org/apache/wicket/intercept/MySession.java",0,1,0,1,1
"wicket-core/src/test/java/org/apache/wicket/intercept/SecurePage.java",0,1,0,1,1
"wicket-core/src/test/java/org/apache/wicket/intercept/SuccessPage.java",0,1,0,1,1
"wicket-core/src/test/java/org/apache/wicket/intercept/Wicket4066Application.java",0,1,0,1,1
"wicket-core/src/test/java/org/apache/wicket/markup/ComponentTagAttributeEscapingTest.java",0,0.989690721649485,1,1,2
"wicket-core/src/test/java/org/apache/wicket/markup/Doctype_1.java",0,1,0,1,1
"wicket-core/src/test/java/org/apache/wicket/markup/Doctype_1_InheritedPage.java",0,0.962962962962963,1,1,2
"wicket-core/src/test/java/org/apache/wicket/markup/Doctype_2.java",0,1,0,1,1
"wicket-core/src/test/java/org/apache/wicket/markup/HtmlProblemFinderTest.java",0,0.282608695652174,1,6,7
"wicket-core/src/test/java/org/apache/wicket/markup/IEConditionalCommentsPage.java",0,1,0,1,1
"wicket-core/src/test/java/org/apache/wicket/markup/MarkupCacheTest.java",0,0.495798319327731,2,3,5
"wicket-core/src/test/java/org/apache/wicket/markup/MarkupFragmentTest.java",0,0.876288659793814,0,2,2
"wicket-core/src/test/java/org/apache/wicket/markup/MarkupInheritanceBaseBase_11.java",0,0.511627906976744,2,4,6
"wicket-core/src/test/java/org/apache/wicket/markup/MarkupInheritanceBaseBase_13.java",0,0.971428571428571,1,1,2
"wicket-core/src/test/java/org/apache/wicket/markup/MarkupInheritanceBaseBase_3.java",0,0.540540540540541,0,5,5
"wicket-core/src/test/java/org/apache/wicket/markup/MarkupInheritanceBasePanel_6.java",0,0.634146341463415,0,4,4
"wicket-core/src/test/java/org/apache/wicket/markup/MarkupInheritanceBasePanel_9.java",0,0.658536585365854,0,4,4
"wicket-core/src/test/java/org/apache/wicket/markup/MarkupInheritanceBase_1.java",0,0.588235294117647,1,4,5
"wicket-core/src/test/java/org/apache/wicket/markup/MarkupInheritanceBase_10.java",0,0.511627906976744,2,4,6
"wicket-core/src/test/java/org/apache/wicket/markup/MarkupInheritanceBase_11.java",0,0.594594594594595,0,4,4
"wicket-core/src/test/java/org/apache/wicket/markup/MarkupInheritanceBase_12.java",0,0.736111111111111,1,4,5
"wicket-core/src/test/java/org/apache/wicket/markup/MarkupInheritanceBase_13.java",0,1,0,1,1
"wicket-core/src/test/java/org/apache/wicket/markup/MarkupInheritanceBase_2.java",0,0.526315789473684,0,5,5
"wicket-core/src/test/java/org/apache/wicket/markup/MarkupInheritanceBase_3.java",0,0.540540540540541,1,4,5
"wicket-core/src/test/java/org/apache/wicket/markup/MarkupInheritanceBase_4.java",0,0.638888888888889,2,4,6
"wicket-core/src/test/java/org/apache/wicket/markup/MarkupInheritanceBase_5.java",0,0.680555555555556,1,4,5
"wicket-core/src/test/java/org/apache/wicket/markup/MarkupInheritanceBase_7.java",0,0.680555555555556,1,4,5
"wicket-core/src/test/java/org/apache/wicket/markup/MarkupInheritanceBase_8.java",0,0.571428571428571,0,5,5
"wicket-core/src/test/java/org/apache/wicket/markup/MarkupInheritanceExtensionPanel_6.java",0,0.538461538461538,0,4,4
"wicket-core/src/test/java/org/apache/wicket/markup/MarkupInheritanceExtensionPanel_9.java",0,0.58974358974359,0,4,4
"wicket-core/src/test/java/org/apache/wicket/markup/MarkupInheritanceExtension_1.java",0,0.588235294117647,1,4,5
"wicket-core/src/test/java/org/apache/wicket/markup/MarkupInheritanceExtension_10.java",0,0.605263157894737,0,4,4
"wicket-core/src/test/java/org/apache/wicket/markup/MarkupInheritanceExtension_11.java",0,0.605263157894737,0,4,4
"wicket-core/src/test/java/org/apache/wicket/markup/MarkupInheritanceExtension_12.java",0,0.638888888888889,0,4,4
"wicket-core/src/test/java/org/apache/wicket/markup/MarkupInheritanceExtension_13.java",0,1,0,1,1
"wicket-core/src/test/java/org/apache/wicket/markup/MarkupInheritanceExtension_2.java",0,0.526315789473684,1,4,5
"wicket-core/src/test/java/org/apache/wicket/markup/MarkupInheritanceExtension_3.java",0,0.571428571428571,1,4,5
"wicket-core/src/test/java/org/apache/wicket/markup/MarkupInheritanceExtension_4.java",0,0.540540540540541,1,4,5
"wicket-core/src/test/java/org/apache/wicket/markup/MarkupInheritanceExtension_5.java",0,0.555555555555556,1,4,5
"wicket-core/src/test/java/org/apache/wicket/markup/MarkupInheritanceExtension_7.java",0,0.540540540540541,1,4,5
"wicket-core/src/test/java/org/apache/wicket/markup/MarkupInheritanceExtension_8.java",0,0.606060606060606,1,4,5
"wicket-core/src/test/java/org/apache/wicket/markup/MarkupInheritancePage_6.java",0,0.611111111111111,1,4,5
"wicket-core/src/test/java/org/apache/wicket/markup/MarkupInheritancePage_9.java",0,0.638888888888889,1,4,5
"wicket-core/src/test/java/org/apache/wicket/markup/MarkupInheritanceTest.java",0,0.520833333333333,4,5,9
"wicket-core/src/test/java/org/apache/wicket/markup/MarkupParserTest.java",0,0.684451219512195,7,2,9
"wicket-core/src/test/java/org/apache/wicket/markup/MarkupVariationTest.java",0,1,0,1,1
"wicket-core/src/test/java/org/apache/wicket/markup/MyComponent.java",0,0.702247191011236,2,3,5
"wicket-core/src/test/java/org/apache/wicket/markup/MyLabel.java",0,0.546666666666667,2,3,5
"wicket-core/src/test/java/org/apache/wicket/markup/MyTable.java",0,0.357142857142857,1,5,6
"wicket-core/src/test/java/org/apache/wicket/markup/RefreshingViewOnRemoveTest.java",0,0.922619047619048,1,2,3
"wicket-core/src/test/java/org/apache/wicket/markup/WicketNamespaceTest.java",0,0.612903225806452,3,3,6
"wicket-core/src/test/java/org/apache/wicket/markup/WicketNamespace_1.java",0,0.55,0,5,5
"wicket-core/src/test/java/org/apache/wicket/markup/WicketNamespace_2.java",0,0.55,0,5,5
"wicket-core/src/test/java/org/apache/wicket/markup/WicketNamespace_3.java",0,0.55,0,5,5
"wicket-core/src/test/java/org/apache/wicket/markup/WicketNamespace_4.java",0,0.55,0,5,5
"wicket-core/src/test/java/org/apache/wicket/markup/WicketNamespace_5.java",0,0.55,0,5,5
"wicket-core/src/test/java/org/apache/wicket/markup/WicketNamespace_6.java",0,0.55,0,5,5
"wicket-core/src/test/java/org/apache/wicket/markup/html/ComponentMarkupIdTest.java",0,0.986301369863014,1,1,2
"wicket-core/src/test/java/org/apache/wicket/markup/html/ComponentMarkupIdTestPage.java",0,1,0,1,1
"wicket-core/src/test/java/org/apache/wicket/markup/html/DecoratingHeaderResponseTest.java",0,0.916167664670659,3,1,4
"wicket-core/src/test/java/org/apache/wicket/markup/html/HeaderContributorTest.java",0,1,0,1,1
"wicket-core/src/test/java/org/apache/wicket/markup/html/MarkupHeadFirstTest.java",0,1,0,1,1
"wicket-core/src/test/java/org/apache/wicket/markup/html/MarkupInheritanceResolverTestPage1.java",0,1,0,1,1
"wicket-core/src/test/java/org/apache/wicket/markup/html/MarkupInheritanceResolverTestPage2.java",0,1,0,1,1
"wicket-core/src/test/java/org/apache/wicket/markup/html/MarkupInheritanceResolverTestPage3.java",0,1,0,1,1
"wicket-core/src/test/java/org/apache/wicket/markup/html/PackageResourceTest.java",0,0.270440251572327,3,5,8
"wicket-core/src/test/java/org/apache/wicket/markup/html/SecurePackageResourceGuardTest.java",0,0.808510638297872,0,3,3
"wicket-core/src/test/java/org/apache/wicket/markup/html/TransparentWebMarkupContainerTest.java",0,0.763392857142857,2,2,4
"wicket-core/src/test/java/org/apache/wicket/markup/html/TransparentWithAjaxUpdatePage.java",0,1,0,1,1
"wicket-core/src/test/java/org/apache/wicket/markup/html/TransparentWithAjaxUpdatePanel.java",0,1,0,1,1
"wicket-core/src/test/java/org/apache/wicket/markup/html/WebPageTest.java",0,1,0,1,1
"wicket-core/src/test/java/org/apache/wicket/markup/html/XmlDeclResponseTest.java",0,1,0,1,1
"wicket-core/src/test/java/org/apache/wicket/markup/html/autolink/AutolinkTest.java",0,0.657534246575342,1,4,5
"wicket-core/src/test/java/org/apache/wicket/markup/html/autolink/BasePage.java",0,0.514285714285714,2,3,5
"wicket-core/src/test/java/org/apache/wicket/markup/html/autolink/Index.java",0,0.948717948717949,2,1,3
"wicket-core/src/test/java/org/apache/wicket/markup/html/autolink/LinkPanel.java",0,0.953488372093023,1,1,2
"wicket-core/src/test/java/org/apache/wicket/markup/html/autolink/MyPage.java",0,0.588235294117647,1,2,3
"wicket-core/src/test/java/org/apache/wicket/markup/html/autolink/PageA.java",0,0.575757575757576,1,2,3
"wicket-core/src/test/java/org/apache/wicket/markup/html/autolink/QuickStartPage.java",0,0.794871794871795,1,3,4
"wicket-core/src/test/java/org/apache/wicket/markup/html/autolink/SubPage.java",0,1,0,1,1
"wicket-core/src/test/java/org/apache/wicket/markup/html/autolink/sub/BasePage.java",0,0.514285714285714,2,3,5
"wicket-core/src/test/java/org/apache/wicket/markup/html/autolink/sub/PageB.java",0,0.588235294117647,1,2,3
"wicket-core/src/test/java/org/apache/wicket/markup/html/basic/HomePageClassRedirect.java",0,0.611111111111111,1,3,4
"wicket-core/src/test/java/org/apache/wicket/markup/html/basic/HomePagePageRedirect.java",0,0.527777777777778,1,4,5
"wicket-core/src/test/java/org/apache/wicket/markup/html/basic/HomePageRedirectTest.java",0,0.547169811320755,2,3,5
"wicket-core/src/test/java/org/apache/wicket/markup/html/basic/LabelTest.java",0,0.588235294117647,2,3,5
"wicket-core/src/test/java/org/apache/wicket/markup/html/basic/LabelWithEscapeMarkupPage.java",0,0.609756097560976,2,2,4
"wicket-core/src/test/java/org/apache/wicket/markup/html/basic/LabelWithoutEscapeMarkupPage.java",0,0.609756097560976,2,2,4
"wicket-core/src/test/java/org/apache/wicket/markup/html/basic/RedirectPage.java",0,0.628571428571429,2,2,4
"wicket-core/src/test/java/org/apache/wicket/markup/html/basic/SimpleBorder.java",0,0.585365853658537,0,4,4
"wicket-core/src/test/java/org/apache/wicket/markup/html/basic/SimplePage.java",0,0.423728813559322,2,4,6
"wicket-core/src/test/java/org/apache/wicket/markup/html/basic/SimplePageTest.java",0,0.564516129032258,4,4,8
"wicket-core/src/test/java/org/apache/wicket/markup/html/basic/SimplePage_10.java",0,0.525,0,4,4
"wicket-core/src/test/java/org/apache/wicket/markup/html/basic/SimplePage_11.java",0,0.659574468085106,2,2,4
"wicket-core/src/test/java/org/apache/wicket/markup/html/basic/SimplePage_12.java",0,0.538461538461538,0,4,4
"wicket-core/src/test/java/org/apache/wicket/markup/html/basic/SimplePage_13.java",0,0.819672131147541,1,2,3
"wicket-core/src/test/java/org/apache/wicket/markup/html/basic/SimplePage_14.java",0,0.931818181818182,3,1,4
"wicket-core/src/test/java/org/apache/wicket/markup/html/basic/SimplePage_15.java",0,0.864864864864865,0,2,2
"wicket-core/src/test/java/org/apache/wicket/markup/html/basic/SimplePage_16.java",0,0.989247311827957,1,1,2
"wicket-core/src/test/java/org/apache/wicket/markup/html/basic/SimplePage_3.java",0,0.684210526315789,1,3,4
"wicket-core/src/test/java/org/apache/wicket/markup/html/basic/SimplePage_4.java",0,0.621621621621622,1,4,5
"wicket-core/src/test/java/org/apache/wicket/markup/html/basic/SimplePage_5.java",0,0.459459459459459,0,4,4
"wicket-core/src/test/java/org/apache/wicket/markup/html/basic/SimplePage_6.java",0,0.6,1,4,5
"wicket-core/src/test/java/org/apache/wicket/markup/html/basic/SimplePage_7.java",0,0.704545454545455,2,3,5
"wicket-core/src/test/java/org/apache/wicket/markup/html/basic/SimplePage_8.java",0,0.666666666666667,1,4,5
"wicket-core/src/test/java/org/apache/wicket/markup/html/basic/SimplePage_9.java",0,0.758620689655172,1,4,5
"wicket-core/src/test/java/org/apache/wicket/markup/html/basic/SimplePanel.java",0,0.558139534883721,0,4,4
"wicket-core/src/test/java/org/apache/wicket/markup/html/basic/SimplePanel_6.java",0,0.604651162790698,0,4,4
"wicket-core/src/test/java/org/apache/wicket/markup/html/basic/SimpleResponsePageClass.java",0,0.346938775510204,3,3,6
"wicket-core/src/test/java/org/apache/wicket/markup/html/basic/SimpleResponsePageClassTest.java",0,0.377777777777778,1,5,6
"wicket-core/src/test/java/org/apache/wicket/markup/html/basic/XmlBasePage.java",0,1,0,1,1
"wicket-core/src/test/java/org/apache/wicket/markup/html/basic/XmlPageTest.java",0,0.896551724137931,1,2,3
"wicket-core/src/test/java/org/apache/wicket/markup/html/basic/XmlPage_1.java",0,1,0,1,1
"wicket-core/src/test/java/org/apache/wicket/markup/html/basic/XmlPage_2.java",0,1,0,1,1
"wicket-core/src/test/java/org/apache/wicket/markup/html/basic/XmlPage_3.java",0,1,0,1,1
"wicket-core/src/test/java/org/apache/wicket/markup/html/border/BorderComponent1.java",0,0.527777777777778,0,3,3
"wicket-core/src/test/java/org/apache/wicket/markup/html/border/BorderComponent2.java",0,0.527777777777778,0,3,3
"wicket-core/src/test/java/org/apache/wicket/markup/html/border/BorderRenderWrappedTestPage_1.java",0,0.386363636363636,0,5,5
"wicket-core/src/test/java/org/apache/wicket/markup/html/border/BorderTestHierarchyPage_4.java",0,0.595238095238095,1,3,4
"wicket-core/src/test/java/org/apache/wicket/markup/html/border/BoxBorderTest.java",0,0.76303317535545,4,4,8
"wicket-core/src/test/java/org/apache/wicket/markup/html/border/BoxBorderTestPage_1.java",0,0.609756097560976,1,4,5
"wicket-core/src/test/java/org/apache/wicket/markup/html/border/BoxBorderTestPage_10.java",0,0.975,1,1,2
"wicket-core/src/test/java/org/apache/wicket/markup/html/border/BoxBorderTestPage_11.java",0,0.977272727272727,1,1,2
"wicket-core/src/test/java/org/apache/wicket/markup/html/border/BoxBorderTestPage_2.java",0,0.6,1,4,5
"wicket-core/src/test/java/org/apache/wicket/markup/html/border/BoxBorderTestPage_3.java",0,0.583333333333333,1,4,5
"wicket-core/src/test/java/org/apache/wicket/markup/html/border/BoxBorderTestPage_5.java",0,0.717948717948718,2,3,5
"wicket-core/src/test/java/org/apache/wicket/markup/html/border/BoxBorderTestPage_6.java",0,0.720930232558139,3,2,5
"wicket-core/src/test/java/org/apache/wicket/markup/html/border/BoxBorderTestPage_7.java",0,0.926829268292683,2,1,3
"wicket-core/src/test/java/org/apache/wicket/markup/html/border/BoxBorderTestPage_8.java",0,0.909090909090909,0,2,2
"wicket-core/src/test/java/org/apache/wicket/markup/html/border/BoxBorderTestPage_9.java",0,0.909090909090909,0,2,2
"wicket-core/src/test/java/org/apache/wicket/markup/html/border/ComponentBorderTest.java",0,0.378048780487805,1,4,5
"wicket-core/src/test/java/org/apache/wicket/markup/html/border/FormBorder.java",0,0.677966101694915,2,3,5
"wicket-core/src/test/java/org/apache/wicket/markup/html/border/HideableBorder.java",0,0.590361445783133,1,2,3
"wicket-core/src/test/java/org/apache/wicket/markup/html/border/HideableBorderPage.java",0,0.717391304347826,0,2,2
"wicket-core/src/test/java/org/apache/wicket/markup/html/border/MyApplicationBorder.java",0,0.575,2,3,5
"wicket-core/src/test/java/org/apache/wicket/markup/html/border/TogglePanel.java",0,0.983333333333333,1,1,2
"wicket-core/src/test/java/org/apache/wicket/markup/html/debug/WicketComponentTreeTest.java",0,0.444444444444444,4,4,8
"wicket-core/src/test/java/org/apache/wicket/markup/html/debug/WicketComponentTreeTestPage.java",0,0.531914893617021,1,5,6
"wicket-core/src/test/java/org/apache/wicket/markup/html/form/AbstractCheckGroupTestPage.java",0,0.467741935483871,2,4,6
"wicket-core/src/test/java/org/apache/wicket/markup/html/form/AbstractTextComponentConvertEmptyStringsToNullTest.java",0,0.638888888888889,0,3,3
"wicket-core/src/test/java/org/apache/wicket/markup/html/form/AutoFormLabelPickupTest.java",0,0.919753086419753,0,2,2
"wicket-core/src/test/java/org/apache/wicket/markup/html/form/AutoLabelTest.java",0,0.862068965517241,1,2,3
"wicket-core/src/test/java/org/apache/wicket/markup/html/form/AutoLabelWithContentTest.java",0,0.880597014925373,0,2,2
"wicket-core/src/test/java/org/apache/wicket/markup/html/form/AutoLabelWithinEnclosureTest.java",0,0.915254237288136,0,2,2
"wicket-core/src/test/java/org/apache/wicket/markup/html/form/CheckBoxMultipleChoiceTest.java",0,0.871621621621622,0,2,2
"wicket-core/src/test/java/org/apache/wicket/markup/html/form/CheckGroupDisabledTestPage.java",0,0.350877192982456,1,5,6
"wicket-core/src/test/java/org/apache/wicket/markup/html/form/CheckGroupTest.java",0,0.64,4,4,8
"wicket-core/src/test/java/org/apache/wicket/markup/html/form/CheckGroupTestPage1.java",0,0.552631578947368,1,3,4
"wicket-core/src/test/java/org/apache/wicket/markup/html/form/CheckGroupTestPage2.java",0,0.634146341463415,2,2,4
"wicket-core/src/test/java/org/apache/wicket/markup/html/form/CheckGroupTestPage3.java",0,0.634146341463415,2,2,4
"wicket-core/src/test/java/org/apache/wicket/markup/html/form/CheckGroupTestPage4.java",0,0.634146341463415,2,2,4
"wicket-core/src/test/java/org/apache/wicket/markup/html/form/CheckGroupTestPage5.java",0,0.596774193548387,1,4,5
"wicket-core/src/test/java/org/apache/wicket/markup/html/form/DisabledItemRetainingCheckBoxTest.java",0,0.699346405228758,0,3,3
"wicket-core/src/test/java/org/apache/wicket/markup/html/form/DropDownChoiceTest.java",0,0.465909090909091,0,3,3
"wicket-core/src/test/java/org/apache/wicket/markup/html/form/DropDownChoiceTestPage.java",0,0.773584905660377,0,2,2
"wicket-core/src/test/java/org/apache/wicket/markup/html/form/EnumChoiceRendererTest.java",0,0.92156862745098,0,2,2
"wicket-core/src/test/java/org/apache/wicket/markup/html/form/FormComponentPanelProcessingTest.java",0,0.915492957746479,1,2,3
"wicket-core/src/test/java/org/apache/wicket/markup/html/form/FormComponentTest.java",0,0.866071428571429,0,2,2
"wicket-core/src/test/java/org/apache/wicket/markup/html/form/FormHasErrorPage.java",0,0.983606557377049,1,1,2
"wicket-core/src/test/java/org/apache/wicket/markup/html/form/FormMethodTestPage.java",0,0.851063829787234,3,2,5
"wicket-core/src/test/java/org/apache/wicket/markup/html/form/FormParentDisabledRawInputTest.java",0,0.734177215189873,0,3,3
"wicket-core/src/test/java/org/apache/wicket/markup/html/form/FormSubmitTest.java",0,0.794019933554817,0,3,3
"wicket-core/src/test/java/org/apache/wicket/markup/html/form/FormTest.java",0,0.408536585365854,3,4,7
"wicket-core/src/test/java/org/apache/wicket/markup/html/form/FormWithMultipleButtonsTest.java",0,0.823943661971831,0,3,3
"wicket-core/src/test/java/org/apache/wicket/markup/html/form/LocalizedErrorMessageTest.java",0,0.454545454545455,2,4,6
"wicket-core/src/test/java/org/apache/wicket/markup/html/form/LocalizedMessagePage.java",0,0.41304347826087,1,3,4
"wicket-core/src/test/java/org/apache/wicket/markup/html/form/NestedFormsPage.java",0,0.942675159235669,2,1,3
"wicket-core/src/test/java/org/apache/wicket/markup/html/form/NestedFormsTest.java",0,0.965753424657534,1,1,2
"wicket-core/src/test/java/org/apache/wicket/markup/html/form/PrimitiveTypeRequiredTest.java",0,0.428571428571429,1,5,6
"wicket-core/src/test/java/org/apache/wicket/markup/html/form/RadioGroupDisabledTestPage.java",0,0.421052631578947,1,5,6
"wicket-core/src/test/java/org/apache/wicket/markup/html/form/RadioGroupTest.java",0,0.609243697478992,4,5,9
"wicket-core/src/test/java/org/apache/wicket/markup/html/form/RadioGroupTestPage1.java",0,0.481481481481481,0,5,5
"wicket-core/src/test/java/org/apache/wicket/markup/html/form/RadioGroupTestPage2.java",0,0.625,0,4,4
"wicket-core/src/test/java/org/apache/wicket/markup/html/form/RadioGroupTestPage3.java",0,0.465116279069767,2,3,5
"wicket-core/src/test/java/org/apache/wicket/markup/html/form/TestFormHasError.java",0,0.96551724137931,1,1,2
"wicket-core/src/test/java/org/apache/wicket/markup/html/form/TextFieldTest.java",0,0.682352941176471,0,3,3
"wicket-core/src/test/java/org/apache/wicket/markup/html/form/ValidatorPropertiesTest.java",0,0.633699633699634,4,3,7
"wicket-core/src/test/java/org/apache/wicket/markup/html/form/border/CommonBorder.java",0,1,0,1,1
"wicket-core/src/test/java/org/apache/wicket/markup/html/form/border/CommonModelPage.java",0,0.976190476190476,1,1,2
"wicket-core/src/test/java/org/apache/wicket/markup/html/form/border/HomePage.java",0,0.920454545454545,0,2,2
"wicket-core/src/test/java/org/apache/wicket/markup/html/form/border/MyBorder.java",0,0.885245901639344,0,2,2
"wicket-core/src/test/java/org/apache/wicket/markup/html/form/border/MyDateField.java",0,1,0,1,1
"wicket-core/src/test/java/org/apache/wicket/markup/html/form/border/MyTextField.java",0,1,0,1,1
"wicket-core/src/test/java/org/apache/wicket/markup/html/form/border/TestHomePage.java",0,0.890243902439024,1,2,3
"wicket-core/src/test/java/org/apache/wicket/markup/html/form/border/TestHomePage_2134.java",0,0.977011494252874,1,1,2
"wicket-core/src/test/java/org/apache/wicket/markup/html/form/encryption/CryptTest.java",0,0.402777777777778,3,5,8
"wicket-core/src/test/java/org/apache/wicket/markup/html/form/feedback/FeedbackFormPage.java",0,0.888888888888889,2,2,4
"wicket-core/src/test/java/org/apache/wicket/markup/html/form/feedback/FeedbackIndicatorFormPage.java",0,0.864406779661017,1,3,4
"wicket-core/src/test/java/org/apache/wicket/markup/html/form/feedback/FormFeedbackTest.java",0,0.912280701754386,0,2,2
"wicket-core/src/test/java/org/apache/wicket/markup/html/form/formComponentPanel/MyFormComponentPanel.java",0,0.830188679245283,0,2,2
"wicket-core/src/test/java/org/apache/wicket/markup/html/form/formComponentPanel/SimplePageTest.java",0,0.666666666666667,0,2,2
"wicket-core/src/test/java/org/apache/wicket/markup/html/form/imagebutton/Home.java",0,0.945945945945946,0,2,2
"wicket-core/src/test/java/org/apache/wicket/markup/html/form/imagebutton/ImageButtonTest.java",0,0.948275862068966,0,2,2
"wicket-core/src/test/java/org/apache/wicket/markup/html/form/imagebutton/InvalidImageButtonPage.java",0,0.82051282051282,2,2,4
"wicket-core/src/test/java/org/apache/wicket/markup/html/form/imagebutton/InvalidImageButtonTest.java",0,0.783783783783784,0,3,3
"wicket-core/src/test/java/org/apache/wicket/markup/html/form/imagebutton/PubApplication.java",0,0.933333333333333,3,1,4
"wicket-core/src/test/java/org/apache/wicket/markup/html/form/login/InterceptTest.java",0,0.530232558139535,4,5,9
"wicket-core/src/test/java/org/apache/wicket/markup/html/form/login/MockHomePage.java",0,0.589285714285714,1,3,4
"wicket-core/src/test/java/org/apache/wicket/markup/html/form/login/MockLoginPage.java",0,0.622448979591837,1,4,5
"wicket-core/src/test/java/org/apache/wicket/markup/html/form/login/PageA.java",0,0.527777777777778,1,3,4
"wicket-core/src/test/java/org/apache/wicket/markup/html/form/panelBorder/CommonBorder.java",0,1,0,1,1
"wicket-core/src/test/java/org/apache/wicket/markup/html/form/panelBorder/CommonModelPage.java",0,1,0,1,1
"wicket-core/src/test/java/org/apache/wicket/markup/html/form/panelBorder/HomePage.java",0,1,0,1,1
"wicket-core/src/test/java/org/apache/wicket/markup/html/form/panelBorder/MyBorder.java",0,1,0,1,1
"wicket-core/src/test/java/org/apache/wicket/markup/html/form/panelBorder/MyDateField.java",0,1,0,1,1
"wicket-core/src/test/java/org/apache/wicket/markup/html/form/panelBorder/MyTextField.java",0,1,0,1,1
"wicket-core/src/test/java/org/apache/wicket/markup/html/form/panelBorder/TestHomePage.java",0,1,0,1,1
"wicket-core/src/test/java/org/apache/wicket/markup/html/form/panelBorder/TestHomePage_2134.java",0,1,0,1,1
"wicket-core/src/test/java/org/apache/wicket/markup/html/form/submitlink/HomePage.java",0,0.794392523364486,1,2,3
"wicket-core/src/test/java/org/apache/wicket/markup/html/form/submitlink/TestHomePage.java",0,0.783783783783784,3,2,5
"wicket-core/src/test/java/org/apache/wicket/markup/html/form/upload/FileUploadError.java",0,0.975903614457831,1,1,2
"wicket-core/src/test/java/org/apache/wicket/markup/html/form/upload/FileUploadFieldTest.java",0,0.286324786324786,5,5,10
"wicket-core/src/test/java/org/apache/wicket/markup/html/form/upload/FileUploadTest.java",0,0.418439716312057,3,4,7
"wicket-core/src/test/java/org/apache/wicket/markup/html/form/upload/MockPageWithFormAndUploadField.java",0,0.460674157303371,5,3,8
"wicket-core/src/test/java/org/apache/wicket/markup/html/form/upload/TestFileUploadError.java",0,0.888198757763975,3,1,4
"wicket-core/src/test/java/org/apache/wicket/markup/html/form/validation/FormValidatorBehaviorTest.java",0,0.857142857142857,1,2,3
"wicket-core/src/test/java/org/apache/wicket/markup/html/form/validation/HereIsTheBug.java",0,0.971428571428571,1,1,2
"wicket-core/src/test/java/org/apache/wicket/markup/html/form/validation/HomePage.java",0,0.902298850574713,0,2,2
"wicket-core/src/test/java/org/apache/wicket/markup/html/form/validation/HomePage1.java",0,0.977272727272727,1,1,2
"wicket-core/src/test/java/org/apache/wicket/markup/html/form/validation/HomePageTest.java",0,0.833333333333333,1,2,3
"wicket-core/src/test/java/org/apache/wicket/markup/html/form/validation/MyBorder.java",0,0.963414634146341,1,1,2
"wicket-core/src/test/java/org/apache/wicket/markup/html/form/validation/MyPanel.java",0,1,0,1,1
"wicket-core/src/test/java/org/apache/wicket/markup/html/form/validation/innerfeedback/BasePage.java",0,0.851851851851852,0,2,2
"wicket-core/src/test/java/org/apache/wicket/markup/html/form/validation/innerfeedback/HomePage.java",0,0.984375,1,1,2
"wicket-core/src/test/java/org/apache/wicket/markup/html/form/validation/innerfeedback/InnerFeedbackTest.java",0,0.877777777777778,0,3,3
"wicket-core/src/test/java/org/apache/wicket/markup/html/form/validation/innerfeedback/LocalizedFeedbackBorder.java",0,0.96875,2,1,3
"wicket-core/src/test/java/org/apache/wicket/markup/html/header/BasePanel.java",0,0.578947368421053,1,3,4
"wicket-core/src/test/java/org/apache/wicket/markup/html/header/HeaderScopingTest.java",0,0.574468085106383,1,3,4
"wicket-core/src/test/java/org/apache/wicket/markup/html/header/MyPage.java",0,0.567567567567568,1,3,4
"wicket-core/src/test/java/org/apache/wicket/markup/html/header/MyPage2.java",0,0.790697674418605,0,2,2
"wicket-core/src/test/java/org/apache/wicket/markup/html/header/PanelA.java",0,0.555555555555556,1,3,4
"wicket-core/src/test/java/org/apache/wicket/markup/html/header/PanelB.java",0,0.611111111111111,1,2,3
"wicket-core/src/test/java/org/apache/wicket/markup/html/header/inheritance/AbstractPage.java",0,0.551724137931034,1,3,4
"wicket-core/src/test/java/org/apache/wicket/markup/html/header/inheritance/ConcretePage2.java",0,0.558823529411765,0,3,3
"wicket-core/src/test/java/org/apache/wicket/markup/html/header/inheritance/InheritanceHeadTest.java",0,0.52,2,4,6
"wicket-core/src/test/java/org/apache/wicket/markup/html/header/inheritance/MyPanel.java",0,0.536585365853659,0,3,3
"wicket-core/src/test/java/org/apache/wicket/markup/html/header/inheritance/MyPanel2.java",0,0.609756097560976,0,3,3
"wicket-core/src/test/java/org/apache/wicket/markup/html/header/testing/HeaderTest.java",0,0.540540540540541,0,4,4
"wicket-core/src/test/java/org/apache/wicket/markup/html/header/testing/TestBasePanel.java",0,0.555555555555556,1,3,4
"wicket-core/src/test/java/org/apache/wicket/markup/html/header/testing/TestExtendedPanel.java",0,0.575757575757576,1,2,3
"wicket-core/src/test/java/org/apache/wicket/markup/html/header/testing/TestPage.java",0,0.555555555555556,1,3,4
"wicket-core/src/test/java/org/apache/wicket/markup/html/header/testing2/HeaderTest.java",0,0.617021276595745,1,3,4
"wicket-core/src/test/java/org/apache/wicket/markup/html/header/testing2/TestBasePage.java",0,0.542857142857143,1,3,4
"wicket-core/src/test/java/org/apache/wicket/markup/html/header/testing2/TestExtendedPage.java",0,0.575757575757576,1,2,3
"wicket-core/src/test/java/org/apache/wicket/markup/html/header/testing2/TestExtendedPage2.java",0,0.575757575757576,1,2,3
"wicket-core/src/test/java/org/apache/wicket/markup/html/header/testing3/HeaderTest.java",0,0.51219512195122,4,2,6
"wicket-core/src/test/java/org/apache/wicket/markup/html/header/testing3/Panel1.java",0,0.605263157894737,0,3,3
"wicket-core/src/test/java/org/apache/wicket/markup/html/header/testing3/Panel2.java",0,0.605263157894737,0,3,3
"wicket-core/src/test/java/org/apache/wicket/markup/html/header/testing3/TestPage.java",0,0.609375,2,3,5
"wicket-core/src/test/java/org/apache/wicket/markup/html/header/threelayers/AbstractBasePage.java",0,0.542857142857143,1,3,4
"wicket-core/src/test/java/org/apache/wicket/markup/html/header/threelayers/AbstractMeldingPage.java",0,0.583333333333333,0,3,3
"wicket-core/src/test/java/org/apache/wicket/markup/html/header/threelayers/AbstractSecurePage.java",0,0.5,0,3,3
"wicket-core/src/test/java/org/apache/wicket/markup/html/header/threelayers/InheritanceHeadTest.java",0,0.526315789473684,1,4,5
"wicket-core/src/test/java/org/apache/wicket/markup/html/header/threelayers/MeldingPage.java",0,0.484848484848485,1,2,3
"wicket-core/src/test/java/org/apache/wicket/markup/html/header/threelayers2/AbstractBasePage.java",0,0.542857142857143,1,3,4
"wicket-core/src/test/java/org/apache/wicket/markup/html/header/threelayers2/AbstractMeldingPage.java",0,0.583333333333333,0,3,3
"wicket-core/src/test/java/org/apache/wicket/markup/html/header/threelayers2/AbstractSecurePage.java",0,0.5,0,3,3
"wicket-core/src/test/java/org/apache/wicket/markup/html/header/threelayers2/InheritanceHeadTest.java",0,0.526315789473684,1,4,5
"wicket-core/src/test/java/org/apache/wicket/markup/html/header/threelayers2/MeldingPage.java",0,0.484848484848485,1,2,3
"wicket-core/src/test/java/org/apache/wicket/markup/html/image/AjaxUpdatedImageTest.java",0,0.980769230769231,1,1,2
"wicket-core/src/test/java/org/apache/wicket/markup/html/image/AjaxyImagesPage.java",0,0.818181818181818,0,2,2
"wicket-core/src/test/java/org/apache/wicket/markup/html/image/Home.java",0,0.9,0,2,2
"wicket-core/src/test/java/org/apache/wicket/markup/html/image/ImageTest.java",0,0.742424242424242,1,3,4
"wicket-core/src/test/java/org/apache/wicket/markup/html/image/InvalidImagePage.java",0,0.815789473684211,2,2,4
"wicket-core/src/test/java/org/apache/wicket/markup/html/image/InvalidImageTest.java",0,0.783783783783784,0,3,3
"wicket-core/src/test/java/org/apache/wicket/markup/html/image/PubApplication.java",0,0.955555555555556,2,1,3
"wicket-core/src/test/java/org/apache/wicket/markup/html/internal/AjaxEnclosurePage_1.java",0,1,0,1,1
"wicket-core/src/test/java/org/apache/wicket/markup/html/internal/AjaxEnclosurePage_2.java",0,1,0,1,1
"wicket-core/src/test/java/org/apache/wicket/markup/html/internal/AjaxEnclosurePage_3.java",0,1,0,1,1
"wicket-core/src/test/java/org/apache/wicket/markup/html/internal/AjaxEnclosureTest.java",0,0.955479452054795,2,1,3
"wicket-core/src/test/java/org/apache/wicket/markup/html/internal/ChildWithDeeperPathInTransparentContainerPage.java",0,1,0,1,1
"wicket-core/src/test/java/org/apache/wicket/markup/html/internal/ComponentResolvingPage.java",0,0.558823529411765,2,4,6
"wicket-core/src/test/java/org/apache/wicket/markup/html/internal/EnclosurePage_1.java",0,0.98,1,1,2
"wicket-core/src/test/java/org/apache/wicket/markup/html/internal/EnclosurePage_10.java",0,1,0,1,1
"wicket-core/src/test/java/org/apache/wicket/markup/html/internal/EnclosurePage_11.java",0,0.962962962962963,1,1,2
"wicket-core/src/test/java/org/apache/wicket/markup/html/internal/EnclosurePage_12.java",0,1,0,1,1
"wicket-core/src/test/java/org/apache/wicket/markup/html/internal/EnclosurePage_13.java",0,1,0,1,1
"wicket-core/src/test/java/org/apache/wicket/markup/html/internal/EnclosurePage_2.java",0,0.979166666666667,1,1,2
"wicket-core/src/test/java/org/apache/wicket/markup/html/internal/EnclosurePage_3.java",0,0.96078431372549,1,1,2
"wicket-core/src/test/java/org/apache/wicket/markup/html/internal/EnclosurePage_4.java",0,0.938775510204082,0,2,2
"wicket-core/src/test/java/org/apache/wicket/markup/html/internal/EnclosurePage_5.java",0,0.958333333333333,1,1,2
"wicket-core/src/test/java/org/apache/wicket/markup/html/internal/EnclosurePage_5_Base.java",0,0.972222222222222,1,1,2
"wicket-core/src/test/java/org/apache/wicket/markup/html/internal/EnclosurePage_6.java",0,0.983870967741935,1,1,2
"wicket-core/src/test/java/org/apache/wicket/markup/html/internal/EnclosurePage_7.java",0,1,0,1,1
"wicket-core/src/test/java/org/apache/wicket/markup/html/internal/EnclosurePage_8.java",0,0.891304347826087,0,2,2
"wicket-core/src/test/java/org/apache/wicket/markup/html/internal/EnclosurePage_9.java",0,1,0,1,1
"wicket-core/src/test/java/org/apache/wicket/markup/html/internal/EnclosureTest.java",0,0.595744680851064,2,4,6
"wicket-core/src/test/java/org/apache/wicket/markup/html/internal/FullReloadPage.java",0,1,0,1,1
"wicket-core/src/test/java/org/apache/wicket/markup/html/internal/HeaderResponseTest.java",0,0.994791666666667,1,1,2
"wicket-core/src/test/java/org/apache/wicket/markup/html/internal/HtmlHeaderContainerTest.java",0,0.452380952380952,2,4,6
"wicket-core/src/test/java/org/apache/wicket/markup/html/internal/InlineEnclosureAjaxPage.java",0,1,0,1,1
"wicket-core/src/test/java/org/apache/wicket/markup/html/internal/InlineEnclosurePage_1.java",0,1,0,1,1
"wicket-core/src/test/java/org/apache/wicket/markup/html/internal/InlineEnclosurePage_2.java",0,1,0,1,1
"wicket-core/src/test/java/org/apache/wicket/markup/html/internal/InlineEnclosurePanelPage.java",0,1,0,1,1
"wicket-core/src/test/java/org/apache/wicket/markup/html/internal/InlineEnclosureTest.java",0,0.860759493670886,0,2,2
"wicket-core/src/test/java/org/apache/wicket/markup/html/internal/InlineEnclosureWithAdditionalAjaxTargetPage.java",0,1,0,1,1
"wicket-core/src/test/java/org/apache/wicket/markup/html/internal/MyBorder.java",0,1,0,1,1
"wicket-core/src/test/java/org/apache/wicket/markup/html/internal/SecuredContainer_13.java",0,1,0,1,1
"wicket-core/src/test/java/org/apache/wicket/markup/html/internal/SimplePanel.java",0,1,0,1,1
"wicket-core/src/test/java/org/apache/wicket/markup/html/internal/SimplePanel2.java",0,1,0,1,1
"wicket-core/src/test/java/org/apache/wicket/markup/html/internal/TogglePageTest.java",0,0.97787610619469,2,1,3
"wicket-core/src/test/java/org/apache/wicket/markup/html/internal/TraditionalEnclosureAjaxPage.java",0,1,0,1,1
"wicket-core/src/test/java/org/apache/wicket/markup/html/link/AbstractLinkTest.java",0,1,0,1,1
"wicket-core/src/test/java/org/apache/wicket/markup/html/link/AutolinkPage_1.java",0,0.534883720930233,1,4,5
"wicket-core/src/test/java/org/apache/wicket/markup/html/link/AutolinkPage_2.java",0,0.534883720930233,1,4,5
"wicket-core/src/test/java/org/apache/wicket/markup/html/link/AutolinkPage_3.java",0,0.631578947368421,1,4,5
"wicket-core/src/test/java/org/apache/wicket/markup/html/link/AutolinkPage_4.java",0,0.473684210526316,0,4,4
"wicket-core/src/test/java/org/apache/wicket/markup/html/link/AutolinkTest.java",0,0.549295774647887,1,4,5
"wicket-core/src/test/java/org/apache/wicket/markup/html/link/BookmarkableContinueToPage.java",0,0.944444444444444,2,1,3
"wicket-core/src/test/java/org/apache/wicket/markup/html/link/BookmarkableHomePageLinksPage.java",0,0.386363636363636,1,5,6
"wicket-core/src/test/java/org/apache/wicket/markup/html/link/BookmarkableHomePageLinksTest.java",0,0.432432432432432,1,4,5
"wicket-core/src/test/java/org/apache/wicket/markup/html/link/BookmarkablePageLinkTest.java",0,0.551724137931034,1,4,5
"wicket-core/src/test/java/org/apache/wicket/markup/html/link/BookmarkableSetSecurityPage.java",0,0.972972972972973,1,1,2
"wicket-core/src/test/java/org/apache/wicket/markup/html/link/BookmarkableThrowsInterceptPage.java",0,0.882352941176471,2,2,4
"wicket-core/src/test/java/org/apache/wicket/markup/html/link/ClientSideImageMapPage_1.java",0,0.901960784313726,0,2,2
"wicket-core/src/test/java/org/apache/wicket/markup/html/link/ClientSideImageMapTest.java",0,0.789473684210526,0,2,2
"wicket-core/src/test/java/org/apache/wicket/markup/html/link/DownloadLinkTest.java",0,0.396039603960396,2,5,7
"wicket-core/src/test/java/org/apache/wicket/markup/html/link/DownloadPage.java",0,0.583333333333333,1,3,4
"wicket-core/src/test/java/org/apache/wicket/markup/html/link/ExternalLinkPage_1.java",0,0.941176470588235,0,2,2
"wicket-core/src/test/java/org/apache/wicket/markup/html/link/ExternalLinkPage_2.java",0,0.886363636363636,1,2,3
"wicket-core/src/test/java/org/apache/wicket/markup/html/link/ExternalLinkTest.java",0,0.897959183673469,0,2,2
"wicket-core/src/test/java/org/apache/wicket/markup/html/link/HrefTest.java",0,0.657894736842105,2,4,6
"wicket-core/src/test/java/org/apache/wicket/markup/html/link/Href_1.java",0,0.525,0,5,5
"wicket-core/src/test/java/org/apache/wicket/markup/html/link/Href_2.java",0,0.594594594594595,1,4,5
"wicket-core/src/test/java/org/apache/wicket/markup/html/link/Href_3.java",0,0.536585365853659,1,4,5
"wicket-core/src/test/java/org/apache/wicket/markup/html/link/Page1.java",0,0.578947368421053,0,5,5
"wicket-core/src/test/java/org/apache/wicket/markup/html/link/XmlPage.java",0,0.6875,2,3,5
"wicket-core/src/test/java/org/apache/wicket/markup/html/link/subdir/Page1.java",0,0.578947368421053,0,5,5
"wicket-core/src/test/java/org/apache/wicket/markup/html/link/submitLink/FormPage.java",0,0.988372093023256,1,1,2
"wicket-core/src/test/java/org/apache/wicket/markup/html/link/submitLink/FormPage2.java",0,0.988372093023256,1,1,2
"wicket-core/src/test/java/org/apache/wicket/markup/html/link/submitLink/FormPage2Test.java",0,0.903225806451613,0,2,2
"wicket-core/src/test/java/org/apache/wicket/markup/html/link/submitLink/FormPageTest.java",0,0.903225806451613,0,2,2
"wicket-core/src/test/java/org/apache/wicket/markup/html/list/IncrementalTableNavigationPage.java",0,0.614285714285714,2,4,6
"wicket-core/src/test/java/org/apache/wicket/markup/html/list/IncrementalTableNavigationTest.java",0,0.458333333333333,3,5,8
"wicket-core/src/test/java/org/apache/wicket/markup/html/list/ListViewTest.java",0,0.6640625,2,5,7
"wicket-core/src/test/java/org/apache/wicket/markup/html/list/PagedTableNavigatorPage.java",0,0.653333333333333,2,4,6
"wicket-core/src/test/java/org/apache/wicket/markup/html/list/PagedTableNavigatorTest.java",0,0.459016393442623,4,4,8
"wicket-core/src/test/java/org/apache/wicket/markup/html/list/PagedTableNavigatorWithLabelProviderPage.java",0,0.700934579439252,1,4,5
"wicket-core/src/test/java/org/apache/wicket/markup/html/list/PagedTableNavigatorWithLabelProviderTest.java",0,0.515151515151515,3,4,7
"wicket-core/src/test/java/org/apache/wicket/markup/html/list/PagedTableNavigatorWithMarginPage.java",0,0.551401869158878,1,5,6
"wicket-core/src/test/java/org/apache/wicket/markup/html/list/PagedTableNavigatorWithMarginTest.java",0,0.751515151515151,5,2,7
"wicket-core/src/test/java/org/apache/wicket/markup/html/list/PagedTablePage.java",0,0.6,1,5,6
"wicket-core/src/test/java/org/apache/wicket/markup/html/list/PagedTableTest.java",0,0.549450549450549,3,5,8
"wicket-core/src/test/java/org/apache/wicket/markup/html/list/SimpleTablePage_1.java",0,0.6,2,4,6
"wicket-core/src/test/java/org/apache/wicket/markup/html/list/SimpleTablePage_2.java",0,0.6,2,4,6
"wicket-core/src/test/java/org/apache/wicket/markup/html/list/SimpleTableTest.java",0,0.351351351351351,1,7,8
"wicket-core/src/test/java/org/apache/wicket/markup/html/list/TableTest.java",0,0.6484375,4,4,8
"wicket-core/src/test/java/org/apache/wicket/markup/html/markupId/HomePage.java",0,1,0,1,1
"wicket-core/src/test/java/org/apache/wicket/markup/html/markupId/MyPanel.java",0,1,0,1,1
"wicket-core/src/test/java/org/apache/wicket/markup/html/markupId/TestHomePage.java",0,0.888888888888889,0,2,2
"wicket-core/src/test/java/org/apache/wicket/markup/html/markupId/WicketApplication.java",0,1,0,1,1
"wicket-core/src/test/java/org/apache/wicket/markup/html/navigation/paging/AbstractPagingNavigationTest.java",0,0.734177215189873,1,3,4
"wicket-core/src/test/java/org/apache/wicket/markup/html/navigation/paging/PagingNavigationIncrementLinkTest.java",0,0.741007194244604,1,4,5
"wicket-core/src/test/java/org/apache/wicket/markup/html/navigation/paging/PagingNavigationLinkTest.java",0,0.713333333333333,2,4,6
"wicket-core/src/test/java/org/apache/wicket/markup/html/page/HomePage.java",0,0.982456140350877,1,1,2
"wicket-core/src/test/java/org/apache/wicket/markup/html/page/SimplePanel.java",0,1,0,1,1
"wicket-core/src/test/java/org/apache/wicket/markup/html/page/TestHomePage.java",0,0.941176470588235,0,2,2
"wicket-core/src/test/java/org/apache/wicket/markup/html/panel/FragmentTestCase.java",0,0.939393939393939,0,2,2
"wicket-core/src/test/java/org/apache/wicket/markup/html/panel/FragmentTestPanel.java",0,0.947368421052632,0,2,2
"wicket-core/src/test/java/org/apache/wicket/markup/html/panel/InlinePanelPage_1.java",0,0.619047619047619,2,2,4
"wicket-core/src/test/java/org/apache/wicket/markup/html/panel/InlinePanelPage_2.java",0,0.595238095238095,1,3,4
"wicket-core/src/test/java/org/apache/wicket/markup/html/panel/InlinePanelPage_3.java",0,0.5,1,3,4
"wicket-core/src/test/java/org/apache/wicket/markup/html/panel/InlinePanelPage_4.java",0,0.578947368421053,1,3,4
"wicket-core/src/test/java/org/apache/wicket/markup/html/panel/InlinePanelPage_5.java",0,0.701492537313433,4,2,6
"wicket-core/src/test/java/org/apache/wicket/markup/html/panel/InlinePanelPage_6.java",0,0.523809523809524,1,3,4
"wicket-core/src/test/java/org/apache/wicket/markup/html/panel/InlinePanelPage_7.java",0,0.975,1,1,2
"wicket-core/src/test/java/org/apache/wicket/markup/html/panel/InlinePanelPage_8.java",0,0.888888888888889,1,2,3
"wicket-core/src/test/java/org/apache/wicket/markup/html/panel/InlinePanel_4.java",0,0.697674418604651,1,3,4
"wicket-core/src/test/java/org/apache/wicket/markup/html/panel/InlineTestPanel.java",0,0.571428571428571,1,3,4
"wicket-core/src/test/java/org/apache/wicket/markup/html/panel/PanelPage_1.java",0,0.6,0,5,5
"wicket-core/src/test/java/org/apache/wicket/markup/html/panel/PanelPage_2.java",0,0.6,0,5,5
"wicket-core/src/test/java/org/apache/wicket/markup/html/panel/PanelPage_3.java",0,0.975,1,1,2
"wicket-core/src/test/java/org/apache/wicket/markup/html/panel/PanelPage_4.java",0,1,0,1,1
"wicket-core/src/test/java/org/apache/wicket/markup/html/panel/PanelTest.java",0,0.620512820512821,5,4,9
"wicket-core/src/test/java/org/apache/wicket/markup/html/panel/PanelWithAttributeModifier.java",0,0.625,1,4,5
"wicket-core/src/test/java/org/apache/wicket/markup/html/panel/PanelWithAttributeModifierPage.java",0,0.575,1,3,4
"wicket-core/src/test/java/org/apache/wicket/markup/html/panel/Provider.java",0,0.878787878787879,1,2,3
"wicket-core/src/test/java/org/apache/wicket/markup/html/panel/SimplePanel_1.java",0,0.631578947368421,0,4,4
"wicket-core/src/test/java/org/apache/wicket/markup/html/panel/SimplePanel_2.java",0,0.631578947368421,0,4,4
"wicket-core/src/test/java/org/apache/wicket/markup/html/panel/SimplePanel_3.java",0,1,0,1,1
"wicket-core/src/test/java/org/apache/wicket/markup/html/panel/SimplePanel_4.java",0,1,0,1,1
"wicket-core/src/test/java/org/apache/wicket/markup/html/tags/InputTagNotClosedTest.java",0,0.590909090909091,1,3,4
"wicket-core/src/test/java/org/apache/wicket/markup/html/tags/InputTagNotVisibleWebPage.java",0,0.65,1,3,4
"wicket-core/src/test/java/org/apache/wicket/markup/html/tags/InputTagVisibleWebPage.java",0,0.65,1,3,4
"wicket-core/src/test/java/org/apache/wicket/markup/html/tree/TreeTest.java",0,0.937062937062937,2,1,3
"wicket-core/src/test/java/org/apache/wicket/markup/outputTransformer/OutputTransformerContainerTest.java",0,0.666666666666667,2,3,5
"wicket-core/src/test/java/org/apache/wicket/markup/outputTransformer/Page_1.java",0,0.349514563106796,2,5,7
"wicket-core/src/test/java/org/apache/wicket/markup/outputTransformer/Page_2.java",0,0.41304347826087,2,5,7
"wicket-core/src/test/java/org/apache/wicket/markup/outputTransformer/Page_3.java",0,1,0,1,1
"wicket-core/src/test/java/org/apache/wicket/markup/outputTransformer/Panel_1.java",0,0.590909090909091,0,4,4
"wicket-core/src/test/java/org/apache/wicket/markup/parser/HomePage.java",0,0.976744186046512,1,1,2
"wicket-core/src/test/java/org/apache/wicket/markup/parser/MergedMarkupTest.java",0,0.910714285714286,0,2,2
"wicket-core/src/test/java/org/apache/wicket/markup/parser/Page_1.java",0,0.605263157894737,0,5,5
"wicket-core/src/test/java/org/apache/wicket/markup/parser/Page_2.java",0,0.684210526315789,2,3,5
"wicket-core/src/test/java/org/apache/wicket/markup/parser/Page_3.java",0,1,0,1,1
"wicket-core/src/test/java/org/apache/wicket/markup/parser/RelativePathPrefixHandlerTest.java",0,0.280701754385965,1,5,6
"wicket-core/src/test/java/org/apache/wicket/markup/parser/SignInPanel.java",0,1,0,1,1
"wicket-core/src/test/java/org/apache/wicket/markup/parser/SubPageWithMarkup.java",0,1,0,1,1
"wicket-core/src/test/java/org/apache/wicket/markup/parser/SubPageWithoutMarkup.java",0,1,0,1,1
"wicket-core/src/test/java/org/apache/wicket/markup/parser/SuperPage.java",0,1,0,1,1
"wicket-core/src/test/java/org/apache/wicket/markup/parser/TestHomePage.java",0,0.95,0,2,2
"wicket-core/src/test/java/org/apache/wicket/markup/parser/XmlPullParserTest.java",0,0.519540229885057,3,3,6
"wicket-core/src/test/java/org/apache/wicket/markup/parser/filter/AbstractTest14WebPage.java",0,0.527777777777778,1,3,4
"wicket-core/src/test/java/org/apache/wicket/markup/parser/filter/DoubleHeaderPartPage.java",0,0.538461538461538,1,3,4
"wicket-core/src/test/java/org/apache/wicket/markup/parser/filter/DoubleHeaderPartPageTest.java",0,0.5,0,3,3
"wicket-core/src/test/java/org/apache/wicket/markup/parser/filter/HeaderSectionBasePage_12.java",0,0.615384615384615,1,4,5
"wicket-core/src/test/java/org/apache/wicket/markup/parser/filter/HeaderSectionBorder.java",0,0.6,0,4,4
"wicket-core/src/test/java/org/apache/wicket/markup/parser/filter/HeaderSectionBorder_2.java",0,0.625,0,4,4
"wicket-core/src/test/java/org/apache/wicket/markup/parser/filter/HeaderSectionMyLabel.java",0,0.75,2,4,6
"wicket-core/src/test/java/org/apache/wicket/markup/parser/filter/HeaderSectionMyLabel2.java",0,0.615384615384615,1,4,5
"wicket-core/src/test/java/org/apache/wicket/markup/parser/filter/HeaderSectionPage_1.java",0,0.594594594594595,1,4,5
"wicket-core/src/test/java/org/apache/wicket/markup/parser/filter/HeaderSectionPage_10.java",0,0.578947368421053,1,4,5
"wicket-core/src/test/java/org/apache/wicket/markup/parser/filter/HeaderSectionPage_11.java",0,0.578947368421053,1,4,5
"wicket-core/src/test/java/org/apache/wicket/markup/parser/filter/HeaderSectionPage_12.java",0,0.558823529411765,2,2,4
"wicket-core/src/test/java/org/apache/wicket/markup/parser/filter/HeaderSectionPage_13.java",0,0.631578947368421,1,4,5
"wicket-core/src/test/java/org/apache/wicket/markup/parser/filter/HeaderSectionPage_14.java",0,0.657142857142857,1,3,4
"wicket-core/src/test/java/org/apache/wicket/markup/parser/filter/HeaderSectionPage_15.java",0,0.657894736842105,1,4,5
"wicket-core/src/test/java/org/apache/wicket/markup/parser/filter/HeaderSectionPage_16.java",0,0.641025641025641,1,4,5
"wicket-core/src/test/java/org/apache/wicket/markup/parser/filter/HeaderSectionPage_17.java",0,0.41025641025641,1,4,5
"wicket-core/src/test/java/org/apache/wicket/markup/parser/filter/HeaderSectionPage_18.java",0,0.648648648648649,1,4,5
"wicket-core/src/test/java/org/apache/wicket/markup/parser/filter/HeaderSectionPage_19.java",0,0.641025641025641,1,4,5
"wicket-core/src/test/java/org/apache/wicket/markup/parser/filter/HeaderSectionPage_2.java",0,0.594594594594595,1,4,5
"wicket-core/src/test/java/org/apache/wicket/markup/parser/filter/HeaderSectionPage_20.java",0,1,0,1,1
"wicket-core/src/test/java/org/apache/wicket/markup/parser/filter/HeaderSectionPage_3.java",0,0.594594594594595,1,4,5
"wicket-core/src/test/java/org/apache/wicket/markup/parser/filter/HeaderSectionPage_4.java",0,0.578947368421053,1,4,5
"wicket-core/src/test/java/org/apache/wicket/markup/parser/filter/HeaderSectionPage_5.java",0,0.578947368421053,1,4,5
"wicket-core/src/test/java/org/apache/wicket/markup/parser/filter/HeaderSectionPage_6.java",0,0.355555555555556,0,4,4
"wicket-core/src/test/java/org/apache/wicket/markup/parser/filter/HeaderSectionPage_7.java",0,0.41025641025641,0,4,4
"wicket-core/src/test/java/org/apache/wicket/markup/parser/filter/HeaderSectionPage_8.java",0,0.55,1,4,5
"wicket-core/src/test/java/org/apache/wicket/markup/parser/filter/HeaderSectionPage_9.java",0,0.421052631578947,0,4,4
"wicket-core/src/test/java/org/apache/wicket/markup/parser/filter/HeaderSectionPage_9a.java",0,0.55,1,5,6
"wicket-core/src/test/java/org/apache/wicket/markup/parser/filter/HeaderSectionPanel.java",0,0.6,0,4,4
"wicket-core/src/test/java/org/apache/wicket/markup/parser/filter/HeaderSectionPanel_17.java",0,0.386363636363636,0,4,4
"wicket-core/src/test/java/org/apache/wicket/markup/parser/filter/HeaderSectionPanel_19.java",0,0.590909090909091,0,4,4
"wicket-core/src/test/java/org/apache/wicket/markup/parser/filter/HeaderSectionPanel_2.java",0,0.571428571428571,0,4,4
"wicket-core/src/test/java/org/apache/wicket/markup/parser/filter/HeaderSectionPanel_3.java",0,0.6,0,4,4
"wicket-core/src/test/java/org/apache/wicket/markup/parser/filter/HeaderSectionPanel_4.java",0,0.65,0,4,4
"wicket-core/src/test/java/org/apache/wicket/markup/parser/filter/HeaderSectionPanel_5.java",0,0.553191489361702,0,4,4
"wicket-core/src/test/java/org/apache/wicket/markup/parser/filter/HeaderSectionTest.java",0,0.665178571428571,2,3,5
"wicket-core/src/test/java/org/apache/wicket/markup/parser/filter/OpenCloseTagExpanderPage_1.java",0,1,0,1,1
"wicket-core/src/test/java/org/apache/wicket/markup/parser/filter/OpenCloseTagExpanderTest.java",0,0.916666666666667,0,2,2
"wicket-core/src/test/java/org/apache/wicket/markup/parser/filter/PanelWithHeaderPart.java",0,0.423076923076923,1,4,5
"wicket-core/src/test/java/org/apache/wicket/markup/parser/filter/sub/HeaderSectionBorder.java",0,0.5,0,5,5
"wicket-core/src/test/java/org/apache/wicket/markup/renderStrategy/ChildFirstHeaderRenderStrategyTest.java",0,0.957894736842105,2,1,3
"wicket-core/src/test/java/org/apache/wicket/markup/renderStrategy/SimplePage1.java",0,0.769230769230769,0,2,2
"wicket-core/src/test/java/org/apache/wicket/markup/renderStrategy/SimplePage2.java",0,0.765432098765432,0,2,2
"wicket-core/src/test/java/org/apache/wicket/markup/renderStrategy/SimplePanel1.java",0,0.795454545454545,0,2,2
"wicket-core/src/test/java/org/apache/wicket/markup/resolver/HomePage_1.java",0,0.977272727272727,1,1,2
"wicket-core/src/test/java/org/apache/wicket/markup/resolver/HomePage_2.java",0,0.846153846153846,0,2,2
"wicket-core/src/test/java/org/apache/wicket/markup/resolver/SimpleBasePage_6.java",0,1,0,1,1
"wicket-core/src/test/java/org/apache/wicket/markup/resolver/SimpleContainerPage_1.java",0,1,0,1,1
"wicket-core/src/test/java/org/apache/wicket/markup/resolver/SimplePage_1.java",0,0.975,1,1,2
"wicket-core/src/test/java/org/apache/wicket/markup/resolver/SimplePage_2.java",0,0.928571428571429,2,1,3
"wicket-core/src/test/java/org/apache/wicket/markup/resolver/SimplePage_3.java",0,0.96,2,1,3
"wicket-core/src/test/java/org/apache/wicket/markup/resolver/SimplePage_4.java",0,0.972972972972973,1,1,2
"wicket-core/src/test/java/org/apache/wicket/markup/resolver/SimplePage_5.java",0,1,0,1,1
"wicket-core/src/test/java/org/apache/wicket/markup/resolver/SimplePage_6.java",0,1,0,1,1
"wicket-core/src/test/java/org/apache/wicket/markup/resolver/TestHomePage.java",0,0.915492957746479,0,2,2
"wicket-core/src/test/java/org/apache/wicket/markup/resolver/WicketContainerResolverTest.java",0,0.944444444444444,0,2,2
"wicket-core/src/test/java/org/apache/wicket/markup/resolver/WicketMessageResolverTest.java",0,0.883495145631068,1,2,3
"wicket-core/src/test/java/org/apache/wicket/markup/resolver/border/BaseBorder.java",0,1,0,1,1
"wicket-core/src/test/java/org/apache/wicket/markup/resolver/border/BasePage.java",0,0.985915492957746,1,1,2
"wicket-core/src/test/java/org/apache/wicket/markup/resolver/border/HomePage.java",0,1,0,1,1
"wicket-core/src/test/java/org/apache/wicket/markup/resolver/border/WicketMessageResolverTest.java",0,0.942857142857143,0,2,2
"wicket-core/src/test/java/org/apache/wicket/markup/resolver/inparent/AutoLinkResolveInParentsMarkupTest.java",0,1,0,1,1
"wicket-core/src/test/java/org/apache/wicket/markup/resolver/inparent/HomePage.java",0,1,0,1,1
"wicket-core/src/test/java/org/apache/wicket/markup/resolver/inparent/base/BasePage.java",0,1,0,1,1
"wicket-core/src/test/java/org/apache/wicket/markup/resolver/issue3559/BasePage.java",0,1,0,1,1
"wicket-core/src/test/java/org/apache/wicket/markup/resolver/issue3559/HomePage.java",0,1,0,1,1
"wicket-core/src/test/java/org/apache/wicket/markup/resolver/issue3559/MenuPanel.java",0,1,0,1,1
"wicket-core/src/test/java/org/apache/wicket/markup/resolver/issue3559/MyTest.java",0,0.961538461538462,1,1,2
"wicket-core/src/test/java/org/apache/wicket/markup/resolver/issue3559/SimplePage.java",0,1,0,1,1
"wicket-core/src/test/java/org/apache/wicket/markup/resolver/issue3559/SimplePanel.java",0,1,0,1,1
"wicket-core/src/test/java/org/apache/wicket/markup/resolver/issue3559/WicketApplication.java",0,1,0,1,1
"wicket-core/src/test/java/org/apache/wicket/markup/resolver/issue3989/BasePanel.java",0,1,0,1,1
"wicket-core/src/test/java/org/apache/wicket/markup/resolver/issue3989/HomePage.java",0,1,0,1,1
"wicket-core/src/test/java/org/apache/wicket/markup/resolver/issue3989/Issue3989Test.java",0,1,0,1,1
"wicket-core/src/test/java/org/apache/wicket/markup/transformer/AbstractTransformerBehaviorTest.java",0,0.554744525547445,0,2,2
"wicket-core/src/test/java/org/apache/wicket/markupFragments/MarkupFragmentTest.java",0,0.827450980392157,0,2,2
"wicket-core/src/test/java/org/apache/wicket/markupFragments/MyBorder.java",0,1,0,1,1
"wicket-core/src/test/java/org/apache/wicket/markupFragments/MyBorder2.java",0,1,0,1,1
"wicket-core/src/test/java/org/apache/wicket/markupFragments/MyBorderPage.java",0,1,0,1,1
"wicket-core/src/test/java/org/apache/wicket/markupFragments/MyPage.java",0,1,0,1,1
"wicket-core/src/test/java/org/apache/wicket/markupFragments/MyPanel.java",0,1,0,1,1
"wicket-core/src/test/java/org/apache/wicket/markupFragments/MyPanelPage.java",0,1,0,1,1
"wicket-core/src/test/java/org/apache/wicket/markupFragments/MyPanelWithAutoComponent.java",0,1,0,1,1
"wicket-core/src/test/java/org/apache/wicket/markupFragments/MyPanelWithAutoComponentPage.java",0,0.942857142857143,0,2,2
"wicket-core/src/test/java/org/apache/wicket/model/AbstractPropertyModelObjectClassTest.java",0,0.75,0,3,3
"wicket-core/src/test/java/org/apache/wicket/model/DetachableTest.java",0,1,0,1,1
"wicket-core/src/test/java/org/apache/wicket/model/HomePage.java",0,0.964285714285714,2,1,3
"wicket-core/src/test/java/org/apache/wicket/model/InheritedModelTest.java",0,0.650485436893204,2,3,5
"wicket-core/src/test/java/org/apache/wicket/model/InheritedTestPage.java",0,0.951219512195122,2,1,3
"wicket-core/src/test/java/org/apache/wicket/model/ModelDetachTest.java",0,0.802083333333333,4,2,6
"wicket-core/src/test/java/org/apache/wicket/model/ModelToStringTest.java",0,0.297560975609756,1,7,8
"wicket-core/src/test/java/org/apache/wicket/model/PropertyModelTest.java",0,0.642857142857143,1,4,5
"wicket-core/src/test/java/org/apache/wicket/model/PropertyModelWithListTest.java",0,1,0,1,1
"wicket-core/src/test/java/org/apache/wicket/model/ResourceModelTest.java",0,0.909090909090909,1,2,3
"wicket-core/src/test/java/org/apache/wicket/model/StringResourceModelTest.java",0,0.294520547945205,6,6,12
"wicket-core/src/test/java/org/apache/wicket/model/TestHomePage.java",0,0.930232558139535,2,1,3
"wicket-core/src/test/java/org/apache/wicket/page/PageAccessSynchronizerTest.java",0,0.829268292682927,1,3,4
"wicket-core/src/test/java/org/apache/wicket/page/PersistentPageManagerTest.java",0,0.767123287671233,1,2,3
"wicket-core/src/test/java/org/apache/wicket/page/persistent/disk/DiskDataStoreTest.java",0,0.524804177545692,1,3,4
"wicket-core/src/test/java/org/apache/wicket/page/persistent/disk/PageWindowManagerTest.java",0,0.885135135135135,1,2,3
"wicket-core/src/test/java/org/apache/wicket/pageStore/AsynchronousDataStoreTest.java",0,0.942857142857143,0,2,2
"wicket-core/src/test/java/org/apache/wicket/pageStore/memory/DummyPageManagerContext.java",0,0.883333333333333,0,2,2
"wicket-core/src/test/java/org/apache/wicket/pageStore/memory/HttpSessionDataStoreTest.java",0,0.846846846846847,0,2,2
"wicket-core/src/test/java/org/apache/wicket/pageStore/memory/MemorySizeEvictionStrategyTest.java",0,1,0,1,1
"wicket-core/src/test/java/org/apache/wicket/pageStore/memory/PageNumberEvictionStrategyTest.java",0,1,0,1,1
"wicket-core/src/test/java/org/apache/wicket/pageStore/memory/PageTableTest.java",0,1,0,1,1
"wicket-core/src/test/java/org/apache/wicket/properties/MyApplication.java",0,0.916666666666667,0,2,2
"wicket-core/src/test/java/org/apache/wicket/properties/MyTesterApplication.java",0,0.923076923076923,0,2,2
"wicket-core/src/test/java/org/apache/wicket/properties/PropertiesTest.java",0,0.447058823529412,1,5,6
"wicket-core/src/test/java/org/apache/wicket/properties/TestForm.java",0,0.578947368421053,1,3,4
"wicket-core/src/test/java/org/apache/wicket/properties/TestPage.java",0,0.701195219123506,1,3,4
"wicket-core/src/test/java/org/apache/wicket/properties/TestPanel.java",0,0.578947368421053,1,3,4
"wicket-core/src/test/java/org/apache/wicket/protocol/http/BufferedWebResponseTest.java",0,1,0,1,1
"wicket-core/src/test/java/org/apache/wicket/protocol/http/ClientPropertiesTest.java",0,0.685950413223141,1,3,4
"wicket-core/src/test/java/org/apache/wicket/protocol/http/FirstPage.java",0,0.702127659574468,1,2,3
"wicket-core/src/test/java/org/apache/wicket/protocol/http/HeaderBufferingWebResponseTest.java",0,0.851851851851852,1,2,3
"wicket-core/src/test/java/org/apache/wicket/protocol/http/MockPage.java",0,0.386666666666667,2,5,7
"wicket-core/src/test/java/org/apache/wicket/protocol/http/ModifyCookiePage.java",0,0.694915254237288,0,3,3
"wicket-core/src/test/java/org/apache/wicket/protocol/http/ModifyCookiePageTest.java",0,0.816666666666667,1,2,3
"wicket-core/src/test/java/org/apache/wicket/protocol/http/RequestUtilsTest.java",0,0.37,0,5,5
"wicket-core/src/test/java/org/apache/wicket/protocol/http/SecondPage.java",0,0.659574468085106,1,2,3
"wicket-core/src/test/java/org/apache/wicket/protocol/http/StoredResponsesMapTest.java",0,0.992957746478873,1,1,2
"wicket-core/src/test/java/org/apache/wicket/protocol/http/TestErrorPage.java",0,0.677966101694915,2,4,6
"wicket-core/src/test/java/org/apache/wicket/protocol/http/TestExpirePage.java",0,0.739130434782609,3,3,6
"wicket-core/src/test/java/org/apache/wicket/protocol/http/WebExternalResourceTest.java",0,0.520408163265306,2,4,6
"wicket-core/src/test/java/org/apache/wicket/protocol/http/WebResponseExceptionsTest.java",0,0.34020618556701,1,5,6
"wicket-core/src/test/java/org/apache/wicket/protocol/http/WebSessionTest.java",0,0.5,0,5,5
"wicket-core/src/test/java/org/apache/wicket/protocol/http/WicketFilterTest.java",0,0.426735218508997,3,5,8
"wicket-core/src/test/java/org/apache/wicket/protocol/http/WicketPanel.java",0,0.55,1,4,5
"wicket-core/src/test/java/org/apache/wicket/protocol/http/WicketPanelPage.java",0,0.564102564102564,0,5,5
"wicket-core/src/test/java/org/apache/wicket/protocol/http/WicketTagPanelTest.java",0,0.663716814159292,3,5,8
"wicket-core/src/test/java/org/apache/wicket/protocol/http/WicketURLTest.java",0,0.382352941176471,0,4,4
"wicket-core/src/test/java/org/apache/wicket/protocol/http/mock/MockHttpServletRequestTest.java",0,1,0,1,1
"wicket-core/src/test/java/org/apache/wicket/protocol/http/request/CryptedUrlWebRequestCodingStrategyTest.java",0,0.503937007874016,0,3,3
"wicket-core/src/test/java/org/apache/wicket/protocol/http/request/HomePage.java",0,0.985074626865672,1,1,2
"wicket-core/src/test/java/org/apache/wicket/protocol/http/request/UserAgentTest.java",0,0.951612903225806,1,1,2
"wicket-core/src/test/java/org/apache/wicket/protocol/http/request/WebClientInfoTest.java",0,1,0,1,1
"wicket-core/src/test/java/org/apache/wicket/protocol/http/servlet/SecuredRemoteAddressRequestWrapperFactoryTest.java",0,0.962264150943396,1,1,2
"wicket-core/src/test/java/org/apache/wicket/protocol/http/servlet/ServletWebRequestTest.java",0,0.842767295597484,0,2,2
"wicket-core/src/test/java/org/apache/wicket/protocol/http/servlet/ServletWebResponseTest.java",0,1,0,1,1
"wicket-core/src/test/java/org/apache/wicket/protocol/http/servlet/WicketSessionFilterTest.java",0,1,0,1,1
"wicket-core/src/test/java/org/apache/wicket/protocol/http/servlet/XForwardedRequestWrapperTest.java",0,0.934883720930233,0,2,2
"wicket-core/src/test/java/org/apache/wicket/protocol/https/HttpPage.java",0,1,0,1,1
"wicket-core/src/test/java/org/apache/wicket/protocol/https/HttpsMapperApplication.java",0,1,0,1,1
"wicket-core/src/test/java/org/apache/wicket/protocol/https/HttpsMapperApplicationTest.java",0,0.977443609022556,1,1,2
"wicket-core/src/test/java/org/apache/wicket/protocol/https/HttpsPage.java",0,1,0,1,1
"wicket-core/src/test/java/org/apache/wicket/protocol/https/HttpsRequestCheckerTest.java",0,0.898305084745763,2,2,4
"wicket-core/src/test/java/org/apache/wicket/protocol/https/SwitchProtocolRequestHandlerTest.java",0,0.986486486486487,1,1,2
"wicket-core/src/test/java/org/apache/wicket/redirect/LoginPage.java",0,0.756756756756757,1,3,4
"wicket-core/src/test/java/org/apache/wicket/redirect/ProtectedPage.java",0,0.725,0,4,4
"wicket-core/src/test/java/org/apache/wicket/redirect/RestartWithMountedPageTest.java",0,0.685714285714286,1,3,4
"wicket-core/src/test/java/org/apache/wicket/redirect/abort/AbortExceptionPage.java",0,0.695121951219512,1,4,5
"wicket-core/src/test/java/org/apache/wicket/redirect/abort/AbortExceptionTest.java",0,0.859375,1,2,3
"wicket-core/src/test/java/org/apache/wicket/redirect/intercept/HomePage.java",0,0.9,0,2,2
"wicket-core/src/test/java/org/apache/wicket/redirect/intercept/InterceptPage.java",0,0.872727272727273,0,3,3
"wicket-core/src/test/java/org/apache/wicket/redirect/intercept/InterceptTest.java",0,0.883495145631068,2,2,4
"wicket-core/src/test/java/org/apache/wicket/redirect/intercept/TargetPage.java",0,0.878048780487805,1,2,3
"wicket-core/src/test/java/org/apache/wicket/request/cycle/BaseRequestHandlerStackTest.java",0,0.537878787878788,2,2,4
"wicket-core/src/test/java/org/apache/wicket/request/cycle/MultiRequestCycleListenerCallOrderApplication.java",0,0.871559633027523,0,2,2
"wicket-core/src/test/java/org/apache/wicket/request/cycle/MultiRequestCycleListenerCallOrderPage.java",0,1,0,1,1
"wicket-core/src/test/java/org/apache/wicket/request/cycle/MultiRequestCycleListenerCallOrderTest.java",0,0.857142857142857,2,2,4
"wicket-core/src/test/java/org/apache/wicket/request/cycle/RequestCycleListenerDetachOrderTest.java",0,1,0,1,1
"wicket-core/src/test/java/org/apache/wicket/request/cycle/RequestCycleListenerTest.java",0,0.48546511627907,1,3,4
"wicket-core/src/test/java/org/apache/wicket/request/cycle/RequestHandlerStackTest.java",0,0.923312883435583,3,1,4
"wicket-core/src/test/java/org/apache/wicket/request/cycle/UrlRendererTest.java",0,0.801324503311258,0,2,2
"wicket-core/src/test/java/org/apache/wicket/request/handler/ListenerInterfaceRequestHandlerTest.java",0,1,0,1,1
"wicket-core/src/test/java/org/apache/wicket/request/handler/PageIdPoliticTest.java",0,0.831325301204819,0,2,2
"wicket-core/src/test/java/org/apache/wicket/request/handler/PageProviderTest.java",0,0.643109540636042,0,3,3
"wicket-core/src/test/java/org/apache/wicket/request/handler/render/WebPageRendererTest.java",0,1,0,1,1
"wicket-core/src/test/java/org/apache/wicket/request/mapper/AbstractMapperTest.java",0,0.873684210526316,2,2,4
"wicket-core/src/test/java/org/apache/wicket/request/mapper/AbstractResourceReferenceMapperTest.java",0,0.642201834862385,2,3,5
"wicket-core/src/test/java/org/apache/wicket/request/mapper/BasicResourceReferenceMapperTest.java",0,0.5625,1,5,6
"wicket-core/src/test/java/org/apache/wicket/request/mapper/BookmarkableMapperTest.java",0,0.755501222493888,1,3,4
"wicket-core/src/test/java/org/apache/wicket/request/mapper/CryptoMapperTest.java",0,0.731707317073171,0,2,2
"wicket-core/src/test/java/org/apache/wicket/request/mapper/CustomHomePageTest.java",0,0.988888888888889,1,1,2
"wicket-core/src/test/java/org/apache/wicket/request/mapper/MountedMapperTest.java",0,0.306892067620286,2,4,6
"wicket-core/src/test/java/org/apache/wicket/request/mapper/PackageMapperTest.java",0,0.899253731343284,1,2,3
"wicket-core/src/test/java/org/apache/wicket/request/mapper/PageInstanceMapperTest.java",0,0.46078431372549,0,3,3
"wicket-core/src/test/java/org/apache/wicket/request/mapper/ResourceMapperTest.java",0,0.75,1,3,4
"wicket-core/src/test/java/org/apache/wicket/request/mapper/TestMapperContext.java",0,0.456066945606695,0,4,4
"wicket-core/src/test/java/org/apache/wicket/request/mapper/UrlInfoTest.java",0,0.956521739130435,1,1,2
"wicket-core/src/test/java/org/apache/wicket/request/mapper/info/ComponentInfoTest.java",0,0.810810810810811,0,3,3
"wicket-core/src/test/java/org/apache/wicket/request/mapper/info/PageComponentInfoTest.java",0,0.783132530120482,0,2,2
"wicket-core/src/test/java/org/apache/wicket/request/resource/ByteArrayResourceTest.java",0,1,0,1,1
"wicket-core/src/test/java/org/apache/wicket/request/resource/CssPackageResourceTest.java",0,1,0,1,1
"wicket-core/src/test/java/org/apache/wicket/request/resource/DynamicImageResourceTest.java",0,1,0,1,1
"wicket-core/src/test/java/org/apache/wicket/request/resource/JavaScriptPackageResourceTest.java",0,1,0,1,1
"wicket-core/src/test/java/org/apache/wicket/request/resource/MetaInfStaticResourceReferenceTest.java",0,1,0,1,1
"wicket-core/src/test/java/org/apache/wicket/request/resource/PackageResourceReferenceTest.java",0,0.967914438502674,1,1,2
"wicket-core/src/test/java/org/apache/wicket/request/resource/ResourceReferenceRegistryTest.java",0,1,0,1,1
"wicket-core/src/test/java/org/apache/wicket/request/resource/WriteCallbackTest.java",0,0.921875,0,2,2
"wicket-core/src/test/java/org/apache/wicket/request/resource/caching/ContextRelativeResourceCachingTest.java",0,0.874015748031496,0,2,2
"wicket-core/src/test/java/org/apache/wicket/resource/ApplicationStringResourceLoaderTest.java",0,0.290909090909091,3,5,8
"wicket-core/src/test/java/org/apache/wicket/resource/BundleStringResourceLoaderTest.java",0,0.289855072463768,1,6,7
"wicket-core/src/test/java/org/apache/wicket/resource/ComponentStringResourceLoaderTest.java",0,0.291666666666667,1,7,8
"wicket-core/src/test/java/org/apache/wicket/resource/DummyApplication.java",0,0.923076923076923,0,2,2
"wicket-core/src/test/java/org/apache/wicket/resource/DummyComponent.java",0,0.25,1,6,7
"wicket-core/src/test/java/org/apache/wicket/resource/DummyPage.java",0,0.461538461538462,2,4,6
"wicket-core/src/test/java/org/apache/wicket/resource/DummySubClassPage.java",0,0.722222222222222,1,3,4
"wicket-core/src/test/java/org/apache/wicket/resource/InvalidResourceSpecificationExceptionTest.java",0,0.414634146341463,2,4,6
"wicket-core/src/test/java/org/apache/wicket/resource/PageWithXmlProperties.java",0,0.945945945945946,0,2,2
"wicket-core/src/test/java/org/apache/wicket/resource/StringResourceLoaderTestBase.java",0,0.423357664233577,2,6,8
"wicket-core/src/test/java/org/apache/wicket/resource/TextTemplateResourceReferenceTest.java",0,1,0,1,1
"wicket-core/src/test/java/org/apache/wicket/resource/XmlFilePropertiesLoaderTest.java",0,0.981132075471698,1,1,2
"wicket-core/src/test/java/org/apache/wicket/resource/loader/ClassStringResourceLoaderTest.java",0,0.950819672131147,1,1,2
"wicket-core/src/test/java/org/apache/wicket/resource/loader/ComponentStringResourceLoaderTest.java",0,0.815126050420168,0,3,3
"wicket-core/src/test/java/org/apache/wicket/resource/loader/JarStringResourceLoaderTest.java",0,1,0,1,1
"wicket-core/src/test/java/org/apache/wicket/resource/loader/PackageStringResourceLoaderTest.java",0,0.833333333333333,0,2,2
"wicket-core/src/test/java/org/apache/wicket/resource/loader/PropertiesResolverTest.java",0,0.907284768211921,0,2,2
"wicket-core/src/test/java/org/apache/wicket/resource/loader/TestPage_1.java",0,1,0,1,1
"wicket-core/src/test/java/org/apache/wicket/resource/loader/XmlPage.java",0,0.977777777777778,1,1,2
"wicket-core/src/test/java/org/apache/wicket/resource/loader/pages/Test1.java",0,0.909090909090909,0,2,2
"wicket-core/src/test/java/org/apache/wicket/response/filter/ResponseFilterTest.java",0,0.703488372093023,0,3,3
"wicket-core/src/test/java/org/apache/wicket/session/DefaultPageFactoryTest.java",0,0.803921568627451,3,3,6
"wicket-core/src/test/java/org/apache/wicket/settings/ISecuritySettingsTest.java",0,1,0,1,1
"wicket-core/src/test/java/org/apache/wicket/stateless/ImageStatelessTest.java",0,0.843137254901961,0,3,3
"wicket-core/src/test/java/org/apache/wicket/stateless/StatelessComponentPage.java",0,0.48936170212766,4,2,6
"wicket-core/src/test/java/org/apache/wicket/stateless/StatelessComponentPageWithParams.java",0,0.890909090909091,2,2,4
"wicket-core/src/test/java/org/apache/wicket/stateless/StatelessComponentTest.java",0,0.561290322580645,3,4,7
"wicket-core/src/test/java/org/apache/wicket/stateless/StatelessFormTest.java",0,0.445652173913043,0,4,4
"wicket-core/src/test/java/org/apache/wicket/stateless/StatelessFormUrlTest.java",0,0.958333333333333,1,1,2
"wicket-core/src/test/java/org/apache/wicket/stateless/TemporarySessionTest.java",0,0.71830985915493,2,3,5
"wicket-core/src/test/java/org/apache/wicket/stateless/pages/HomePage.java",0,0.945454545454545,2,1,3
"wicket-core/src/test/java/org/apache/wicket/stateless/pages/LoginPage.java",0,0.522727272727273,2,3,5
"wicket-core/src/test/java/org/apache/wicket/stateless/pages/Page1.java",0,0.8,0,2,2
"wicket-core/src/test/java/org/apache/wicket/stateless/pages/Page2.java",0,0.771428571428571,0,2,2
"wicket-core/src/test/java/org/apache/wicket/stateless/pages/RefreshStatelessPageTest.java",0,1,0,1,1
"wicket-core/src/test/java/org/apache/wicket/stateless/pages/StatelessFormTest.java",0,0.842105263157895,1,2,3
"wicket-core/src/test/java/org/apache/wicket/stateless/pages/UsernamePasswordSignInPanel.java",0,0.764705882352941,1,4,5
"wicket-core/src/test/java/org/apache/wicket/util/ExceptionTestBase.java",0,0.509090909090909,3,5,8
"wicket-core/src/test/java/org/apache/wicket/util/Log4jEventHistory.java",0,1,0,1,1
"wicket-core/src/test/java/org/apache/wicket/util/cookies/CookieUtilsTest.java",0,0.64,0,3,3
"wicket-core/src/test/java/org/apache/wicket/util/cookies/CookieValuePersisterTestPage.java",0,1,0,1,1
"wicket-core/src/test/java/org/apache/wicket/util/cookies/SetCookieAndRedirectStatefullTestPage.java",0,1,0,1,1
"wicket-core/src/test/java/org/apache/wicket/util/cookies/SetCookieAndRedirectStatelessTestPage.java",0,1,0,1,1
"wicket-core/src/test/java/org/apache/wicket/util/cookies/SetCookieAndRedirectTest.java",0,0.928571428571429,0,2,2
"wicket-core/src/test/java/org/apache/wicket/util/io/PageA.java",0,0.67948717948718,4,3,7
"wicket-core/src/test/java/org/apache/wicket/util/io/PageB.java",0,0.8,3,3,6
"wicket-core/src/test/java/org/apache/wicket/util/io/SerializableCheckerTest.java",0,0.851851851851852,0,3,3
"wicket-core/src/test/java/org/apache/wicket/util/iterator/AbstractHierarchyIteratorTest.java",0,0.979351032448378,1,1,2
"wicket-core/src/test/java/org/apache/wicket/util/iterator/ComponentIteratorTest.java",0,1,0,1,1
"wicket-core/src/test/java/org/apache/wicket/util/lang/Address.java",0,0.688524590163934,3,2,5
"wicket-core/src/test/java/org/apache/wicket/util/lang/Country.java",0,0.619047619047619,0,3,3
"wicket-core/src/test/java/org/apache/wicket/util/lang/Country2.java",0,0.957446808510638,1,1,2
"wicket-core/src/test/java/org/apache/wicket/util/lang/Person.java",0,0.660194174757282,1,4,5
"wicket-core/src/test/java/org/apache/wicket/util/lang/Person2.java",0,0.533333333333333,1,3,4
"wicket-core/src/test/java/org/apache/wicket/util/lang/PropertyResolverTest.java",0,0.502029769959405,6,5,11
"wicket-core/src/test/java/org/apache/wicket/util/lang/WicketObjectsTest.java",0,0.543307086614173,3,5,8
"wicket-core/src/test/java/org/apache/wicket/util/license/ApacheLicenceHeaderTest.java",0,0.393617021276596,2,3,5
"wicket-core/src/test/java/org/apache/wicket/util/markup/xhtml/WellFormedXmlTest.java",0,0.941176470588235,0,2,2
"wicket-core/src/test/java/org/apache/wicket/util/resource/ResourceTest.java",0,0.343023255813953,3,5,8
"wicket-core/src/test/java/org/apache/wicket/util/resource/UrlResourceStreamTest.java",0,0.63716814159292,0,2,2
"wicket-core/src/test/java/org/apache/wicket/util/resource/locator/CachingResourceStreamLocatorTest.java",0,1,0,1,1
"wicket-core/src/test/java/org/apache/wicket/util/resource/locator/ResourceNameIteratorTest.java",0,0.945736434108527,0,2,2
"wicket-core/src/test/java/org/apache/wicket/util/string/JavaScriptStripperTest.java",0,0.23125,2,5,7
"wicket-core/src/test/java/org/apache/wicket/util/string/UrlUtilsTest.java",0,0.639344262295082,1,2,3
"wicket-core/src/test/java/org/apache/wicket/util/string/interpolator/PropertyVariableInterpolatorTest.java",0,0.732394366197183,0,2,2
"wicket-core/src/test/java/org/apache/wicket/util/template/CssTemplateTest.java",0,1,0,1,1
"wicket-core/src/test/java/org/apache/wicket/util/tester/BlockedResourceLinkPage.java",0,0.825,0,3,3
"wicket-core/src/test/java/org/apache/wicket/util/tester/FormTesterSubmitLinkTest.java",0,0.551948051948052,0,2,2
"wicket-core/src/test/java/org/apache/wicket/util/tester/FormTesterTest.java",0,0.356666666666667,5,5,10
"wicket-core/src/test/java/org/apache/wicket/util/tester/MockAjaxFormPage.java",0,0.833333333333333,2,2,4
"wicket-core/src/test/java/org/apache/wicket/util/tester/MockFormFileUploadPage.java",0,0.687022900763359,4,3,7
"wicket-core/src/test/java/org/apache/wicket/util/tester/MockFormPage.java",0,0.821138211382114,4,3,7
"wicket-core/src/test/java/org/apache/wicket/util/tester/MockPageAjaxSubmitLinkSubmitsWholeForm.java",0,0.826923076923077,1,2,3
"wicket-core/src/test/java/org/apache/wicket/util/tester/MockPageParameterPage.java",0,0.566666666666667,1,5,6
"wicket-core/src/test/java/org/apache/wicket/util/tester/MockPageWithFormAndAjaxFormSubmitBehavior.java",0,0.828125,5,2,7
"wicket-core/src/test/java/org/apache/wicket/util/tester/MockPageWithFormAndCheckGroup.java",0,0.684782608695652,1,4,5
"wicket-core/src/test/java/org/apache/wicket/util/tester/MockPageWithLinkAndLabel.java",0,0.977272727272727,1,1,2
"wicket-core/src/test/java/org/apache/wicket/util/tester/MockResourceLinkPage.java",0,0.825,1,3,4
"wicket-core/src/test/java/org/apache/wicket/util/tester/TagTesterTest.java",0,0.854961832061069,2,2,4
"wicket-core/src/test/java/org/apache/wicket/util/tester/WicketTesterSessionCreationTest.java",0,0.962962962962963,1,1,2
"wicket-core/src/test/java/org/apache/wicket/util/tester/WicketTesterSessionInvalidateTest.java",0,0.876404494382023,0,2,2
"wicket-core/src/test/java/org/apache/wicket/util/tester/WicketTesterTest.java",0,0.319230769230769,8,5,13
"wicket-core/src/test/java/org/apache/wicket/util/tester/apps_1/Book.java",0,0.79746835443038,2,2,4
"wicket-core/src/test/java/org/apache/wicket/util/tester/apps_1/CreateBook.java",0,0.615384615384615,3,3,6
"wicket-core/src/test/java/org/apache/wicket/util/tester/apps_1/MyMockApplication.java",0,0.576923076923077,2,3,5
"wicket-core/src/test/java/org/apache/wicket/util/tester/apps_1/SuccessPage.java",0,0.542857142857143,1,3,4
"wicket-core/src/test/java/org/apache/wicket/util/tester/apps_1/ViewBook.java",0,0.523809523809524,1,3,4
"wicket-core/src/test/java/org/apache/wicket/util/tester/apps_2/LoginPage.java",0,0.464285714285714,1,3,4
"wicket-core/src/test/java/org/apache/wicket/util/tester/apps_2/RedirectPage.java",0,0.464285714285714,1,3,4
"wicket-core/src/test/java/org/apache/wicket/util/tester/apps_2/Test.java",0,0.568627450980392,0,4,4
"wicket-core/src/test/java/org/apache/wicket/util/tester/apps_3/ChoicePage.java",0,0.435754189944134,1,5,6
"wicket-core/src/test/java/org/apache/wicket/util/tester/apps_3/FormTesterTest.java",0,0.626865671641791,3,4,7
"wicket-core/src/test/java/org/apache/wicket/util/tester/apps_4/EmailPage.java",0,0.651515151515151,3,3,6
"wicket-core/src/test/java/org/apache/wicket/util/tester/apps_4/FormTesterTest.java",0,0.5,2,4,6
"wicket-core/src/test/java/org/apache/wicket/util/tester/apps_5/AjaxLinkClickTest.java",0,0.661654135338346,4,4,8
"wicket-core/src/test/java/org/apache/wicket/util/tester/apps_5/AjaxSubmitLinkClickTest.java",0,0.350746268656716,1,6,7
"wicket-core/src/test/java/org/apache/wicket/util/tester/apps_5/MockPageWithFormAndContainedLink.java",0,0.9,0,2,2
"wicket-core/src/test/java/org/apache/wicket/util/tester/apps_5/MockPageWithFormAndLink.java",0,0.7,2,3,5
"wicket-core/src/test/java/org/apache/wicket/util/tester/apps_5/MockPageWithLink.java",0,0.432432432432432,1,4,5
"wicket-core/src/test/java/org/apache/wicket/util/tester/apps_6/LinkPage.java",0,0.961832061068702,1,1,2
"wicket-core/src/test/java/org/apache/wicket/util/tester/apps_6/ResultPage.java",0,0.959183673469388,1,1,2
"wicket-core/src/test/java/org/apache/wicket/util/tester/apps_7/HomePage.java",0,0.930555555555556,0,2,2
"wicket-core/src/test/java/org/apache/wicket/util/tester/apps_7/TestHomePage.java",0,0.95,0,2,2
"wicket-core/src/test/java/org/apache/wicket/util/tester/apps_7/WicketApplication.java",0,0.977272727272727,1,1,2
"wicket-core/src/test/java/org/apache/wicket/validation/ValidatorBehaviorTest.java",0,0.92964824120603,1,2,3
"wicket-core/src/test/java/org/apache/wicket/validation/validator/CreditCardValidatorTest.java",0,0.886792452830189,0,2,2
"wicket-core/src/test/java/org/apache/wicket/validation/validator/EmailValidatorTest.java",0,0.561643835616438,4,4,8
"wicket-core/src/test/java/org/apache/wicket/validation/validator/MaximumValidatorTest.java",0,0.903614457831325,0,2,2
"wicket-core/src/test/java/org/apache/wicket/validation/validator/MinimumValidatorTest.java",0,0.901234567901235,0,2,2
"wicket-core/src/test/java/org/apache/wicket/validation/validator/RangeValidatorTest.java",0,0.886363636363636,0,2,2
"wicket-core/src/test/java/org/apache/wicket/validation/validator/UrlValidatorTest.java",0,0.622159090909091,1,4,5
"wicket-core/src/test/java/org/apache/wicket/versioning/InMemoryPageStore.java",0,0.781818181818182,2,2,4
"wicket-core/src/test/java/org/apache/wicket/versioning/PageVersioningTest.java",0,0.895061728395062,4,1,5
"wicket-core/src/test/java/org/apache/wicket/versioning/VersioningTestPage.java",0,0.959459459459459,2,1,3
"wicket-datetime/src/main/java/org/apache/wicket/datetime/DateConverter.java",0,0.783898305084746,5,2,7
"wicket-datetime/src/main/java/org/apache/wicket/datetime/PatternDateConverter.java",0,0.798076923076923,1,3,4
"wicket-datetime/src/main/java/org/apache/wicket/datetime/StyleDateConverter.java",0,0.704918032786885,2,3,5
"wicket-datetime/src/main/java/org/apache/wicket/datetime/markup/html/basic/DateLabel.java",0,0.776699029126214,5,2,7
"wicket-datetime/src/main/java/org/apache/wicket/datetime/markup/html/form/DateTextField.java",0,0.684210526315789,5,3,8
"wicket-datetime/src/main/java/org/apache/wicket/extensions/yui/YuiLib.java",0,0.542857142857143,4,4,8
"wicket-datetime/src/main/java/org/apache/wicket/extensions/yui/calendar/AbstractCalendar.java",0,0.436781609195402,2,4,6
"wicket-datetime/src/main/java/org/apache/wicket/extensions/yui/calendar/DateField.java",0,0.567901234567901,3,2,5
"wicket-datetime/src/main/java/org/apache/wicket/extensions/yui/calendar/DatePicker.java",0,0.282633371169126,3,6,9
"wicket-datetime/src/main/java/org/apache/wicket/extensions/yui/calendar/DateTimeField.java",0,0.363963963963964,5,4,9
"wicket-datetime/src/main/java/org/apache/wicket/extensions/yui/calendar/TimeField.java",0,0.941176470588235,2,1,3
"wicket-datetime/src/test/java/org/apache/wicket/WicketTestCase.java",0,1,0,1,1
"wicket-datetime/src/test/java/org/apache/wicket/datetime/DateConverterTest.java",0,1,0,1,1
"wicket-datetime/src/test/java/org/apache/wicket/extensions/yui/calendar/DatePickerTest.java",0,0.595716198125837,1,3,4
"wicket-datetime/src/test/java/org/apache/wicket/extensions/yui/calendar/DatesPage1.java",0,0.951923076923077,1,1,2
"wicket-datetime/src/test/java/org/apache/wicket/extensions/yui/calendar/DatesPage2.java",0,0.886792452830189,0,2,2
"wicket-datetime/src/test/java/org/apache/wicket/util/license/ApacheLicenceHeaderTest.java",0,0.466666666666667,1,3,4
"wicket-datetime/src/test/java/org/apache/wicket/util/markup/xhtml/WellFormedXmlTest.java",0,0.941176470588235,0,2,2
"wicket-devutils/src/main/java/org/apache/wicket/devutils/DevUtilsPage.java",0,0.539473684210526,1,3,4
"wicket-devutils/src/main/java/org/apache/wicket/devutils/DevUtilsPanel.java",0,0.355932203389831,1,4,5
"wicket-devutils/src/main/java/org/apache/wicket/devutils/DevelopmentUtilitiesNotEnabledException.java",0,0.666666666666667,0,2,2
"wicket-devutils/src/main/java/org/apache/wicket/devutils/debugbar/DebugBar.java",0,0.653179190751445,4,2,6
"wicket-devutils/src/main/java/org/apache/wicket/devutils/debugbar/DebugBarInitializer.java",0,0.636363636363636,0,3,3
"wicket-devutils/src/main/java/org/apache/wicket/devutils/debugbar/IDebugBarContributor.java",0,0.685714285714286,0,2,2
"wicket-devutils/src/main/java/org/apache/wicket/devutils/debugbar/InspectorDebugPanel.java",0,0.630952380952381,1,3,4
"wicket-devutils/src/main/java/org/apache/wicket/devutils/debugbar/PageSizeDebugPanel.java",0,1,0,1,1
"wicket-devutils/src/main/java/org/apache/wicket/devutils/debugbar/SessionSizeDebugPanel.java",0,0.631067961165049,1,2,3
"wicket-devutils/src/main/java/org/apache/wicket/devutils/debugbar/StandardDebugPanel.java",0,0.621951219512195,1,3,4
"wicket-devutils/src/main/java/org/apache/wicket/devutils/debugbar/VersionDebugContributor.java",0,0.745098039215686,0,2,2
"wicket-devutils/src/main/java/org/apache/wicket/devutils/diskstore/DebugDiskDataStore.java",0,1,0,1,1
"wicket-devutils/src/main/java/org/apache/wicket/devutils/diskstore/DebugPageManagerProvider.java",0,1,0,1,1
"wicket-devutils/src/main/java/org/apache/wicket/devutils/diskstore/DiskStoreBrowserPage.java",0,1,0,1,1
"wicket-devutils/src/main/java/org/apache/wicket/devutils/diskstore/PageWindowModel.java",0,1,0,1,1
"wicket-devutils/src/main/java/org/apache/wicket/devutils/diskstore/browser/BrowserPanel.java",0,1,0,1,1
"wicket-devutils/src/main/java/org/apache/wicket/devutils/diskstore/browser/BrowserTable.java",0,1,0,1,1
"wicket-devutils/src/main/java/org/apache/wicket/devutils/diskstore/browser/DataStoreHelper.java",0,1,0,1,1
"wicket-devutils/src/main/java/org/apache/wicket/devutils/diskstore/browser/PageWindowColumn.java",0,1,0,1,1
"wicket-devutils/src/main/java/org/apache/wicket/devutils/diskstore/browser/PageWindowDescription.java",0,1,0,1,1
"wicket-devutils/src/main/java/org/apache/wicket/devutils/diskstore/browser/PageWindowProvider.java",0,1,0,1,1
"wicket-devutils/src/main/java/org/apache/wicket/devutils/diskstore/browser/SessionsProviderModel.java",0,1,0,1,1
"wicket-devutils/src/main/java/org/apache/wicket/devutils/inspector/ApplicationView.java",0,0.672413793103448,2,5,7
"wicket-devutils/src/main/java/org/apache/wicket/devutils/inspector/InspectorBug.java",0,0.490566037735849,2,5,7
"wicket-devutils/src/main/java/org/apache/wicket/devutils/inspector/InspectorPage.java",0,0.45,1,7,8
"wicket-devutils/src/main/java/org/apache/wicket/devutils/inspector/LiveSessionsPage.java",0,0.489010989010989,6,4,10
"wicket-devutils/src/main/java/org/apache/wicket/devutils/inspector/RenderPerformanceListener.java",0,1,0,1,1
"wicket-devutils/src/main/java/org/apache/wicket/devutils/inspector/RequestsPage.java",0,0.380952380952381,4,6,10
"wicket-devutils/src/main/java/org/apache/wicket/devutils/inspector/SessionSizeModel.java",0,0.642857142857143,0,3,3
"wicket-devutils/src/main/java/org/apache/wicket/devutils/inspector/SessionView.java",0,0.480769230769231,2,5,7
"wicket-devutils/src/main/java/org/apache/wicket/devutils/stateless/StatelessChecker.java",0,0.851239669421488,0,3,3
"wicket-devutils/src/main/java/org/apache/wicket/devutils/stateless/StatelessComponent.java",0,1,0,1,1
"wicket-devutils/src/test/java/org/apache/wicket/devutils/inspector/SessionSizeModelTest.java",0,0.690140845070423,0,2,2
"wicket-devutils/src/test/java/org/apache/wicket/devutils/stateless/StatelessCheckerTest.java",0,0.97,2,1,3
"wicket-devutils/src/test/java/org/apache/wicket/util/license/ApacheLicenceHeaderTest.java",0,1,0,1,1
"wicket-devutils/src/test/java/org/apache/wicket/util/markup/xhtml/WellFormedXmlTest.java",0,0.941176470588235,0,2,2
"wicket-examples/src/disabled/java/ng/NGApplication.java",0,0.666666666666667,0,2,2
"wicket-examples/src/disabled/java/ng/TestPage1.java",0,0.794520547945205,0,3,3
"wicket-examples/src/disabled/java/ng/TestPage2.java",0,0.571428571428571,0,2,2
"wicket-examples/src/disabled/java/ng/TestPage3.java",0,0.644444444444444,0,2,2
"wicket-examples/src/disabled/java/ng/TestPage4.java",0,0.571428571428571,1,2,3
"wicket-examples/src/main/java/org/apache/wicket/examples/HelloWorldServlet.java",0,0.962264150943396,2,1,3
"wicket-examples/src/main/java/org/apache/wicket/examples/ServerHostNameAndTimeFilter.java",0,0.875968992248062,4,1,5
"wicket-examples/src/main/java/org/apache/wicket/examples/WicketExampleApplication.java",0,0.188405797101449,2,6,8
"wicket-examples/src/main/java/org/apache/wicket/examples/WicketExampleHeader.java",0,0.23728813559322,0,8,8
"wicket-examples/src/main/java/org/apache/wicket/examples/WicketExamplePage.java",0,0.2,1,8,9
"wicket-examples/src/main/java/org/apache/wicket/examples/WicketExampleRequestCycle.java",0,0.528735632183908,1,3,4
"wicket-examples/src/main/java/org/apache/wicket/examples/ajax/builtin/AjaxApplication.java",0,0.258823529411765,2,6,8
"wicket-examples/src/main/java/org/apache/wicket/examples/ajax/builtin/AutoCompletePage.java",0,0.467889908256881,2,6,8
"wicket-examples/src/main/java/org/apache/wicket/examples/ajax/builtin/BasePage.java",0,0.371428571428571,1,6,7
"wicket-examples/src/main/java/org/apache/wicket/examples/ajax/builtin/ChoicePage.java",0,0.554621848739496,2,5,7
"wicket-examples/src/main/java/org/apache/wicket/examples/ajax/builtin/Clock.java",0,0.573333333333333,1,5,6
"wicket-examples/src/main/java/org/apache/wicket/examples/ajax/builtin/ClockPage.java",0,0.533333333333333,0,4,4
"wicket-examples/src/main/java/org/apache/wicket/examples/ajax/builtin/EditableLabelPage.java",0,0.75177304964539,2,4,6
"wicket-examples/src/main/java/org/apache/wicket/examples/ajax/builtin/EffectsPage.java",0,0.537735849056604,3,5,8
"wicket-examples/src/main/java/org/apache/wicket/examples/ajax/builtin/FileUploadPage.java",0,1,0,1,1
"wicket-examples/src/main/java/org/apache/wicket/examples/ajax/builtin/FormPage.java",0,0.439189189189189,3,5,8
"wicket-examples/src/main/java/org/apache/wicket/examples/ajax/builtin/GuestBook.java",0,0.56353591160221,1,5,6
"wicket-examples/src/main/java/org/apache/wicket/examples/ajax/builtin/Index.java",0,0.4375,1,3,4
"wicket-examples/src/main/java/org/apache/wicket/examples/ajax/builtin/LazyLoadingPage.java",0,0.905660377358491,0,2,2
"wicket-examples/src/main/java/org/apache/wicket/examples/ajax/builtin/LinksPage.java",0,0.380530973451327,1,8,9
"wicket-examples/src/main/java/org/apache/wicket/examples/ajax/builtin/OnChangeAjaxBehaviorPage.java",0,0.919540229885057,3,1,4
"wicket-examples/src/main/java/org/apache/wicket/examples/ajax/builtin/PageablesPage.java",0,0.514705882352941,3,4,7
"wicket-examples/src/main/java/org/apache/wicket/examples/ajax/builtin/RatingsPage.java",0,0.678861788617886,7,3,10
"wicket-examples/src/main/java/org/apache/wicket/examples/ajax/builtin/TabbedPanelPage.java",0,0.682926829268293,2,4,6
"wicket-examples/src/main/java/org/apache/wicket/examples/ajax/builtin/TodoList.java",0,0.738317757009346,5,4,9
"wicket-examples/src/main/java/org/apache/wicket/examples/ajax/builtin/WorldClockPage.java",0,0.628205128205128,3,4,7
"wicket-examples/src/main/java/org/apache/wicket/examples/ajax/builtin/modal/ModalContent1Page.java",0,0.411214953271028,3,5,8
"wicket-examples/src/main/java/org/apache/wicket/examples/ajax/builtin/modal/ModalContent2Page.java",0,0.346153846153846,2,4,6
"wicket-examples/src/main/java/org/apache/wicket/examples/ajax/builtin/modal/ModalPanel1.java",0,0.288461538461538,2,4,6
"wicket-examples/src/main/java/org/apache/wicket/examples/ajax/builtin/modal/ModalWindowPage.java",0,0.742857142857143,1,4,5
"wicket-examples/src/main/java/org/apache/wicket/examples/ajax/builtin/tree/BaseTreePage.java",0,0.604938271604938,3,4,7
"wicket-examples/src/main/java/org/apache/wicket/examples/ajax/builtin/tree/EditablePanel.java",0,0.396551724137931,1,4,5
"wicket-examples/src/main/java/org/apache/wicket/examples/ajax/builtin/tree/EditableTreeTablePage.java",0,0.371794871794872,2,5,7
"wicket-examples/src/main/java/org/apache/wicket/examples/ajax/builtin/tree/ModelBean.java",0,0.73936170212766,2,4,6
"wicket-examples/src/main/java/org/apache/wicket/examples/ajax/builtin/tree/PropertyEditableColumn.java",0,0.418918918918919,1,6,7
"wicket-examples/src/main/java/org/apache/wicket/examples/ajax/builtin/tree/SimpleTreePage.java",0,0.415094339622642,2,5,7
"wicket-examples/src/main/java/org/apache/wicket/examples/ajax/builtin/tree/TreeTablePage.java",0,0.357142857142857,2,5,7
"wicket-examples/src/main/java/org/apache/wicket/examples/ajax/prototype/Index.java",0,0.295238095238095,1,9,10
"wicket-examples/src/main/java/org/apache/wicket/examples/ajax/prototype/PrototypeApplication.java",0,0.220338983050847,3,6,9
"wicket-examples/src/main/java/org/apache/wicket/examples/asemail/MailTemplate.java",0,1,0,1,1
"wicket-examples/src/main/java/org/apache/wicket/examples/asemail/MailTemplateApplication.java",0,1,0,1,1
"wicket-examples/src/main/java/org/apache/wicket/examples/asemail/MailTemplatePanel.java",0,1,0,1,1
"wicket-examples/src/main/java/org/apache/wicket/examples/asemail/TemplateBasedOnPage.java",0,1,0,1,1
"wicket-examples/src/main/java/org/apache/wicket/examples/authentication1/AuthenticatedWebPage.java",0,0.5,0,5,5
"wicket-examples/src/main/java/org/apache/wicket/examples/authentication1/Home.java",0,0.433333333333333,1,5,6
"wicket-examples/src/main/java/org/apache/wicket/examples/authentication1/SignIn.java",0,0.357142857142857,3,4,7
"wicket-examples/src/main/java/org/apache/wicket/examples/authentication1/SignInApplication.java",0,0.567307692307692,5,4,9
"wicket-examples/src/main/java/org/apache/wicket/examples/authentication1/SignInSession.java",0,0.610526315789474,5,3,8
"wicket-examples/src/main/java/org/apache/wicket/examples/authentication1/SignOut.java",0,0.974358974358974,1,1,2
"wicket-examples/src/main/java/org/apache/wicket/examples/authentication2/AuthenticatedWebPage.java",0,0.464285714285714,3,3,6
"wicket-examples/src/main/java/org/apache/wicket/examples/authentication2/Home.java",0,0.351351351351351,0,5,5
"wicket-examples/src/main/java/org/apache/wicket/examples/authentication2/SignIn2.java",0,0.403846153846154,3,3,6
"wicket-examples/src/main/java/org/apache/wicket/examples/authentication2/SignIn2Application.java",0,0.523809523809524,5,3,8
"wicket-examples/src/main/java/org/apache/wicket/examples/authentication2/SignIn2Session.java",0,0.602150537634409,4,3,7
"wicket-examples/src/main/java/org/apache/wicket/examples/authentication2/SignOut.java",0,0.333333333333333,1,4,5
"wicket-examples/src/main/java/org/apache/wicket/examples/authentication3/AdminPage.java",0,0.433333333333333,4,2,6
"wicket-examples/src/main/java/org/apache/wicket/examples/authentication3/BasePage.java",0,0.857142857142857,1,2,3
"wicket-examples/src/main/java/org/apache/wicket/examples/authentication3/HomePage.java",0,0.62962962962963,1,3,4
"wicket-examples/src/main/java/org/apache/wicket/examples/authentication3/MyAuthenticatedWebApplication.java",0,0.352941176470588,4,3,7
"wicket-examples/src/main/java/org/apache/wicket/examples/authentication3/MyAuthenticatedWebSession.java",0,0.536231884057971,4,4,8
"wicket-examples/src/main/java/org/apache/wicket/examples/authentication3/MySignInPage.java",0,0.384615384615385,3,3,6
"wicket-examples/src/main/java/org/apache/wicket/examples/authentication3/SignOut.java",0,0.974358974358974,1,1,2
"wicket-examples/src/main/java/org/apache/wicket/examples/authorization/BasePage.java",0,0.925925925925926,2,1,3
"wicket-examples/src/main/java/org/apache/wicket/examples/authorization/Index.java",0,0.511111111111111,2,5,7
"wicket-examples/src/main/java/org/apache/wicket/examples/authorization/RolesApplication.java",0,0.488372093023256,4,3,7
"wicket-examples/src/main/java/org/apache/wicket/examples/authorization/RolesSession.java",0,0.714285714285714,3,2,5
"wicket-examples/src/main/java/org/apache/wicket/examples/authorization/User.java",0,0.78125,5,2,7
"wicket-examples/src/main/java/org/apache/wicket/examples/authorization/UserRolesAuthorizer.java",0,0.52,3,4,7
"wicket-examples/src/main/java/org/apache/wicket/examples/authorization/pages/AdminAnnotationsBookmarkablePage.java",0,0.5,3,3,6
"wicket-examples/src/main/java/org/apache/wicket/examples/authorization/pages/AdminAnnotationsInternalPage.java",0,0.512820512820513,3,3,6
"wicket-examples/src/main/java/org/apache/wicket/examples/authorization/pages/AdminBookmarkablePage.java",0,0.512820512820513,2,4,6
"wicket-examples/src/main/java/org/apache/wicket/examples/authorization/pages/AdminInternalPage.java",0,0.547619047619048,4,2,6
"wicket-examples/src/main/java/org/apache/wicket/examples/authorization/pages/AnnotationsPanelsPage.java",0,0.763736263736264,4,3,7
"wicket-examples/src/main/java/org/apache/wicket/examples/authorization/pages/PanelsPage.java",0,0.782178217821782,4,2,6
"wicket-examples/src/main/java/org/apache/wicket/examples/breadcrumb/BreadCrumbApplication.java",0,0.354166666666667,1,4,5
"wicket-examples/src/main/java/org/apache/wicket/examples/breadcrumb/FirstPanel.java",0,0.63265306122449,0,3,3
"wicket-examples/src/main/java/org/apache/wicket/examples/breadcrumb/FourthPanel.java",0,0.638297872340426,0,3,3
"wicket-examples/src/main/java/org/apache/wicket/examples/breadcrumb/Index.java",0,0.560975609756098,1,3,4
"wicket-examples/src/main/java/org/apache/wicket/examples/breadcrumb/ResultPanel.java",0,0.672413793103448,0,3,3
"wicket-examples/src/main/java/org/apache/wicket/examples/breadcrumb/SecondPanel.java",0,0.777777777777778,2,3,5
"wicket-examples/src/main/java/org/apache/wicket/examples/breadcrumb/ThirdPanel.java",0,0.638297872340426,0,3,3
"wicket-examples/src/main/java/org/apache/wicket/examples/captcha/Captcha.java",0,0.706349206349206,5,3,8
"wicket-examples/src/main/java/org/apache/wicket/examples/captcha/CaptchaApplication.java",0,0.568181818181818,1,3,4
"wicket-examples/src/main/java/org/apache/wicket/examples/compref/Address.java",0,0.746153846153846,2,3,5
"wicket-examples/src/main/java/org/apache/wicket/examples/compref/AnotherPanel.java",0,0.473684210526316,1,4,5
"wicket-examples/src/main/java/org/apache/wicket/examples/compref/Book.java",0,0.722772277227723,1,3,4
"wicket-examples/src/main/java/org/apache/wicket/examples/compref/BookmarkablePage.java",0,0.48780487804878,4,4,8
"wicket-examples/src/main/java/org/apache/wicket/examples/compref/BookmarkablePageLinkPage.java",0,0.357142857142857,4,5,9
"wicket-examples/src/main/java/org/apache/wicket/examples/compref/BorderPage.java",0,0.310344827586207,2,6,8
"wicket-examples/src/main/java/org/apache/wicket/examples/compref/ButtonPage.java",0,0.401785714285714,3,5,8
"wicket-examples/src/main/java/org/apache/wicket/examples/compref/CheckBoxMultipleChoicePage.java",0,0.691176470588235,2,4,6
"wicket-examples/src/main/java/org/apache/wicket/examples/compref/CheckBoxPage.java",0,0.530612244897959,3,5,8
"wicket-examples/src/main/java/org/apache/wicket/examples/compref/CheckBoxSelectorPage.java",0,1,0,1,1
"wicket-examples/src/main/java/org/apache/wicket/examples/compref/CheckGroupPage.java",0,0.309090909090909,0,5,5
"wicket-examples/src/main/java/org/apache/wicket/examples/compref/CheckGroupPage2.java",0,1,0,1,1
"wicket-examples/src/main/java/org/apache/wicket/examples/compref/ComponentReferenceApplication.java",0,0.480519480519481,2,4,6
"wicket-examples/src/main/java/org/apache/wicket/examples/compref/Count.java",0,1,0,1,1
"wicket-examples/src/main/java/org/apache/wicket/examples/compref/DropDownChoicePage.java",0,0.385416666666667,3,5,8
"wicket-examples/src/main/java/org/apache/wicket/examples/compref/ExplainPanel.java",0,0.414634146341463,0,5,5
"wicket-examples/src/main/java/org/apache/wicket/examples/compref/ExternalLinkPage.java",0,0.392156862745098,2,5,7
"wicket-examples/src/main/java/org/apache/wicket/examples/compref/FormPage.java",0,0.333333333333333,1,6,7
"wicket-examples/src/main/java/org/apache/wicket/examples/compref/FragmentPage.java",0,0.577464788732394,0,5,5
"wicket-examples/src/main/java/org/apache/wicket/examples/compref/IncludePage.java",0,0.326923076923077,1,6,7
"wicket-examples/src/main/java/org/apache/wicket/examples/compref/Index.java",0,0.382352941176471,1,4,5
"wicket-examples/src/main/java/org/apache/wicket/examples/compref/LabelPage.java",0,0.351063829787234,1,6,7
"wicket-examples/src/main/java/org/apache/wicket/examples/compref/LinkPage.java",0,0.428571428571429,3,4,7
"wicket-examples/src/main/java/org/apache/wicket/examples/compref/ListChoicePage.java",0,0.476635514018692,2,6,8
"wicket-examples/src/main/java/org/apache/wicket/examples/compref/ListMultipleChoicePage.java",0,0.367741935483871,3,7,10
"wicket-examples/src/main/java/org/apache/wicket/examples/compref/MultiLineLabelPage.java",0,0.245614035087719,1,6,7
"wicket-examples/src/main/java/org/apache/wicket/examples/compref/MyBorder.java",0,0.473684210526316,1,4,5
"wicket-examples/src/main/java/org/apache/wicket/examples/compref/MyPanel.java",0,0.463414634146341,1,4,5
"wicket-examples/src/main/java/org/apache/wicket/examples/compref/NonBookmarkablePage.java",0,0.352941176470588,1,5,6
"wicket-examples/src/main/java/org/apache/wicket/examples/compref/PalettePage.java",0,0.569620253164557,1,4,5
"wicket-examples/src/main/java/org/apache/wicket/examples/compref/PanelPage.java",0,0.369565217391304,1,6,7
"wicket-examples/src/main/java/org/apache/wicket/examples/compref/Person.java",0,0.687898089171974,2,3,5
"wicket-examples/src/main/java/org/apache/wicket/examples/compref/RadioChoicePage.java",0,0.471153846153846,3,5,8
"wicket-examples/src/main/java/org/apache/wicket/examples/compref/RadioGroupPage.java",0,0.32,0,5,5
"wicket-examples/src/main/java/org/apache/wicket/examples/compref/RadioGroupPage2.java",0,1,0,1,1
"wicket-examples/src/main/java/org/apache/wicket/examples/compref/SelectPage.java",0,0.441340782122905,1,6,7
"wicket-examples/src/main/java/org/apache/wicket/examples/compref/SubmitLinkPage.java",0,0.527472527472527,2,4,6
"wicket-examples/src/main/java/org/apache/wicket/examples/compref/TabbedPanelPage.java",0,0.71304347826087,3,5,8
"wicket-examples/src/main/java/org/apache/wicket/examples/compref/TextAreaPage.java",0,0.51685393258427,2,5,7
"wicket-examples/src/main/java/org/apache/wicket/examples/compref/TextFieldPage.java",0,0.354838709677419,2,6,8
"wicket-examples/src/main/java/org/apache/wicket/examples/compref/XmlPage.java",0,0.584415584415584,2,4,6
"wicket-examples/src/main/java/org/apache/wicket/examples/customresourceloading/AlternativePageFromWebContext.java",0,0.486486486486487,2,3,5
"wicket-examples/src/main/java/org/apache/wicket/examples/customresourceloading/CustomResourceLoadingApplication.java",0,0.672,5,3,8
"wicket-examples/src/main/java/org/apache/wicket/examples/customresourceloading/Index.java",0,0.525,0,4,4
"wicket-examples/src/main/java/org/apache/wicket/examples/customresourceloading/PageFromWebContext.java",0,0.486486486486487,2,3,5
"wicket-examples/src/main/java/org/apache/wicket/examples/customresourceloading/PageWithCustomLoading.java",0,0.550561797752809,3,4,7
"wicket-examples/src/main/java/org/apache/wicket/examples/dates/DatesApplication.java",0,0.928571428571429,2,1,3
"wicket-examples/src/main/java/org/apache/wicket/examples/dates/DatesPage.java",0,0.712389380530973,4,3,7
"wicket-examples/src/main/java/org/apache/wicket/examples/echo/Echo.java",0,0.633802816901408,2,3,5
"wicket-examples/src/main/java/org/apache/wicket/examples/echo/EchoApplication.java",0,0.555555555555556,2,3,5
"wicket-examples/src/main/java/org/apache/wicket/examples/encodings/EncodingsApplication.java",0,0.377777777777778,2,4,6
"wicket-examples/src/main/java/org/apache/wicket/examples/encodings/Home.java",0,0.394366197183099,3,4,7
"wicket-examples/src/main/java/org/apache/wicket/examples/events/BasePage.java",0,1,0,1,1
"wicket-examples/src/main/java/org/apache/wicket/examples/events/DecoupledAjaxUpdatePage.java",0,1,0,1,1
"wicket-examples/src/main/java/org/apache/wicket/examples/events/EventsApplication.java",0,1,0,1,1
"wicket-examples/src/main/java/org/apache/wicket/examples/events/IndexPage.java",0,1,0,1,1
"wicket-examples/src/main/java/org/apache/wicket/examples/forminput/BeforeAndAfterBorder.java",0,0.818181818181818,1,3,4
"wicket-examples/src/main/java/org/apache/wicket/examples/forminput/FormInput.java",0,0.441666666666667,6,4,10
"wicket-examples/src/main/java/org/apache/wicket/examples/forminput/FormInputApplication.java",0,0.455284552845528,4,4,8
"wicket-examples/src/main/java/org/apache/wicket/examples/forminput/FormInputModel.java",0,0.762589928057554,4,3,7
"wicket-examples/src/main/java/org/apache/wicket/examples/forminput/Multiply.java",0,0.738095238095238,1,3,4
"wicket-examples/src/main/java/org/apache/wicket/examples/forminput/UsPhoneNumber.java",0,0.742857142857143,2,2,4
"wicket-examples/src/main/java/org/apache/wicket/examples/frames/BodyFrame.java",0,0.547619047619048,2,4,6
"wicket-examples/src/main/java/org/apache/wicket/examples/frames/ExampleFrame.java",0,1,0,1,1
"wicket-examples/src/main/java/org/apache/wicket/examples/frames/FrameTarget.java",0,0.563218390804598,2,4,6
"wicket-examples/src/main/java/org/apache/wicket/examples/frames/FramesApplication.java",0,0.568181818181818,1,3,4
"wicket-examples/src/main/java/org/apache/wicket/examples/frames/Home.java",0,0.36734693877551,2,3,5
"wicket-examples/src/main/java/org/apache/wicket/examples/frames/LeftFrame.java",0,0.609090909090909,2,4,6
"wicket-examples/src/main/java/org/apache/wicket/examples/frames/Page1.java",0,0.529411764705882,1,3,4
"wicket-examples/src/main/java/org/apache/wicket/examples/frames/Page2.java",0,0.529411764705882,1,3,4
"wicket-examples/src/main/java/org/apache/wicket/examples/frames/TopFrame.java",0,0.529411764705882,1,3,4
"wicket-examples/src/main/java/org/apache/wicket/examples/guestbook/Comment.java",0,0.617021276595745,1,4,5
"wicket-examples/src/main/java/org/apache/wicket/examples/guestbook/GuestBook.java",0,0.340909090909091,3,6,9
"wicket-examples/src/main/java/org/apache/wicket/examples/guestbook/GuestBookApplication.java",0,0.288888888888889,0,5,5
"wicket-examples/src/main/java/org/apache/wicket/examples/guice/GuiceApplication.java",0,0.857142857142857,3,2,5
"wicket-examples/src/main/java/org/apache/wicket/examples/guice/HomePage.java",0,0.878787878787879,2,2,4
"wicket-examples/src/main/java/org/apache/wicket/examples/guice/service/IMyService.java",0,0.971428571428571,1,1,2
"wicket-examples/src/main/java/org/apache/wicket/examples/guice/service/MyService.java",0,1,0,1,1
"wicket-examples/src/main/java/org/apache/wicket/examples/hangman/Game.java",0,0.713333333333333,2,5,7
"wicket-examples/src/main/java/org/apache/wicket/examples/hangman/Guess.java",0,0.398230088495575,3,6,9
"wicket-examples/src/main/java/org/apache/wicket/examples/hangman/HangmanApplication.java",0,0.327586206896552,2,5,7
"wicket-examples/src/main/java/org/apache/wicket/examples/hangman/HangmanPage.java",0,0.431818181818182,2,3,5
"wicket-examples/src/main/java/org/apache/wicket/examples/hangman/HangmanSession.java",0,0.588235294117647,5,2,7
"wicket-examples/src/main/java/org/apache/wicket/examples/hangman/Home.java",0,0.333333333333333,4,4,8
"wicket-examples/src/main/java/org/apache/wicket/examples/hangman/Letter.java",0,0.554878048780488,3,3,6
"wicket-examples/src/main/java/org/apache/wicket/examples/hangman/Lose.java",0,0.340425531914894,4,4,8
"wicket-examples/src/main/java/org/apache/wicket/examples/hangman/Win.java",0,0.297872340425532,3,5,8
"wicket-examples/src/main/java/org/apache/wicket/examples/hangman/Word.java",0,0.786206896551724,6,2,8
"wicket-examples/src/main/java/org/apache/wicket/examples/hangman/WordGenerator.java",0,0.555555555555556,3,4,7
"wicket-examples/src/main/java/org/apache/wicket/examples/hellobrowser/HelloBrowser.java",0,0.629213483146067,2,4,6
"wicket-examples/src/main/java/org/apache/wicket/examples/hellobrowser/HelloBrowserApplication.java",0,0.482142857142857,1,5,6
"wicket-examples/src/main/java/org/apache/wicket/examples/helloworld/HelloWorld.java",0,0.351351351351351,0,6,6
"wicket-examples/src/main/java/org/apache/wicket/examples/helloworld/HelloWorldApplication.java",0,0.318181818181818,2,4,6
"wicket-examples/src/main/java/org/apache/wicket/examples/homepage/HomePage.java",0,1,0,1,1
"wicket-examples/src/main/java/org/apache/wicket/examples/homepage/HomePageApplication.java",0,1,0,1,1
"wicket-examples/src/main/java/org/apache/wicket/examples/images/Home.java",0,0.38255033557047,2,5,7
"wicket-examples/src/main/java/org/apache/wicket/examples/images/ImagesApplication.java",0,0.220338983050847,1,6,7
"wicket-examples/src/main/java/org/apache/wicket/examples/kittenCaptcha/HomePage.java",0,0.964705882352941,1,1,2
"wicket-examples/src/main/java/org/apache/wicket/examples/kittenCaptcha/WicketApplication.java",0,1,0,1,1
"wicket-examples/src/main/java/org/apache/wicket/examples/library/AuthenticatedWebPage.java",0,0.321428571428571,4,5,9
"wicket-examples/src/main/java/org/apache/wicket/examples/library/Book.java",0,0.822222222222222,5,2,7
"wicket-examples/src/main/java/org/apache/wicket/examples/library/BookDetails.java",0,0.541984732824427,3,4,7
"wicket-examples/src/main/java/org/apache/wicket/examples/library/EditBook.java",0,0.5,2,6,8
"wicket-examples/src/main/java/org/apache/wicket/examples/library/Home.java",0,0.297619047619048,2,6,8
"wicket-examples/src/main/java/org/apache/wicket/examples/library/LibraryApplication.java",0,0.423913043478261,4,3,7
"wicket-examples/src/main/java/org/apache/wicket/examples/library/LibrarySession.java",0,0.658730158730159,5,3,8
"wicket-examples/src/main/java/org/apache/wicket/examples/library/SignIn.java",0,0.387755102040816,2,4,6
"wicket-examples/src/main/java/org/apache/wicket/examples/library/SignOut.java",0,0.974358974358974,1,1,2
"wicket-examples/src/main/java/org/apache/wicket/examples/library/User.java",0,0.450704225352113,1,4,5
"wicket-examples/src/main/java/org/apache/wicket/examples/linkomatic/Book.java",0,0.473684210526316,0,4,4
"wicket-examples/src/main/java/org/apache/wicket/examples/linkomatic/BookDetails.java",0,0.325,0,5,5
"wicket-examples/src/main/java/org/apache/wicket/examples/linkomatic/Home.java",0,0.334519572953737,4,5,9
"wicket-examples/src/main/java/org/apache/wicket/examples/linkomatic/LinkomaticApplication.java",0,0.236363636363636,2,6,8
"wicket-examples/src/main/java/org/apache/wicket/examples/linkomatic/Page1.java",0,0.325,1,5,6
"wicket-examples/src/main/java/org/apache/wicket/examples/linkomatic/Page2.java",0,0.342105263157895,0,5,5
"wicket-examples/src/main/java/org/apache/wicket/examples/linkomatic/Page3.java",0,0.317073170731707,1,5,6
"wicket-examples/src/main/java/org/apache/wicket/examples/linkomatic/Popup.java",0,0.486486486486487,0,4,4
"wicket-examples/src/main/java/org/apache/wicket/examples/navomatic/NavomaticApplication.java",0,0.282608695652174,0,6,6
"wicket-examples/src/main/java/org/apache/wicket/examples/navomatic/NavomaticBorder.java",0,0.317073170731707,2,4,6
"wicket-examples/src/main/java/org/apache/wicket/examples/navomatic/Page1.java",0,0.371428571428571,1,5,6
"wicket-examples/src/main/java/org/apache/wicket/examples/navomatic/Page2.java",0,0.361111111111111,2,4,6
"wicket-examples/src/main/java/org/apache/wicket/examples/navomatic/Page3.java",0,0.371428571428571,2,4,6
"wicket-examples/src/main/java/org/apache/wicket/examples/nested/Home.java",0,0.613333333333333,3,5,8
"wicket-examples/src/main/java/org/apache/wicket/examples/nested/NestedApplication.java",0,0.232142857142857,1,6,7
"wicket-examples/src/main/java/org/apache/wicket/examples/nested/RecursivePanel.java",0,0.508928571428571,1,6,7
"wicket-examples/src/main/java/org/apache/wicket/examples/niceurl/Home.java",0,0.491228070175439,0,4,4
"wicket-examples/src/main/java/org/apache/wicket/examples/niceurl/NiceUrlApplication.java",0,0.422535211267606,3,4,7
"wicket-examples/src/main/java/org/apache/wicket/examples/niceurl/Page1.java",0,0.5,0,4,4
"wicket-examples/src/main/java/org/apache/wicket/examples/niceurl/Page2.java",0,0.516666666666667,2,4,6
"wicket-examples/src/main/java/org/apache/wicket/examples/niceurl/Page2QP.java",0,0.564102564102564,2,3,5
"wicket-examples/src/main/java/org/apache/wicket/examples/niceurl/mounted/Page3.java",0,0.48780487804878,0,4,4
"wicket-examples/src/main/java/org/apache/wicket/examples/niceurl/mounted/Page4.java",0,0.48780487804878,0,4,4
"wicket-examples/src/main/java/org/apache/wicket/examples/niceurl/mounted/Page5.java",0,0.415730337078652,1,4,5
"wicket-examples/src/main/java/org/apache/wicket/examples/pub/Home.java",0,0.335820895522388,4,5,9
"wicket-examples/src/main/java/org/apache/wicket/examples/pub/PubApplication.java",0,0.288888888888889,1,4,5
"wicket-examples/src/main/java/org/apache/wicket/examples/pub2/Home.java",0,1,0,1,1
"wicket-examples/src/main/java/org/apache/wicket/examples/pub2/PubApplication.java",0,1,0,1,1
"wicket-examples/src/main/java/org/apache/wicket/examples/repeater/AjaxDataTablePage.java",0,0.359375,0,5,5
"wicket-examples/src/main/java/org/apache/wicket/examples/repeater/BasePage.java",0,0.57843137254902,1,4,5
"wicket-examples/src/main/java/org/apache/wicket/examples/repeater/Contact.java",0,0.853107344632768,4,2,6
"wicket-examples/src/main/java/org/apache/wicket/examples/repeater/ContactDataProvider.java",0,0.519480519480519,2,4,6
"wicket-examples/src/main/java/org/apache/wicket/examples/repeater/ContactGenerator.java",0,0.71304347826087,1,3,4
"wicket-examples/src/main/java/org/apache/wicket/examples/repeater/ContactsDatabase.java",0,0.72680412371134,2,4,6
"wicket-examples/src/main/java/org/apache/wicket/examples/repeater/DataGridPage.java",0,0.42,1,4,5
"wicket-examples/src/main/java/org/apache/wicket/examples/repeater/DataTablePage.java",0,0.378048780487805,1,5,6
"wicket-examples/src/main/java/org/apache/wicket/examples/repeater/DatabaseLocator.java",0,0.567567567567568,1,3,4
"wicket-examples/src/main/java/org/apache/wicket/examples/repeater/DetachableContactModel.java",0,0.555555555555556,1,4,5
"wicket-examples/src/main/java/org/apache/wicket/examples/repeater/ExamplePage.java",0,0.513513513513513,0,4,4
"wicket-examples/src/main/java/org/apache/wicket/examples/repeater/FormPage.java",0,0.583892617449664,2,4,6
"wicket-examples/src/main/java/org/apache/wicket/examples/repeater/GridViewPage.java",0,0.459016393442623,1,5,6
"wicket-examples/src/main/java/org/apache/wicket/examples/repeater/Index.java",0,0.588235294117647,1,2,3
"wicket-examples/src/main/java/org/apache/wicket/examples/repeater/OIRPage.java",0,0.611464968152866,0,5,5
"wicket-examples/src/main/java/org/apache/wicket/examples/repeater/PagingPage.java",0,0.546666666666667,0,5,5
"wicket-examples/src/main/java/org/apache/wicket/examples/repeater/RefreshingPage.java",0,0.554545454545455,0,6,6
"wicket-examples/src/main/java/org/apache/wicket/examples/repeater/RepeaterApplication.java",0,0.571428571428571,2,3,5
"wicket-examples/src/main/java/org/apache/wicket/examples/repeater/RepeatingPage.java",0,0.597402597402597,1,5,6
"wicket-examples/src/main/java/org/apache/wicket/examples/repeater/SimplePage.java",0,0.522388059701492,0,5,5
"wicket-examples/src/main/java/org/apache/wicket/examples/repeater/SortableContactDataProvider.java",0,0.611111111111111,1,4,5
"wicket-examples/src/main/java/org/apache/wicket/examples/repeater/SortingPage.java",0,0.575757575757576,1,5,6
"wicket-examples/src/main/java/org/apache/wicket/examples/requestmapper/CustomHomeMapper.java",0,1,0,1,1
"wicket-examples/src/main/java/org/apache/wicket/examples/requestmapper/HttpsPage.java",0,1,0,1,1
"wicket-examples/src/main/java/org/apache/wicket/examples/requestmapper/LocaleFirstMapper.java",0,0.7578125,0,2,2
"wicket-examples/src/main/java/org/apache/wicket/examples/requestmapper/LocaleHelper.java",0,0.917647058823529,0,2,2
"wicket-examples/src/main/java/org/apache/wicket/examples/requestmapper/LocalizedPage.java",0,1,0,1,1
"wicket-examples/src/main/java/org/apache/wicket/examples/requestmapper/MapperDemoResourceReference.java",0,1,0,1,1
"wicket-examples/src/main/java/org/apache/wicket/examples/requestmapper/RequestMapperApplication.java",0,0.990476190476191,1,1,2
"wicket-examples/src/main/java/org/apache/wicket/examples/requestmapper/RequestMapperHomePage.java",0,1,0,1,1
"wicket-examples/src/main/java/org/apache/wicket/examples/requestmapper/packageMount/PackageMountedPage.java",0,1,0,1,1
"wicket-examples/src/main/java/org/apache/wicket/examples/resourcedecoration/BasicGroupingKey.java",0,1,0,1,1
"wicket-examples/src/main/java/org/apache/wicket/examples/resourcedecoration/GroupedAndOrderedResourceReference.java",0,1,0,1,1
"wicket-examples/src/main/java/org/apache/wicket/examples/resourcedecoration/GroupingAndFilteringHeaderResponse.java",0,1,0,1,1
"wicket-examples/src/main/java/org/apache/wicket/examples/resourcedecoration/GroupingHeaderResponse.java",0,1,0,1,1
"wicket-examples/src/main/java/org/apache/wicket/examples/resourcedecoration/HomePage.java",0,1,0,1,1
"wicket-examples/src/main/java/org/apache/wicket/examples/resourcedecoration/HttpAggregatingResourceReferenceCollection.java",0,1,0,1,1
"wicket-examples/src/main/java/org/apache/wicket/examples/resourcedecoration/MergedResourcesResource.java",0,1,0,1,1
"wicket-examples/src/main/java/org/apache/wicket/examples/resourcedecoration/ResourceDecorationApplication.java",0,1,0,1,1
"wicket-examples/src/main/java/org/apache/wicket/examples/source/SourcesPage.java",0,0.348242811501597,5,5,10
"wicket-examples/src/main/java/org/apache/wicket/examples/spring/annot/web/AnnotPage.java",0,0.346938775510204,0,5,5
"wicket-examples/src/main/java/org/apache/wicket/examples/spring/annot/web/ProxyDataProvider.java",0,0.363636363636364,2,4,6
"wicket-examples/src/main/java/org/apache/wicket/examples/spring/annot/web/ProxyModel.java",0,0.384615384615385,1,4,5
"wicket-examples/src/main/java/org/apache/wicket/examples/spring/common/Contact.java",0,0.897142857142857,5,1,6
"wicket-examples/src/main/java/org/apache/wicket/examples/spring/common/ContactDao.java",0,0.63265306122449,1,3,4
"wicket-examples/src/main/java/org/apache/wicket/examples/spring/common/ContactDaoImpl.java",0,0.55050505050505,3,3,6
"wicket-examples/src/main/java/org/apache/wicket/examples/spring/common/ContactGenerator.java",0,0.586206896551724,0,4,4
"wicket-examples/src/main/java/org/apache/wicket/examples/spring/common/QueryParam.java",0,0.590361445783133,1,4,5
"wicket-examples/src/main/java/org/apache/wicket/examples/spring/common/web/BasePage.java",0,0.361111111111111,3,3,6
"wicket-examples/src/main/java/org/apache/wicket/examples/spring/common/web/ContactDataProvider.java",0,0.433962264150943,1,5,6
"wicket-examples/src/main/java/org/apache/wicket/examples/spring/common/web/ContactDetachableModel.java",0,0.352941176470588,1,4,5
"wicket-examples/src/main/java/org/apache/wicket/examples/spring/common/web/ContactsDisplayPage.java",0,0.352941176470588,1,4,5
"wicket-examples/src/main/java/org/apache/wicket/examples/spring/common/web/ExampleApplication.java",0,0.459016393442623,3,4,7
"wicket-examples/src/main/java/org/apache/wicket/examples/spring/common/web/HomePage.java",0,0.810810810810811,2,3,5
"wicket-examples/src/main/java/org/apache/wicket/examples/stateless/Index.java",0,0.571428571428571,1,5,6
"wicket-examples/src/main/java/org/apache/wicket/examples/stateless/SessionModel.java",0,0.535714285714286,1,4,5
"wicket-examples/src/main/java/org/apache/wicket/examples/stateless/StatefulPage.java",0,0.730769230769231,1,4,5
"wicket-examples/src/main/java/org/apache/wicket/examples/stateless/StatelessApplication.java",0,0.491525423728814,3,4,7
"wicket-examples/src/main/java/org/apache/wicket/examples/stateless/StatelessPage.java",0,0.457142857142857,6,4,10
"wicket-examples/src/main/java/org/apache/wicket/examples/stateless/StatelessPage1.java",0,0.802816901408451,2,3,5
"wicket-examples/src/main/java/org/apache/wicket/examples/stateless/StatelessPage2.java",0,0.802816901408451,2,3,5
"wicket-examples/src/main/java/org/apache/wicket/examples/stateless/StatelessPage3.java",0,0.612903225806452,1,4,5
"wicket-examples/src/main/java/org/apache/wicket/examples/stockquote/StockQuote.java",0,0.811659192825112,5,3,8
"wicket-examples/src/main/java/org/apache/wicket/examples/stockquote/StockQuoteApplication.java",0,0.288888888888889,2,5,7
"wicket-examples/src/main/java/org/apache/wicket/examples/stockquote/StockQuoteLabel.java",0,0.524390243902439,3,4,7
"wicket-examples/src/main/java/org/apache/wicket/examples/stockquote/StockQuoteLabel2.java",0,0.509433962264151,1,4,5
"wicket-examples/src/main/java/org/apache/wicket/examples/stockquote/StockQuotePage.java",0,0.64,3,4,7
"wicket-examples/src/main/java/org/apache/wicket/examples/template/Banner.java",0,0.4,1,5,6
"wicket-examples/src/main/java/org/apache/wicket/examples/template/Banner1.java",0,0.387755102040816,3,4,7
"wicket-examples/src/main/java/org/apache/wicket/examples/template/Banner2.java",0,0.387755102040816,3,4,7
"wicket-examples/src/main/java/org/apache/wicket/examples/template/Index.java",0,0.382352941176471,2,4,6
"wicket-examples/src/main/java/org/apache/wicket/examples/template/TemplateApplication.java",0,0.288888888888889,0,6,6
"wicket-examples/src/main/java/org/apache/wicket/examples/template/border/Page1.java",0,0.333333333333333,1,4,5
"wicket-examples/src/main/java/org/apache/wicket/examples/template/border/Page2.java",0,0.371428571428571,1,4,5
"wicket-examples/src/main/java/org/apache/wicket/examples/template/border/TemplateBorder.java",0,0.5,2,5,7
"wicket-examples/src/main/java/org/apache/wicket/examples/template/pageinheritance/Page1.java",0,0.361111111111111,1,5,6
"wicket-examples/src/main/java/org/apache/wicket/examples/template/pageinheritance/Page2.java",0,0.371428571428571,0,5,5
"wicket-examples/src/main/java/org/apache/wicket/examples/template/pageinheritance/Panel1.java",0,0.519230769230769,2,3,5
"wicket-examples/src/main/java/org/apache/wicket/examples/template/pageinheritance/TemplatePage.java",0,0.505494505494505,1,5,6
"wicket-examples/src/main/java/org/apache/wicket/examples/template/pageinheritance/TemplatePanel.java",0,0.509433962264151,2,3,5
"wicket-examples/src/main/java/org/apache/wicket/examples/unicodeconverter/UnicodeConverter.java",0,0.657142857142857,2,4,6
"wicket-examples/src/main/java/org/apache/wicket/examples/unicodeconverter/UnicodeConverterApplication.java",0,0.568181818181818,2,3,5
"wicket-examples/src/main/java/org/apache/wicket/examples/upload/MultiUploadPage.java",0,0.698630136986301,4,4,8
"wicket-examples/src/main/java/org/apache/wicket/examples/upload/UploadApplication.java",0,0.346153846153846,2,6,8
"wicket-examples/src/main/java/org/apache/wicket/examples/upload/UploadPage.java",0,0.461883408071749,6,6,12
"wicket-examples/src/main/java/org/apache/wicket/examples/velocity/DynamicPage.java",0,0.810810810810811,5,2,7
"wicket-examples/src/main/java/org/apache/wicket/examples/velocity/Field.java",0,0.432098765432099,0,3,3
"wicket-examples/src/main/java/org/apache/wicket/examples/velocity/Home.java",0,0.846153846153846,1,2,3
"wicket-examples/src/main/java/org/apache/wicket/examples/velocity/Person.java",0,1,0,1,1
"wicket-examples/src/main/java/org/apache/wicket/examples/velocity/TemplatePage.java",0,0.792,3,3,6
"wicket-examples/src/main/java/org/apache/wicket/examples/velocity/VelocityTemplateApplication.java",0,0.877358490566038,2,2,4
"wicket-examples/src/main/java/org/apache/wicket/examples/wizard/Index.java",0,0.58974358974359,0,5,5
"wicket-examples/src/main/java/org/apache/wicket/examples/wizard/NewUserWizard.java",0,0.707692307692308,1,5,6
"wicket-examples/src/main/java/org/apache/wicket/examples/wizard/StaticWizard.java",0,0.61038961038961,1,4,5
"wicket-examples/src/main/java/org/apache/wicket/examples/wizard/StaticWizardWithPanels.java",0,0.741666666666667,1,4,5
"wicket-examples/src/main/java/org/apache/wicket/examples/wizard/User.java",0,0.896907216494845,2,2,4
"wicket-examples/src/main/java/org/apache/wicket/examples/wizard/WizardApplication.java",0,0.375,2,4,6
"wicket-examples/src/main/java/org/apache/wicket/examples/wizard/WizardPage.java",0,0.596491228070175,1,4,5
"wicket-examples/src/test/java/org/apache/wicket/examples/ClassLocator.java",0,0.575757575757576,1,2,3
"wicket-examples/src/test/java/org/apache/wicket/examples/JettyTestCaseDecorator.java",0,0.872727272727273,4,1,5
"wicket-examples/src/test/java/org/apache/wicket/examples/StartExamples.java",0,0.476744186046512,4,3,7
"wicket-examples/src/test/java/org/apache/wicket/examples/WicketTestCase.java",0,0.55,0,2,2
"wicket-examples/src/test/java/org/apache/wicket/examples/WicketWebTestCase.java",0,0.603960396039604,5,3,8
"wicket-examples/src/test/java/org/apache/wicket/examples/ajax/prototype/AjaxTest.java",0,0.34,1,4,5
"wicket-examples/src/test/java/org/apache/wicket/examples/compref/ComprefTest.java",0,0.473684210526316,0,5,5
"wicket-examples/src/test/java/org/apache/wicket/examples/encodings/EncodingTest.java",0,0.447368421052632,0,5,5
"wicket-examples/src/test/java/org/apache/wicket/examples/forminput/FormInputTest.java",0,0.444444444444444,0,5,5
"wicket-examples/src/test/java/org/apache/wicket/examples/guestbook/GuestbookTest.java",0,0.381578947368421,4,3,7
"wicket-examples/src/test/java/org/apache/wicket/examples/hangman/HangManTest.java",0,0.617224880382775,6,3,9
"wicket-examples/src/test/java/org/apache/wicket/examples/hangman/WordGeneratorTest.java",0,0.38961038961039,3,5,8
"wicket-examples/src/test/java/org/apache/wicket/examples/helloworld/HelloWorldTest.java",0,0.351351351351351,0,6,6
"wicket-examples/src/test/java/org/apache/wicket/examples/images/ImagesTest.java",0,0.425,1,4,5
"wicket-examples/src/test/java/org/apache/wicket/examples/library/LibraryTest.java",0,0.372549019607843,2,3,5
"wicket-examples/src/test/java/org/apache/wicket/examples/linkomatic/LinkomaticTest.java",0,0.411764705882353,0,5,5
"wicket-examples/src/test/java/org/apache/wicket/examples/niceurl/NiceUrlTest.java",0,0.595744680851064,1,4,5
"wicket-examples/src/test/java/org/apache/wicket/examples/repeater/RepeaterTest.java",0,0.366666666666667,1,4,5
"wicket-examples/src/test/java/org/apache/wicket/examples/signin2/Signin2Test.java",0,0.431818181818182,4,3,7
"wicket-examples/src/test/java/org/apache/wicket/examples/template/TemplateTest.java",0,0.905660377358491,1,2,3
"wicket-examples/src/test/java/org/apache/wicket/filtertest/Application.java",0,0.833333333333333,2,3,5
"wicket-examples/src/test/java/org/apache/wicket/filtertest/HelloWorld.java",0,0.878048780487805,1,2,3
"wicket-examples/src/test/java/org/apache/wicket/filtertest/WithCPWithFPTest.java",0,0.894736842105263,1,2,3
"wicket-examples/src/test/java/org/apache/wicket/filtertest/WithCPWithoutFPTest.java",0,0.87037037037037,0,3,3
"wicket-examples/src/test/java/org/apache/wicket/filtertest/WithoutCPWithFPTest.java",0,0.82089552238806,2,2,4
"wicket-examples/src/test/java/org/apache/wicket/filtertest/WithoutCPWithoutFPTest.java",0,0.805555555555556,2,2,4
"wicket-examples/src/test/java/org/apache/wicket/util/license/ApacheLicenceHeaderTest.java",0,0.353658536585366,1,3,4
"wicket-examples/src/test/java/org/apache/wicket/util/markup/xhtml/WellFormedXmlTest.java",0,1,0,1,1
"wicket-extensions/src/main/java/org/apache/wicket/extensions/Initializer.java",0,0.346153846153846,2,4,6
"wicket-extensions/src/main/java/org/apache/wicket/extensions/ajax/markup/html/AjaxEditableChoiceLabel.java",0,0.395498392282958,4,4,8
"wicket-extensions/src/main/java/org/apache/wicket/extensions/ajax/markup/html/AjaxEditableLabel.java",0,0.447058823529412,7,5,12
"wicket-extensions/src/main/java/org/apache/wicket/extensions/ajax/markup/html/AjaxEditableMultiLineLabel.java",0,0.529850746268657,4,4,8
"wicket-extensions/src/main/java/org/apache/wicket/extensions/ajax/markup/html/AjaxIndicatorAppender.java",0,0.850746268656716,3,2,5
"wicket-extensions/src/main/java/org/apache/wicket/extensions/ajax/markup/html/AjaxLazyLoadPanel.java",0,0.427672955974843,2,4,6
"wicket-extensions/src/main/java/org/apache/wicket/extensions/ajax/markup/html/AjaxLazyLoadPanelTester.java",0,0.926829268292683,2,1,3
"wicket-extensions/src/main/java/org/apache/wicket/extensions/ajax/markup/html/IndicatingAjaxButton.java",0,0.350515463917526,2,4,6
"wicket-extensions/src/main/java/org/apache/wicket/extensions/ajax/markup/html/IndicatingAjaxFallbackLink.java",0,0.48,3,4,7
"wicket-extensions/src/main/java/org/apache/wicket/extensions/ajax/markup/html/IndicatingAjaxLink.java",0,0.544117647058823,2,4,6
"wicket-extensions/src/main/java/org/apache/wicket/extensions/ajax/markup/html/WicketAjaxIndicatorAppender.java",0,0.592592592592593,1,4,5
"wicket-extensions/src/main/java/org/apache/wicket/extensions/ajax/markup/html/autocomplete/AbstractAutoCompleteBehavior.java",0,0.259259259259259,3,6,9
"wicket-extensions/src/main/java/org/apache/wicket/extensions/ajax/markup/html/autocomplete/AbstractAutoCompleteRenderer.java",0,0.369565217391304,2,5,7
"wicket-extensions/src/main/java/org/apache/wicket/extensions/ajax/markup/html/autocomplete/AbstractAutoCompleteTextRenderer.java",0,0.421052631578947,2,5,7
"wicket-extensions/src/main/java/org/apache/wicket/extensions/ajax/markup/html/autocomplete/AutoCompleteBehavior.java",0,0.318518518518519,5,5,10
"wicket-extensions/src/main/java/org/apache/wicket/extensions/ajax/markup/html/autocomplete/AutoCompleteSettings.java",0,0.394658753709199,1,4,5
"wicket-extensions/src/main/java/org/apache/wicket/extensions/ajax/markup/html/autocomplete/AutoCompleteTextField.java",0,0.291666666666667,4,6,10
"wicket-extensions/src/main/java/org/apache/wicket/extensions/ajax/markup/html/autocomplete/DefaultCssAutoCompleteTextField.java",0,0.618181818181818,0,3,3
"wicket-extensions/src/main/java/org/apache/wicket/extensions/ajax/markup/html/autocomplete/IAutoCompleteRenderer.java",0,0.443298969072165,1,5,6
"wicket-extensions/src/main/java/org/apache/wicket/extensions/ajax/markup/html/autocomplete/StringAutoCompleteRenderer.java",0,0.365384615384615,1,4,5
"wicket-extensions/src/main/java/org/apache/wicket/extensions/ajax/markup/html/form/upload/UploadProgressBar.java",0,0.244186046511628,3,7,10
"wicket-extensions/src/main/java/org/apache/wicket/extensions/ajax/markup/html/form/upload/UploadStatusResource.java",0,0.443548387096774,5,3,8
"wicket-extensions/src/main/java/org/apache/wicket/extensions/ajax/markup/html/modal/ModalWindow.java",0,0.418642681929681,8,4,12
"wicket-extensions/src/main/java/org/apache/wicket/extensions/ajax/markup/html/repeater/data/sort/AjaxFallbackOrderByBorder.java",0,0.681481481481481,3,4,7
"wicket-extensions/src/main/java/org/apache/wicket/extensions/ajax/markup/html/repeater/data/sort/AjaxFallbackOrderByLink.java",0,0.508982035928144,3,4,7
"wicket-extensions/src/main/java/org/apache/wicket/extensions/ajax/markup/html/repeater/data/table/AjaxFallbackDefaultDataTable.java",0,0.44578313253012,2,4,6
"wicket-extensions/src/main/java/org/apache/wicket/extensions/ajax/markup/html/repeater/data/table/AjaxFallbackHeadersToolbar.java",0,0.528735632183908,1,5,6
"wicket-extensions/src/main/java/org/apache/wicket/extensions/ajax/markup/html/repeater/data/table/AjaxNavigationToolbar.java",0,0.551282051282051,2,5,7
"wicket-extensions/src/main/java/org/apache/wicket/extensions/ajax/markup/html/tabs/AjaxTabbedPanel.java",0,0.56043956043956,3,4,7
"wicket-extensions/src/main/java/org/apache/wicket/extensions/breadcrumb/BreadCrumbBar.java",0,0.681388012618297,2,5,7
"wicket-extensions/src/main/java/org/apache/wicket/extensions/breadcrumb/BreadCrumbLink.java",0,0.637362637362637,2,5,7
"wicket-extensions/src/main/java/org/apache/wicket/extensions/breadcrumb/BreadCrumbModelListenerSupport.java",0,0.741071428571429,3,3,6
"wicket-extensions/src/main/java/org/apache/wicket/extensions/breadcrumb/DefaultBreadCrumbsModel.java",0,0.925675675675676,3,1,4
"wicket-extensions/src/main/java/org/apache/wicket/extensions/breadcrumb/IBreadCrumbModel.java",0,0.603603603603604,2,4,6
"wicket-extensions/src/main/java/org/apache/wicket/extensions/breadcrumb/IBreadCrumbModelListener.java",0,0.733333333333333,3,2,5
"wicket-extensions/src/main/java/org/apache/wicket/extensions/breadcrumb/IBreadCrumbParticipant.java",0,0.629032258064516,2,3,5
"wicket-extensions/src/main/java/org/apache/wicket/extensions/breadcrumb/panel/BreadCrumbPanel.java",0,0.71978021978022,2,4,6
"wicket-extensions/src/main/java/org/apache/wicket/extensions/breadcrumb/panel/BreadCrumbPanelFactory.java",0,0.689320388349515,5,2,7
"wicket-extensions/src/main/java/org/apache/wicket/extensions/breadcrumb/panel/BreadCrumbPanelLink.java",0,0.710526315789474,2,4,6
"wicket-extensions/src/main/java/org/apache/wicket/extensions/breadcrumb/panel/BreadCrumbParticipantDelegate.java",0,0.96031746031746,1,1,2
"wicket-extensions/src/main/java/org/apache/wicket/extensions/breadcrumb/panel/IBreadCrumbPanelFactory.java",0,0.48780487804878,0,4,4
"wicket-extensions/src/main/java/org/apache/wicket/extensions/captcha/kittens/KittenCaptchaPanel.java",0,0.954656862745098,6,1,7
"wicket-extensions/src/main/java/org/apache/wicket/extensions/captcha/kittens/OpaqueRegion.java",0,1,0,1,1
"wicket-extensions/src/main/java/org/apache/wicket/extensions/markup/html/basic/DefaultLinkParser.java",0,0.858585858585859,2,2,4
"wicket-extensions/src/main/java/org/apache/wicket/extensions/markup/html/basic/ILinkParser.java",0,1,0,1,1
"wicket-extensions/src/main/java/org/apache/wicket/extensions/markup/html/basic/ILinkRenderStrategy.java",0,0.942857142857143,0,2,2
"wicket-extensions/src/main/java/org/apache/wicket/extensions/markup/html/basic/LinkParser.java",0,0.709302325581395,2,2,4
"wicket-extensions/src/main/java/org/apache/wicket/extensions/markup/html/basic/SmartLinkLabel.java",0,0.323232323232323,2,5,7
"wicket-extensions/src/main/java/org/apache/wicket/extensions/markup/html/basic/SmartLinkMultiLineLabel.java",0,0.393617021276596,2,5,7
"wicket-extensions/src/main/java/org/apache/wicket/extensions/markup/html/captcha/CaptchaImageResource.java",0,0.453757225433526,4,4,8
"wicket-extensions/src/main/java/org/apache/wicket/extensions/markup/html/form/DateTextField.java",0,0.487179487179487,6,3,9
"wicket-extensions/src/main/java/org/apache/wicket/extensions/markup/html/form/palette/Palette.java",0,0.773584905660377,9,2,11
"wicket-extensions/src/main/java/org/apache/wicket/extensions/markup/html/form/palette/component/AbstractOptions.java",0,0.593582887700535,3,5,8
"wicket-extensions/src/main/java/org/apache/wicket/extensions/markup/html/form/palette/component/Choices.java",0,0.573529411764706,0,5,5
"wicket-extensions/src/main/java/org/apache/wicket/extensions/markup/html/form/palette/component/Recorder.java",0,0.801724137931034,6,2,8
"wicket-extensions/src/main/java/org/apache/wicket/extensions/markup/html/form/palette/component/Selection.java",0,0.5,0,4,4
"wicket-extensions/src/main/java/org/apache/wicket/extensions/markup/html/form/select/IOptionRenderer.java",0,0.520833333333333,0,5,5
"wicket-extensions/src/main/java/org/apache/wicket/extensions/markup/html/form/select/Select.java",0,0.564885496183206,5,4,9
"wicket-extensions/src/main/java/org/apache/wicket/extensions/markup/html/form/select/SelectOption.java",0,0.558558558558559,5,4,9
"wicket-extensions/src/main/java/org/apache/wicket/extensions/markup/html/form/select/SelectOptions.java",0,0.572289156626506,4,5,9
"wicket-extensions/src/main/java/org/apache/wicket/extensions/markup/html/image/resource/ThumbnailImageResource.java",0,0.549132947976879,3,5,8
"wicket-extensions/src/main/java/org/apache/wicket/extensions/markup/html/repeater/data/grid/AbstractDataGridView.java",0,0.485207100591716,3,5,8
"wicket-extensions/src/main/java/org/apache/wicket/extensions/markup/html/repeater/data/grid/DataGridView.java",0,0.777777777777778,2,4,6
"wicket-extensions/src/main/java/org/apache/wicket/extensions/markup/html/repeater/data/grid/ICellPopulator.java",0,0.608108108108108,0,4,4
"wicket-extensions/src/main/java/org/apache/wicket/extensions/markup/html/repeater/data/grid/PropertyPopulator.java",0,0.613333333333333,1,5,6
"wicket-extensions/src/main/java/org/apache/wicket/extensions/markup/html/repeater/data/sort/ISortState.java",0,0.666666666666667,3,3,6
"wicket-extensions/src/main/java/org/apache/wicket/extensions/markup/html/repeater/data/sort/ISortStateLocator.java",0,0.657142857142857,1,4,5
"wicket-extensions/src/main/java/org/apache/wicket/extensions/markup/html/repeater/data/sort/OrderByBorder.java",0,0.589285714285714,1,5,6
"wicket-extensions/src/main/java/org/apache/wicket/extensions/markup/html/repeater/data/sort/OrderByLink.java",0,0.760736196319018,4,3,7
"wicket-extensions/src/main/java/org/apache/wicket/extensions/markup/html/repeater/data/sort/SortOrder.java",0,0.921052631578947,0,2,2
"wicket-extensions/src/main/java/org/apache/wicket/extensions/markup/html/repeater/data/table/AbstractColumn.java",0,0.660377358490566,2,5,7
"wicket-extensions/src/main/java/org/apache/wicket/extensions/markup/html/repeater/data/table/AbstractToolbar.java",0,0.757142857142857,2,3,5
"wicket-extensions/src/main/java/org/apache/wicket/extensions/markup/html/repeater/data/table/DataTable.java",0,0.388446215139442,4,6,10
"wicket-extensions/src/main/java/org/apache/wicket/extensions/markup/html/repeater/data/table/DefaultDataTable.java",0,0.554054054054054,0,5,5
"wicket-extensions/src/main/java/org/apache/wicket/extensions/markup/html/repeater/data/table/HeaderlessColumn.java",0,0.469387755102041,1,4,5
"wicket-extensions/src/main/java/org/apache/wicket/extensions/markup/html/repeater/data/table/HeadersToolbar.java",0,0.577235772357724,2,5,7
"wicket-extensions/src/main/java/org/apache/wicket/extensions/markup/html/repeater/data/table/IColumn.java",0,0.631578947368421,0,4,4
"wicket-extensions/src/main/java/org/apache/wicket/extensions/markup/html/repeater/data/table/ISortableDataProvider.java",0,0.911764705882353,0,2,2
"wicket-extensions/src/main/java/org/apache/wicket/extensions/markup/html/repeater/data/table/IStyledColumn.java",0,0.882352941176471,0,3,3
"wicket-extensions/src/main/java/org/apache/wicket/extensions/markup/html/repeater/data/table/NavigationToolbar.java",0,0.636363636363636,4,4,8
"wicket-extensions/src/main/java/org/apache/wicket/extensions/markup/html/repeater/data/table/NavigatorLabel.java",0,0.35,4,5,9
"wicket-extensions/src/main/java/org/apache/wicket/extensions/markup/html/repeater/data/table/NoRecordsToolbar.java",0,0.695121951219512,3,4,7
"wicket-extensions/src/main/java/org/apache/wicket/extensions/markup/html/repeater/data/table/PropertyColumn.java",0,0.686440677966102,3,5,8
"wicket-extensions/src/main/java/org/apache/wicket/extensions/markup/html/repeater/data/table/filter/AbstractFilter.java",0,0.756756756756757,3,3,6
"wicket-extensions/src/main/java/org/apache/wicket/extensions/markup/html/repeater/data/table/filter/ChoiceFilter.java",0,0.748251748251748,4,3,7
"wicket-extensions/src/main/java/org/apache/wicket/extensions/markup/html/repeater/data/table/filter/ChoiceFilteredPropertyColumn.java",0,0.620689655172414,1,5,6
"wicket-extensions/src/main/java/org/apache/wicket/extensions/markup/html/repeater/data/table/filter/FilterForm.java",0,0.691729323308271,1,5,6
"wicket-extensions/src/main/java/org/apache/wicket/extensions/markup/html/repeater/data/table/filter/FilterStateModel.java",0,0.641025641025641,2,4,6
"wicket-extensions/src/main/java/org/apache/wicket/extensions/markup/html/repeater/data/table/filter/FilterToolbar.java",0,0.636363636363636,1,5,6
"wicket-extensions/src/main/java/org/apache/wicket/extensions/markup/html/repeater/data/table/filter/FilteredAbstractColumn.java",0,0.725806451612903,1,4,5
"wicket-extensions/src/main/java/org/apache/wicket/extensions/markup/html/repeater/data/table/filter/FilteredPropertyColumn.java",0,0.671641791044776,1,4,5
"wicket-extensions/src/main/java/org/apache/wicket/extensions/markup/html/repeater/data/table/filter/GoAndClearFilter.java",0,0.771929824561403,2,4,6
"wicket-extensions/src/main/java/org/apache/wicket/extensions/markup/html/repeater/data/table/filter/GoFilter.java",0,0.739583333333333,2,4,6
"wicket-extensions/src/main/java/org/apache/wicket/extensions/markup/html/repeater/data/table/filter/IFilterStateLocator.java",0,0.655737704918033,1,4,5
"wicket-extensions/src/main/java/org/apache/wicket/extensions/markup/html/repeater/data/table/filter/IFilteredColumn.java",0,0.509803921568627,0,5,5
"wicket-extensions/src/main/java/org/apache/wicket/extensions/markup/html/repeater/data/table/filter/NoFilter.java",0,0.7,1,4,5
"wicket-extensions/src/main/java/org/apache/wicket/extensions/markup/html/repeater/data/table/filter/TextFilter.java",0,0.721311475409836,2,3,5
"wicket-extensions/src/main/java/org/apache/wicket/extensions/markup/html/repeater/data/table/filter/TextFilteredPropertyColumn.java",0,0.571428571428571,1,5,6
"wicket-extensions/src/main/java/org/apache/wicket/extensions/markup/html/repeater/util/SingleSortState.java",0,0.62,3,4,7
"wicket-extensions/src/main/java/org/apache/wicket/extensions/markup/html/repeater/util/SortParam.java",0,0.447619047619048,2,4,6
"wicket-extensions/src/main/java/org/apache/wicket/extensions/markup/html/repeater/util/SortableDataProvider.java",0,0.728260869565217,2,4,6
"wicket-extensions/src/main/java/org/apache/wicket/extensions/markup/html/tabs/AbstractTab.java",0,0.621212121212121,2,5,7
"wicket-extensions/src/main/java/org/apache/wicket/extensions/markup/html/tabs/ITab.java",0,0.538461538461538,0,6,6
"wicket-extensions/src/main/java/org/apache/wicket/extensions/markup/html/tabs/PanelCachingTab.java",0,0.623376623376623,2,5,7
"wicket-extensions/src/main/java/org/apache/wicket/extensions/markup/html/tabs/TabbedPanel.java",0,0.751184834123223,6,3,9
"wicket-extensions/src/main/java/org/apache/wicket/extensions/markup/html/tree/DefaultAbstractTree.java",0,0.678023850085179,7,3,10
"wicket-extensions/src/main/java/org/apache/wicket/extensions/markup/html/tree/Tree.java",0,0.680272108843537,3,4,7
"wicket-extensions/src/main/java/org/apache/wicket/extensions/markup/html/tree/table/AbstractColumn.java",0,0.618181818181818,2,5,7
"wicket-extensions/src/main/java/org/apache/wicket/extensions/markup/html/tree/table/AbstractColumnsView.java",0,1,0,1,1
"wicket-extensions/src/main/java/org/apache/wicket/extensions/markup/html/tree/table/AbstractPropertyColumn.java",0,1,0,1,1
"wicket-extensions/src/main/java/org/apache/wicket/extensions/markup/html/tree/table/ColumnLocation.java",0,0.733727810650888,5,3,8
"wicket-extensions/src/main/java/org/apache/wicket/extensions/markup/html/tree/table/IColumn.java",0,0.617886178861789,4,3,7
"wicket-extensions/src/main/java/org/apache/wicket/extensions/markup/html/tree/table/IRenderable.java",0,0.434782608695652,3,4,7
"wicket-extensions/src/main/java/org/apache/wicket/extensions/markup/html/tree/table/MiddleColumnsView.java",0,0.703056768558952,5,4,9
"wicket-extensions/src/main/java/org/apache/wicket/extensions/markup/html/tree/table/PropertyRenderableColumn.java",0,0.451388888888889,5,3,8
"wicket-extensions/src/main/java/org/apache/wicket/extensions/markup/html/tree/table/PropertyTreeColumn.java",0,0.428571428571429,5,3,8
"wicket-extensions/src/main/java/org/apache/wicket/extensions/markup/html/tree/table/SideColumnsView.java",0,0.730964467005076,3,4,7
"wicket-extensions/src/main/java/org/apache/wicket/extensions/markup/html/tree/table/TreeTable.java",0,0.635933806146572,7,3,10
"wicket-extensions/src/main/java/org/apache/wicket/extensions/markup/html/tree/table/TreeTableItem.java",0,1,0,1,1
"wicket-extensions/src/main/java/org/apache/wicket/extensions/model/AbstractCheckBoxModel.java",0,0.238095238095238,1,5,6
"wicket-extensions/src/main/java/org/apache/wicket/extensions/rating/RatingPanel.java",0,0.659770114942529,5,4,9
"wicket-extensions/src/main/java/org/apache/wicket/extensions/requestlogger/JsonRequestLogger.java",0,0.97972972972973,1,1,2
"wicket-extensions/src/main/java/org/apache/wicket/extensions/util/encoding/CharSetMap.java",0,0.839797639123103,5,2,7
"wicket-extensions/src/main/java/org/apache/wicket/extensions/util/encoding/CharSetUtil.java",0,0.715596330275229,4,4,8
"wicket-extensions/src/main/java/org/apache/wicket/extensions/validation/validator/RfcCompliantEmailAddressValidator.java",0,0.688235294117647,3,2,5
"wicket-extensions/src/main/java/org/apache/wicket/extensions/wizard/AbstractWizardModel.java",0,0.832402234636871,1,3,4
"wicket-extensions/src/main/java/org/apache/wicket/extensions/wizard/CancelButton.java",0,0.63768115942029,2,3,5
"wicket-extensions/src/main/java/org/apache/wicket/extensions/wizard/FinishButton.java",0,0.64,3,3,6
"wicket-extensions/src/main/java/org/apache/wicket/extensions/wizard/IDefaultButtonProvider.java",0,0.869565217391304,0,2,2
"wicket-extensions/src/main/java/org/apache/wicket/extensions/wizard/IWizard.java",0,0.476190476190476,2,3,5
"wicket-extensions/src/main/java/org/apache/wicket/extensions/wizard/IWizardModel.java",0,0.704545454545455,3,3,6
"wicket-extensions/src/main/java/org/apache/wicket/extensions/wizard/IWizardModelListener.java",0,0.666666666666667,1,2,3
"wicket-extensions/src/main/java/org/apache/wicket/extensions/wizard/IWizardStep.java",0,0.566666666666667,2,4,6
"wicket-extensions/src/main/java/org/apache/wicket/extensions/wizard/LastButton.java",0,0.591549295774648,3,3,6
"wicket-extensions/src/main/java/org/apache/wicket/extensions/wizard/NextButton.java",0,0.8,4,2,6
"wicket-extensions/src/main/java/org/apache/wicket/extensions/wizard/PreviousButton.java",0,0.583333333333333,3,3,6
"wicket-extensions/src/main/java/org/apache/wicket/extensions/wizard/StaticContentStep.java",0,0.704545454545455,2,4,6
"wicket-extensions/src/main/java/org/apache/wicket/extensions/wizard/Wizard.java",0,0.713467048710602,4,3,7
"wicket-extensions/src/main/java/org/apache/wicket/extensions/wizard/WizardButton.java",0,0.703296703296703,3,4,7
"wicket-extensions/src/main/java/org/apache/wicket/extensions/wizard/WizardButtonBar.java",0,0.64,3,4,7
"wicket-extensions/src/main/java/org/apache/wicket/extensions/wizard/WizardModel.java",0,0.778461538461538,4,3,7
"wicket-extensions/src/main/java/org/apache/wicket/extensions/wizard/WizardStep.java",0,0.744086021505376,6,2,8
"wicket-extensions/src/main/java/org/apache/wicket/extensions/wizard/dynamic/DynamicWizardModel.java",0,0.939024390243902,2,1,3
"wicket-extensions/src/main/java/org/apache/wicket/extensions/wizard/dynamic/DynamicWizardStep.java",0,0.829268292682927,2,3,5
"wicket-extensions/src/main/java/org/apache/wicket/extensions/wizard/dynamic/IDynamicWizardStep.java",0,0.885416666666667,1,2,3
"wicket-extensions/src/test/java/org/apache/wicket/WicketTestCase.java",0,0.906832298136646,1,2,3
"wicket-extensions/src/test/java/org/apache/wicket/extensions/ajax/markup/html/AjaxEditableLabelPage.java",0,0.903846153846154,2,2,4
"wicket-extensions/src/test/java/org/apache/wicket/extensions/ajax/markup/html/AjaxEditableTest.java",0,0.699248120300752,3,2,5
"wicket-extensions/src/test/java/org/apache/wicket/extensions/markup/html/AjaxLazyLoadPanelTesterTest.java",0,0.861111111111111,2,3,5
"wicket-extensions/src/test/java/org/apache/wicket/extensions/markup/html/basic/DefaultLinkParserTest.java",0,0.402173913043478,0,3,3
"wicket-extensions/src/test/java/org/apache/wicket/extensions/markup/html/image/resource/ThumbnailImageResourceTest.java",0,1,0,1,1
"wicket-extensions/src/test/java/org/apache/wicket/extensions/markup/html/repeater/data/table/Contact.java",0,1,0,1,1
"wicket-extensions/src/test/java/org/apache/wicket/extensions/markup/html/repeater/data/table/ContactGenerator.java",0,0.991304347826087,1,1,2
"wicket-extensions/src/test/java/org/apache/wicket/extensions/markup/html/repeater/data/table/ContactsDatabase.java",0,0.938775510204082,0,2,2
"wicket-extensions/src/test/java/org/apache/wicket/extensions/markup/html/repeater/data/table/DataTablePage.java",0,0.85981308411215,0,2,2
"wicket-extensions/src/test/java/org/apache/wicket/extensions/markup/html/repeater/data/table/DataTableTest.java",0,0.574766355140187,1,3,4
"wicket-extensions/src/test/java/org/apache/wicket/extensions/markup/html/repeater/data/table/DatabaseLocator.java",0,0.945945945945946,0,2,2
"wicket-extensions/src/test/java/org/apache/wicket/extensions/markup/html/repeater/data/table/DetachableContactModel.java",0,1,0,1,1
"wicket-extensions/src/test/java/org/apache/wicket/extensions/markup/html/repeater/data/table/RepeaterApplication.java",0,0.969230769230769,1,1,2
"wicket-extensions/src/test/java/org/apache/wicket/extensions/markup/html/repeater/data/table/SortableContactDataProvider.java",0,0.959459459459459,1,1,2
"wicket-extensions/src/test/java/org/apache/wicket/extensions/markup/html/tree/MoveChildToParentNodeMarkedForRecreationTest.java",0,0.847826086956522,0,3,3
"wicket-extensions/src/test/java/org/apache/wicket/extensions/markup/html/tree/MoveChildToParentNodeMarkedForRecreationTestPage.java",0,0.884615384615385,1,2,3
"wicket-extensions/src/test/java/org/apache/wicket/extensions/markup/html/upload/UploadFormWithProgressBarTest.java",0,0.754098360655738,1,2,3
"wicket-extensions/src/test/java/org/apache/wicket/extensions/validation/validator/RfcCompliantEmailValidatorTest.java",0,0.757142857142857,2,3,5
"wicket-extensions/src/test/java/org/apache/wicket/extensions/wizard/WizardModelTest.java",0,1,0,1,1
"wicket-extensions/src/test/java/org/apache/wicket/util/license/ApacheLicenceHeaderTest.java",0,0.735294117647059,1,3,4
"wicket-extensions/src/test/java/org/apache/wicket/util/markup/xhtml/WellFormedXmlTest.java",0,0.941176470588235,0,2,2
"wicket-guice/src/main/java/org/apache/wicket/guice/GuiceComponentInjector.java",0,0.482269503546099,0,5,5
"wicket-guice/src/main/java/org/apache/wicket/guice/GuiceFieldValueFactory.java",0,0.778571428571429,0,2,2
"wicket-guice/src/main/java/org/apache/wicket/guice/GuiceInjectorHolder.java",0,0.78125,3,2,5
"wicket-guice/src/main/java/org/apache/wicket/guice/GuiceProxyTargetLocator.java",0,0.485981308411215,1,3,4
"wicket-guice/src/main/java/org/apache/wicket/guice/GuiceWebApplicationFactory.java",0,0.803191489361702,2,2,4
"wicket-guice/src/test/java/org/apache/wicket/guice/Blue.java",0,0.970588235294118,1,1,2
"wicket-guice/src/test/java/org/apache/wicket/guice/GuiceInjectorTest.java",0,0.6171875,1,3,4
"wicket-guice/src/test/java/org/apache/wicket/guice/GuiceWebApplicationFactoryTest.java",0,0.902912621359223,0,2,2
"wicket-guice/src/test/java/org/apache/wicket/guice/ITestService.java",0,0.470588235294118,1,3,4
"wicket-guice/src/test/java/org/apache/wicket/guice/Red.java",0,0.970588235294118,1,1,2
"wicket-guice/src/test/java/org/apache/wicket/guice/TestBehavior.java",0,1,0,1,1
"wicket-guice/src/test/java/org/apache/wicket/guice/TestComponent.java",0,0.46969696969697,2,4,6
"wicket-guice/src/test/java/org/apache/wicket/guice/TestNoComponent.java",0,1,0,1,1
"wicket-guice/src/test/java/org/apache/wicket/guice/TestService.java",0,0.592592592592593,0,3,3
"wicket-guice/src/test/java/org/apache/wicket/guice/TestServiceBlue.java",0,0.925925925925926,0,2,2
"wicket-guice/src/test/java/org/apache/wicket/guice/TestServiceRed.java",0,0.925925925925926,0,2,2
"wicket-guice/src/test/java/org/apache/wicket/util/license/ApacheLicenceHeaderTest.java",0,0.857142857142857,0,3,3
"wicket-ioc/src/main/java/org/apache/wicket/injection/CompoundFieldValueFactory.java",0,0.887218045112782,3,2,5
"wicket-ioc/src/main/java/org/apache/wicket/injection/IFieldValueFactory.java",0,0.92156862745098,0,2,2
"wicket-ioc/src/main/java/org/apache/wicket/injection/Injector.java",0,0.641509433962264,3,3,6
"wicket-ioc/src/main/java/org/apache/wicket/injection/NoopFieldValueFactory.java",0,0.893617021276596,1,2,3
"wicket-ioc/src/main/java/org/apache/wicket/proxy/ILazyInitProxy.java",0,0.941176470588235,0,2,2
"wicket-ioc/src/main/java/org/apache/wicket/proxy/IProxyTargetLocator.java",0,0.847457627118644,0,2,2
"wicket-ioc/src/main/java/org/apache/wicket/proxy/LazyInitProxyFactory.java",0,0.733201581027668,4,3,7
"wicket-ioc/src/test/java/org/apache/wicket/injection/CompoundFieldValueFactoryTest.java",0,0.840425531914894,4,2,6
"wicket-ioc/src/test/java/org/apache/wicket/injection/InjectorTest.java",0,0.717948717948718,2,3,5
"wicket-ioc/src/test/java/org/apache/wicket/injection/NoopFieldValueFactoryTest.java",0,0.56,2,3,5
"wicket-ioc/src/test/java/org/apache/wicket/injection/util/InternalTestObject.java",0,0.6875,2,2,4
"wicket-ioc/src/test/java/org/apache/wicket/injection/util/MockDependency.java",0,0.727272727272727,2,2,4
"wicket-ioc/src/test/java/org/apache/wicket/injection/util/TestObject.java",0,0.6875,2,2,4
"wicket-ioc/src/test/java/org/apache/wicket/proxy/LazyInitProxyFactoryTest.java",0,0.684491978609626,1,4,5
"wicket-ioc/src/test/java/org/apache/wicket/proxy/util/ConcreteObject.java",0,0.727272727272727,2,2,4
"wicket-ioc/src/test/java/org/apache/wicket/proxy/util/IInterface.java",0,0.548387096774194,1,2,3
"wicket-ioc/src/test/java/org/apache/wicket/proxy/util/IObjectMethodTester.java",0,0.660377358490566,2,2,4
"wicket-ioc/src/test/java/org/apache/wicket/proxy/util/InterfaceObject.java",0,0.622222222222222,2,2,4
"wicket-ioc/src/test/java/org/apache/wicket/proxy/util/MockObjectLocator.java",0,0.604166666666667,2,3,5
"wicket-ioc/src/test/java/org/apache/wicket/proxy/util/ObjectMethodTester.java",0,0.686746987951807,1,3,4
"wicket-ioc/src/test/java/org/apache/wicket/util/license/ApacheLicenceHeaderTest.java",0,1,0,1,1
"wicket-jmx/src/main/java/org/apache/wicket/jmx/Application.java",0,0.566037735849057,2,5,7
"wicket-jmx/src/main/java/org/apache/wicket/jmx/ApplicationMBean.java",0,0.638297872340426,3,4,7
"wicket-jmx/src/main/java/org/apache/wicket/jmx/ApplicationSettings.java",0,0.74468085106383,1,3,4
"wicket-jmx/src/main/java/org/apache/wicket/jmx/ApplicationSettingsMBean.java",0,0.747126436781609,1,3,4
"wicket-jmx/src/main/java/org/apache/wicket/jmx/DebugSettings.java",0,0.56,1,4,5
"wicket-jmx/src/main/java/org/apache/wicket/jmx/DebugSettingsMBean.java",0,0.60431654676259,2,3,5
"wicket-jmx/src/main/java/org/apache/wicket/jmx/Initializer.java",0,0.770491803278688,4,2,6
"wicket-jmx/src/main/java/org/apache/wicket/jmx/MarkupSettings.java",0,0.753333333333333,0,4,4
"wicket-jmx/src/main/java/org/apache/wicket/jmx/MarkupSettingsMBean.java",0,0.72992700729927,2,3,5
"wicket-jmx/src/main/java/org/apache/wicket/jmx/PageSettings.java",0,0.648148148148148,1,3,4
"wicket-jmx/src/main/java/org/apache/wicket/jmx/PageSettingsMBean.java",0,0.567567567567568,1,3,4
"wicket-jmx/src/main/java/org/apache/wicket/jmx/RequestCycleSettings.java",0,0.742857142857143,0,4,4
"wicket-jmx/src/main/java/org/apache/wicket/jmx/RequestCycleSettingsMBean.java",0,0.65625,2,3,5
"wicket-jmx/src/main/java/org/apache/wicket/jmx/RequestLogger.java",0,0.584905660377358,3,4,7
"wicket-jmx/src/main/java/org/apache/wicket/jmx/RequestLoggerMBean.java",0,0.596153846153846,1,4,5
"wicket-jmx/src/main/java/org/apache/wicket/jmx/ResourceSettings.java",0,0.666666666666667,1,4,5
"wicket-jmx/src/main/java/org/apache/wicket/jmx/ResourceSettingsMBean.java",0,0.78,1,3,4
"wicket-jmx/src/main/java/org/apache/wicket/jmx/SecuritySettings.java",0,0.67741935483871,1,3,4
"wicket-jmx/src/main/java/org/apache/wicket/jmx/SecuritySettingsMBean.java",0,0.666666666666667,1,2,3
"wicket-jmx/src/main/java/org/apache/wicket/jmx/SessionSettings.java",0,0.641509433962264,2,3,5
"wicket-jmx/src/main/java/org/apache/wicket/jmx/SessionSettingsMBean.java",0,0.65,1,2,3
"wicket-jmx/src/main/java/org/apache/wicket/jmx/StoreSettings.java",0,1,0,1,1
"wicket-jmx/src/main/java/org/apache/wicket/jmx/StoreSettingsMBean.java",0,1,0,1,1
"wicket-jmx/src/main/java/org/apache/wicket/jmx/Stringz.java",0,0.64,3,2,5
"wicket-jmx/src/test/java/org/apache/wicket/util/license/ApacheLicenceHeaderTest.java",0,0.735294117647059,1,3,4
"wicket-objectssizeof-agent/src/main/java/org/apache/wicket/util/instrument/InstrumentationObjectSizeOfStrategy.java",0,0.734375,4,2,6
"wicket-objectssizeof-agent/src/main/java/org/apache/wicket/util/instrument/ObjectSizeOfAgent.java",0,0.710144927536232,1,3,4
"wicket-objectssizeof-agent/src/test/wicket/util/license/ApacheLicenceHeaderTest.java",0,0.941176470588235,0,2,2
"wicket-request/src/main/java/org/apache/wicket/request/HttpHeaderCollection.java",0,1,0,1,1
"wicket-request/src/main/java/org/apache/wicket/request/IExceptionMapper.java",0,0.645161290322581,0,3,3
"wicket-request/src/main/java/org/apache/wicket/request/ILogData.java",0,1,0,1,1
"wicket-request/src/main/java/org/apache/wicket/request/ILoggableRequestHandler.java",0,1,0,1,1
"wicket-request/src/main/java/org/apache/wicket/request/IRequestCycle.java",0,0.542372881355932,1,2,3
"wicket-request/src/main/java/org/apache/wicket/request/IRequestHandler.java",0,0.934782608695652,3,1,4
"wicket-request/src/main/java/org/apache/wicket/request/IRequestHandlerDelegate.java",0,1,0,1,1
"wicket-request/src/main/java/org/apache/wicket/request/IRequestMapper.java",0,0.590909090909091,1,3,4
"wicket-request/src/main/java/org/apache/wicket/request/IRequestParameters.java",0,0.933333333333333,0,2,2
"wicket-request/src/main/java/org/apache/wicket/request/IWritableRequestParameters.java",0,0.976190476190476,1,1,2
"wicket-request/src/main/java/org/apache/wicket/request/Request.java",0,0.686274509803922,4,3,7
"wicket-request/src/main/java/org/apache/wicket/request/RequestHandlerStack.java",0,0.71551724137931,2,2,4
"wicket-request/src/main/java/org/apache/wicket/request/Response.java",0,0.266666666666667,1,7,8
"wicket-request/src/main/java/org/apache/wicket/request/Url.java",0,0.441658630665381,1,4,5
"wicket-request/src/main/java/org/apache/wicket/request/UrlDecoder.java",0,0.674157303370786,1,3,4
"wicket-request/src/main/java/org/apache/wicket/request/UrlEncoder.java",0,0.577127659574468,2,3,5
"wicket-request/src/main/java/org/apache/wicket/request/UrlRenderer.java",0,0.771084337349398,1,4,5
"wicket-request/src/main/java/org/apache/wicket/request/flow/RedirectToUrlException.java",0,0.5,0,2,2
"wicket-request/src/main/java/org/apache/wicket/request/flow/ResetResponseException.java",0,0.33,1,5,6
"wicket-request/src/main/java/org/apache/wicket/request/handler/EmptyRequestHandler.java",0,0.411764705882353,3,4,7
"wicket-request/src/main/java/org/apache/wicket/request/handler/TextRequestHandler.java",0,0.416058394160584,4,5,9
"wicket-request/src/main/java/org/apache/wicket/request/handler/logger/DelegateLogData.java",0,1,0,1,1
"wicket-request/src/main/java/org/apache/wicket/request/handler/logger/NoLogData.java",0,1,0,1,1
"wicket-request/src/main/java/org/apache/wicket/request/http/WebRequest.java",0,0.568807339449541,6,5,11
"wicket-request/src/main/java/org/apache/wicket/request/http/WebResponse.java",0,0.291970802919708,1,7,8
"wicket-request/src/main/java/org/apache/wicket/request/http/flow/AbortWithHttpErrorCodeException.java",0,0.967741935483871,1,1,2
"wicket-request/src/main/java/org/apache/wicket/request/http/handler/ErrorCodeRequestHandler.java",0,0.689320388349515,6,2,8
"wicket-request/src/main/java/org/apache/wicket/request/http/handler/RedirectRequestHandler.java",0,0.352380952380952,4,5,9
"wicket-request/src/main/java/org/apache/wicket/request/mapper/AbstractMapper.java",0,0.71304347826087,1,4,5
"wicket-request/src/main/java/org/apache/wicket/request/mapper/CompoundRequestMapper.java",0,0.481327800829876,0,4,4
"wicket-request/src/main/java/org/apache/wicket/request/mapper/ICompoundRequestMapper.java",0,0.442307692307692,1,4,5
"wicket-request/src/main/java/org/apache/wicket/request/mapper/ParentPathReferenceRewriter.java",0,0.916666666666667,1,2,3
"wicket-request/src/main/java/org/apache/wicket/request/mapper/info/ComponentInfo.java",0,0.707746478873239,0,3,3
"wicket-request/src/main/java/org/apache/wicket/request/mapper/info/PageComponentInfo.java",0,0.811475409836066,1,2,3
"wicket-request/src/main/java/org/apache/wicket/request/mapper/info/PageInfo.java",0,0.938775510204082,3,1,4
"wicket-request/src/main/java/org/apache/wicket/request/mapper/mount/IMountedRequestMapper.java",0,0.794117647058823,0,2,2
"wicket-request/src/main/java/org/apache/wicket/request/mapper/mount/Mount.java",0,0.819444444444444,0,3,3
"wicket-request/src/main/java/org/apache/wicket/request/mapper/mount/MountMapper.java",0,0.804733727810651,1,2,3
"wicket-request/src/main/java/org/apache/wicket/request/mapper/mount/MountParameters.java",0,0.773109243697479,0,3,3
"wicket-request/src/main/java/org/apache/wicket/request/mapper/mount/UnmountedMapperAdapter.java",0,0.693333333333333,0,2,2
"wicket-request/src/main/java/org/apache/wicket/request/mapper/mount/UnmountedRequestHandlerAdapter.java",0,0.694444444444444,0,2,2
"wicket-request/src/main/java/org/apache/wicket/request/mapper/parameter/IIndexedParameters.java",0,0.95,0,2,2
"wicket-request/src/main/java/org/apache/wicket/request/mapper/parameter/INamedParameters.java",0,0.78169014084507,0,2,2
"wicket-request/src/main/java/org/apache/wicket/request/mapper/parameter/IPageParametersEncoder.java",0,0.808510638297872,1,3,4
"wicket-request/src/main/java/org/apache/wicket/request/mapper/parameter/PageParameters.java",0,0.57185628742515,1,4,5
"wicket-request/src/main/java/org/apache/wicket/request/mapper/parameter/PageParametersEncoder.java",0,0.873417721518987,0,3,3
"wicket-request/src/main/java/org/apache/wicket/request/mapper/parameter/UrlPathPageParametersEncoder.java",0,0.636363636363636,0,3,3
"wicket-request/src/main/java/org/apache/wicket/request/parameter/CombinedRequestParametersAdapter.java",0,0.627272727272727,0,3,3
"wicket-request/src/main/java/org/apache/wicket/request/parameter/EmptyRequestParameters.java",0,0.454545454545455,0,3,3
"wicket-request/src/main/java/org/apache/wicket/request/parameter/UrlRequestParametersAdapter.java",0,0.881720430107527,0,2,2
"wicket-request/src/test/java/org/apache/wicket/request/HttpHeaderCollectionTest.java",0,1,0,1,1
"wicket-request/src/test/java/org/apache/wicket/request/UrlEncoderTest.java",0,1,0,1,1
"wicket-request/src/test/java/org/apache/wicket/request/UrlTest.java",0,0.472589792060492,0,4,4
"wicket-request/src/test/java/org/apache/wicket/request/http/handler/RedirectRequestHandlerTest.java",0,0.597222222222222,0,2,2
"wicket-request/src/test/java/org/apache/wicket/request/mapper/CompoundRequestMapperTest.java",0,1,0,1,1
"wicket-request/src/test/java/org/apache/wicket/request/mapper/mount/MountParametersTest.java",0,0.830985915492958,0,2,2
"wicket-request/src/test/java/org/apache/wicket/request/mapper/parameter/PageParametersTest.java",0,1,0,1,1
"wicket-request/src/test/java/org/apache/wicket/request/mapper/parameter/UrlPathPageParametersEncoderTest.java",0,1,0,1,1
"wicket-request/src/test/java/org/apache/wicket/util/license/ApacheLicenceHeaderTest.java",0,1,0,1,1
"wicket-spring/src/main/java/org/apache/wicket/spring/ISpringContextLocator.java",0,0.603448275862069,3,3,6
"wicket-spring/src/main/java/org/apache/wicket/spring/SpringBeanLocator.java",0,0.706140350877193,5,4,9
"wicket-spring/src/main/java/org/apache/wicket/spring/SpringWebApplication.java",0,0.618421052631579,3,5,8
"wicket-spring/src/main/java/org/apache/wicket/spring/SpringWebApplicationFactory.java",0,0.590909090909091,6,4,10
"wicket-spring/src/main/java/org/apache/wicket/spring/injection/annot/AnnotProxyFieldValueFactory.java",0,0.402097902097902,3,4,7
"wicket-spring/src/main/java/org/apache/wicket/spring/injection/annot/SpringBean.java",0,0.816326530612245,0,2,2
"wicket-spring/src/main/java/org/apache/wicket/spring/injection/annot/SpringComponentInjector.java",0,0.808383233532934,2,2,4
"wicket-spring/src/main/java/org/apache/wicket/spring/test/ApplicationContextMock.java",0,0.625560538116592,3,5,8
"wicket-spring/src/main/java/org/apache/wicket/spring/test/SpringContextLocatorMock.java",0,0.622641509433962,1,4,5
"wicket-spring/src/test/java/org/apache/wicket/spring/Bean.java",0,0.433333333333333,2,3,5
"wicket-spring/src/test/java/org/apache/wicket/spring/SpringBeanLocatorTest.java",0,0.814049586776859,4,2,6
"wicket-spring/src/test/java/org/apache/wicket/spring/injection/annot/AnnotProxyFieldValueFactoryTest.java",0,1,0,1,1
"wicket-spring/src/test/java/org/apache/wicket/spring/injection/annot/SpringBeanTest.java",0,1,0,1,1
"wicket-spring/src/test/java/org/apache/wicket/spring/injection/util/Bean.java",0,1,0,1,1
"wicket-spring/src/test/java/org/apache/wicket/spring/injection/util/Bean2.java",0,1,0,1,1
"wicket-spring/src/test/java/org/apache/wicket/spring/injection/util/Injectable.java",0,1,0,1,1
"wicket-spring/src/test/java/org/apache/wicket/util/license/ApacheLicenceHeaderTest.java",0,0.735294117647059,1,3,4
"wicket-util/src/main/java/org/apache/wicket/IClusterable.java",0,1,0,1,1
"wicket-util/src/main/java/org/apache/wicket/serialize/ISerializer.java",0,1,0,1,1
"wicket-util/src/main/java/org/apache/wicket/util/ClassProvider.java",0,0.920634920634921,0,2,2
"wicket-util/src/main/java/org/apache/wicket/util/IContextProvider.java",0,1,0,1,1
"wicket-util/src/main/java/org/apache/wicket/util/IHierarchical.java",0,1,0,1,1
"wicket-util/src/main/java/org/apache/wicket/util/IProvider.java",0,1,0,1,1
"wicket-util/src/main/java/org/apache/wicket/util/LazyInitializer.java",0,0.966101694915254,1,1,2
"wicket-util/src/main/java/org/apache/wicket/util/LongEncoder.java",0,0.965811965811966,1,1,2
"wicket-util/src/main/java/org/apache/wicket/util/NullProvider.java",0,1,0,1,1
"wicket-util/src/main/java/org/apache/wicket/util/ValueProvider.java",0,0.864406779661017,0,2,2
"wicket-util/src/main/java/org/apache/wicket/util/collections/ArrayListStack.java",0,0.755395683453237,2,4,6
"wicket-util/src/main/java/org/apache/wicket/util/collections/ClassMetaCache.java",0,0.900826446280992,0,2,2
"wicket-util/src/main/java/org/apache/wicket/util/collections/ConcurrentHashSet.java",0,0.986486486486487,2,1,3
"wicket-util/src/main/java/org/apache/wicket/util/collections/IntHashMap.java",0,0.741687979539642,4,3,7
"wicket-util/src/main/java/org/apache/wicket/util/collections/MicroMap.java",0,0.734328358208955,4,3,7
"wicket-util/src/main/java/org/apache/wicket/util/collections/MiniMap.java",0,0.773946360153257,8,2,10
"wicket-util/src/main/java/org/apache/wicket/util/collections/MostRecentlyUsedMap.java",0,0.36046511627907,2,6,8
"wicket-util/src/main/java/org/apache/wicket/util/collections/MultiMap.java",0,0.912751677852349,1,2,3
"wicket-util/src/main/java/org/apache/wicket/util/collections/ReadOnlyIterator.java",0,0.828571428571429,0,3,3
"wicket-util/src/main/java/org/apache/wicket/util/collections/ReverseListIterator.java",0,1,0,1,1
"wicket-util/src/main/java/org/apache/wicket/util/convert/ConversionException.java",0,0.442748091603053,2,5,7
"wicket-util/src/main/java/org/apache/wicket/util/convert/IConverter.java",0,0.297297297297297,2,7,9
"wicket-util/src/main/java/org/apache/wicket/util/convert/MaskConverter.java",0,0.587570621468927,2,5,7
"wicket-util/src/main/java/org/apache/wicket/util/convert/converter/AbstractConverter.java",0,0.46078431372549,3,5,8
"wicket-util/src/main/java/org/apache/wicket/util/convert/converter/AbstractDecimalConverter.java",0,0.320987654320988,1,5,6
"wicket-util/src/main/java/org/apache/wicket/util/convert/converter/AbstractIntegerConverter.java",0,0.381818181818182,3,3,6
"wicket-util/src/main/java/org/apache/wicket/util/convert/converter/AbstractNumberConverter.java",0,0.355140186915888,6,4,10
"wicket-util/src/main/java/org/apache/wicket/util/convert/converter/BigDecimalConverter.java",0,0.56,1,4,5
"wicket-util/src/main/java/org/apache/wicket/util/convert/converter/BooleanConverter.java",0,0.265625,3,4,7
"wicket-util/src/main/java/org/apache/wicket/util/convert/converter/ByteConverter.java",0,0.354838709677419,4,4,8
"wicket-util/src/main/java/org/apache/wicket/util/convert/converter/CalendarConverter.java",0,1,0,1,1
"wicket-util/src/main/java/org/apache/wicket/util/convert/converter/CharacterConverter.java",0,0.3125,4,4,8
"wicket-util/src/main/java/org/apache/wicket/util/convert/converter/DateConverter.java",0,0.337209302325581,3,5,8
"wicket-util/src/main/java/org/apache/wicket/util/convert/converter/DoubleConverter.java",0,0.28125,5,4,9
"wicket-util/src/main/java/org/apache/wicket/util/convert/converter/FloatConverter.java",0,0.258064516129032,4,4,8
"wicket-util/src/main/java/org/apache/wicket/util/convert/converter/IntegerConverter.java",0,0.274193548387097,4,4,8
"wicket-util/src/main/java/org/apache/wicket/util/convert/converter/LongConverter.java",0,0.241935483870968,4,4,8
"wicket-util/src/main/java/org/apache/wicket/util/convert/converter/ShortConverter.java",0,0.241935483870968,4,4,8
"wicket-util/src/main/java/org/apache/wicket/util/convert/converter/SqlDateConverter.java",0,0.463414634146341,5,3,8
"wicket-util/src/main/java/org/apache/wicket/util/convert/converter/SqlTimeConverter.java",0,0.329268292682927,3,5,8
"wicket-util/src/main/java/org/apache/wicket/util/convert/converter/SqlTimestampConverter.java",0,0.365671641791045,3,5,8
"wicket-util/src/main/java/org/apache/wicket/util/convert/converter/ZeroPaddingIntegerConverter.java",0,0.858823529411765,6,1,7
"wicket-util/src/main/java/org/apache/wicket/util/crypt/AbstractCrypt.java",0,0.491428571428571,2,6,8
"wicket-util/src/main/java/org/apache/wicket/util/crypt/Base64.java",0,0.792760180995475,4,2,6
"wicket-util/src/main/java/org/apache/wicket/util/crypt/CachingSunJceCryptFactory.java",0,0.540540540540541,2,3,5
"wicket-util/src/main/java/org/apache/wicket/util/crypt/CharEncoding.java",0,1,0,1,1
"wicket-util/src/main/java/org/apache/wicket/util/crypt/ClassCryptFactory.java",0,0.63265306122449,3,4,7
"wicket-util/src/main/java/org/apache/wicket/util/crypt/CryptFactoryCachingDecorator.java",0,0.660714285714286,3,2,5
"wicket-util/src/main/java/org/apache/wicket/util/crypt/ICrypt.java",0,0.318181818181818,2,5,7
"wicket-util/src/main/java/org/apache/wicket/util/crypt/ICryptFactory.java",0,0.548387096774194,1,2,3
"wicket-util/src/main/java/org/apache/wicket/util/crypt/NoCrypt.java",0,0.3,1,5,6
"wicket-util/src/main/java/org/apache/wicket/util/crypt/NoCryptFactory.java",0,0.595238095238095,1,2,3
"wicket-util/src/main/java/org/apache/wicket/util/crypt/StringUtils.java",0,1,0,1,1
"wicket-util/src/main/java/org/apache/wicket/util/crypt/SunJceCrypt.java",0,0.608695652173913,4,4,8
"wicket-util/src/main/java/org/apache/wicket/util/crypt/TrivialCrypt.java",0,0.612244897959184,2,3,5
"wicket-util/src/main/java/org/apache/wicket/util/diff/AddDelta.java",0,0.878571428571429,4,1,5
"wicket-util/src/main/java/org/apache/wicket/util/diff/ChangeDelta.java",0,0.49685534591195,3,2,5
"wicket-util/src/main/java/org/apache/wicket/util/diff/Chunk.java",0,0.813267813267813,6,2,8
"wicket-util/src/main/java/org/apache/wicket/util/diff/DeleteDelta.java",0,0.869565217391304,5,1,6
"wicket-util/src/main/java/org/apache/wicket/util/diff/Delta.java",0,0.600732600732601,3,2,5
"wicket-util/src/main/java/org/apache/wicket/util/diff/Diff.java",0,0.596401028277635,4,3,7
"wicket-util/src/main/java/org/apache/wicket/util/diff/DiffAlgorithm.java",0,0.788235294117647,3,2,5
"wicket-util/src/main/java/org/apache/wicket/util/diff/DiffException.java",0,0.857142857142857,2,2,4
"wicket-util/src/main/java/org/apache/wicket/util/diff/DifferentiationFailedException.java",0,0.840425531914894,2,2,4
"wicket-util/src/main/java/org/apache/wicket/util/diff/PatchFailedException.java",0,0.858695652173913,2,2,4
"wicket-util/src/main/java/org/apache/wicket/util/diff/Revision.java",0,0.532075471698113,4,2,6
"wicket-util/src/main/java/org/apache/wicket/util/diff/RevisionVisitor.java",0,0.764705882352941,2,2,4
"wicket-util/src/main/java/org/apache/wicket/util/diff/ToString.java",0,0.872611464968153,3,2,5
"wicket-util/src/main/java/org/apache/wicket/util/diff/myers/DiffNode.java",0,0.463414634146341,2,3,5
"wicket-util/src/main/java/org/apache/wicket/util/diff/myers/MyersDiff.java",0,0.506122448979592,1,3,4
"wicket-util/src/main/java/org/apache/wicket/util/diff/myers/PathNode.java",0,0.464516129032258,2,3,5
"wicket-util/src/main/java/org/apache/wicket/util/diff/myers/Snake.java",0,0.71,3,2,5
"wicket-util/src/main/java/org/apache/wicket/util/file/File.java",0,0.608562691131499,5,3,8
"wicket-util/src/main/java/org/apache/wicket/util/file/FileCleaner.java",0,0.925925925925926,0,2,2
"wicket-util/src/main/java/org/apache/wicket/util/file/FileCleaningTracker.java",0,0.963746223564955,1,1,2
"wicket-util/src/main/java/org/apache/wicket/util/file/FileDeleteStrategy.java",0,0.957142857142857,1,1,2
"wicket-util/src/main/java/org/apache/wicket/util/file/Files.java",0,0.357142857142857,4,4,8
"wicket-util/src/main/java/org/apache/wicket/util/file/Folder.java",0,0.779503105590062,5,2,7
"wicket-util/src/main/java/org/apache/wicket/util/file/FolderDeleteStrategy.java",0,0.963855421686747,1,1,2
"wicket-util/src/main/java/org/apache/wicket/util/file/IFileCleaner.java",0,1,0,1,1
"wicket-util/src/main/java/org/apache/wicket/util/file/IResourceFinder.java",0,0.473684210526316,1,4,5
"wicket-util/src/main/java/org/apache/wicket/util/file/IResourcePath.java",0,0.548387096774194,1,2,3
"wicket-util/src/main/java/org/apache/wicket/util/file/Path.java",0,0.62589928057554,2,5,7
"wicket-util/src/main/java/org/apache/wicket/util/file/WebXmlFile.java",0,0.717325227963526,0,2,2
"wicket-util/src/main/java/org/apache/wicket/util/io/ByteArrayOutputStream.java",0,0.450381679389313,4,3,7
"wicket-util/src/main/java/org/apache/wicket/util/io/ByteCountingOutputStream.java",0,0.678571428571429,1,3,4
"wicket-util/src/main/java/org/apache/wicket/util/io/Connections.java",0,0.727941176470588,1,3,4
"wicket-util/src/main/java/org/apache/wicket/util/io/DeferredFileOutputStream.java",0,0.377049180327869,2,5,7
"wicket-util/src/main/java/org/apache/wicket/util/io/FullyBufferedReader.java",0,0.570224719101124,2,4,6
"wicket-util/src/main/java/org/apache/wicket/util/io/HandleArrayListStack.java",0,0.482233502538071,1,4,5
"wicket-util/src/main/java/org/apache/wicket/util/io/IOUtils.java",0,0.549473684210526,3,4,7
"wicket-util/src/main/java/org/apache/wicket/util/io/Streams.java",0,0.392670157068063,3,5,8
"wicket-util/src/main/java/org/apache/wicket/util/io/StringBufferWriter.java",0,0.785714285714286,1,3,4
"wicket-util/src/main/java/org/apache/wicket/util/io/ThresholdingOutputStream.java",0,0.666666666666667,3,2,5
"wicket-util/src/main/java/org/apache/wicket/util/io/XmlReader.java",0,0.800829875518672,3,3,6
"wicket-util/src/main/java/org/apache/wicket/util/lang/Args.java",0,0.637426900584795,1,3,4
"wicket-util/src/main/java/org/apache/wicket/util/lang/Arrays.java",0,0.97029702970297,1,1,2
"wicket-util/src/main/java/org/apache/wicket/util/lang/Bytes.java",0,0.766968325791855,7,1,8
"wicket-util/src/main/java/org/apache/wicket/util/lang/Checks.java",0,0.877049180327869,1,2,3
"wicket-util/src/main/java/org/apache/wicket/util/lang/Classes.java",0,0.621951219512195,3,4,7
"wicket-util/src/main/java/org/apache/wicket/util/lang/EnumeratedType.java",0,0.96039603960396,1,1,2
"wicket-util/src/main/java/org/apache/wicket/util/lang/Exceptions.java",0,0.7,0,2,2
"wicket-util/src/main/java/org/apache/wicket/util/lang/Generics.java",0,0.968253968253968,1,1,2
"wicket-util/src/main/java/org/apache/wicket/util/lang/Objects.java",0,0.931612903225806,2,2,4
"wicket-util/src/main/java/org/apache/wicket/util/lang/PackageName.java",0,0.9,1,2,3
"wicket-util/src/main/java/org/apache/wicket/util/lang/Packages.java",0,0.994318181818182,1,1,2
"wicket-util/src/main/java/org/apache/wicket/util/lang/Primitives.java",0,1,0,1,1
"wicket-util/src/main/java/org/apache/wicket/util/lang/Threads.java",0,1,0,1,1
"wicket-util/src/main/java/org/apache/wicket/util/listener/ChangeListenerSet.java",0,0.26530612244898,1,5,6
"wicket-util/src/main/java/org/apache/wicket/util/listener/IChangeListener.java",0,0.433333333333333,1,4,5
"wicket-util/src/main/java/org/apache/wicket/util/listener/ListenerCollection.java",0,0.85929648241206,2,3,5
"wicket-util/src/main/java/org/apache/wicket/util/parse/metapattern/BooleanGroup.java",0,0.707692307692308,4,2,6
"wicket-util/src/main/java/org/apache/wicket/util/parse/metapattern/FloatingPointGroup.java",0,0.744444444444444,3,2,5
"wicket-util/src/main/java/org/apache/wicket/util/parse/metapattern/Group.java",0,0.58695652173913,3,3,6
"wicket-util/src/main/java/org/apache/wicket/util/parse/metapattern/GroupAlreadyBoundException.java",0,0.371428571428571,1,4,5
"wicket-util/src/main/java/org/apache/wicket/util/parse/metapattern/GroupNotBoundException.java",0,0.371428571428571,0,4,4
"wicket-util/src/main/java/org/apache/wicket/util/parse/metapattern/IntegerGroup.java",0,0.598360655737705,1,4,5
"wicket-util/src/main/java/org/apache/wicket/util/parse/metapattern/MetaPattern.java",0,0.653439153439153,6,3,9
"wicket-util/src/main/java/org/apache/wicket/util/parse/metapattern/OptionalMetaPattern.java",0,0.55,0,5,5
"wicket-util/src/main/java/org/apache/wicket/util/parse/metapattern/parsers/CommaSeparatedVariableParser.java",0,0.288461538461538,2,5,7
"wicket-util/src/main/java/org/apache/wicket/util/parse/metapattern/parsers/IntegerVariableAssignmentParser.java",0,0.5375,1,5,6
"wicket-util/src/main/java/org/apache/wicket/util/parse/metapattern/parsers/ListParser.java",0,0.490384615384615,2,4,6
"wicket-util/src/main/java/org/apache/wicket/util/parse/metapattern/parsers/MetaPatternParser.java",0,0.742857142857143,3,3,6
"wicket-util/src/main/java/org/apache/wicket/util/parse/metapattern/parsers/TagNameParser.java",0,0.384615384615385,1,5,6
"wicket-util/src/main/java/org/apache/wicket/util/parse/metapattern/parsers/VariableAssignmentParser.java",0,0.525773195876289,2,5,7
"wicket-util/src/main/java/org/apache/wicket/util/parse/metapattern/parsers/WordParser.java",0,0.366666666666667,0,6,6
"wicket-util/src/main/java/org/apache/wicket/util/resource/AbstractResourceStream.java",0,0.292682926829268,3,5,8
"wicket-util/src/main/java/org/apache/wicket/util/resource/AbstractStringResourceStream.java",0,0.396039603960396,2,6,8
"wicket-util/src/main/java/org/apache/wicket/util/resource/FileResourceStream.java",0,0.502923976608187,1,7,8
"wicket-util/src/main/java/org/apache/wicket/util/resource/IFixedLocationResourceStream.java",0,0.484848484848485,1,3,4
"wicket-util/src/main/java/org/apache/wicket/util/resource/IResourceStream.java",0,0.254237288135593,4,6,10
"wicket-util/src/main/java/org/apache/wicket/util/resource/IStringResourceStream.java",0,0.6,1,3,4
"wicket-util/src/main/java/org/apache/wicket/util/resource/ResourceStreamNotFoundException.java",0,0.514285714285714,0,4,4
"wicket-util/src/main/java/org/apache/wicket/util/resource/ResourceUtils.java",0,1,0,1,1
"wicket-util/src/main/java/org/apache/wicket/util/resource/StringBufferResourceStream.java",0,0.575757575757576,2,5,7
"wicket-util/src/main/java/org/apache/wicket/util/resource/StringResourceStream.java",0,0.458823529411765,1,5,6
"wicket-util/src/main/java/org/apache/wicket/util/resource/XSLTResourceStream.java",0,0.822368421052632,4,2,6
"wicket-util/src/main/java/org/apache/wicket/util/resource/ZipResourceStream.java",0,0.458536585365854,5,2,7
"wicket-util/src/main/java/org/apache/wicket/util/string/AbstractStringList.java",0,1,0,1,1
"wicket-util/src/main/java/org/apache/wicket/util/string/AppendingStringBuffer.java",0,0.969783352337514,3,1,4
"wicket-util/src/main/java/org/apache/wicket/util/string/Entities.java",0,0.988526037069726,1,1,2
"wicket-util/src/main/java/org/apache/wicket/util/string/IStringIterator.java",0,0.971428571428571,1,1,2
"wicket-util/src/main/java/org/apache/wicket/util/string/IStringSequence.java",0,1,0,1,1
"wicket-util/src/main/java/org/apache/wicket/util/string/PrependingStringBuffer.java",0,0.957317073170732,2,1,3
"wicket-util/src/main/java/org/apache/wicket/util/string/StringEscapeUtils.java",0,1,0,1,1
"wicket-util/src/main/java/org/apache/wicket/util/string/StringList.java",0,1,0,1,1
"wicket-util/src/main/java/org/apache/wicket/util/string/StringValue.java",0,0.956466069142126,3,1,4
"wicket-util/src/main/java/org/apache/wicket/util/string/StringValueConversionException.java",0,1,0,1,1
"wicket-util/src/main/java/org/apache/wicket/util/string/Strings.java",0,0.729907773386034,2,2,4
"wicket-util/src/main/java/org/apache/wicket/util/string/interpolator/MapVariableInterpolator.java",0,0.289719626168224,1,6,7
"wicket-util/src/main/java/org/apache/wicket/util/string/interpolator/SystemVariableInterpolator.java",0,0.351351351351351,0,4,4
"wicket-util/src/main/java/org/apache/wicket/util/string/interpolator/VariableInterpolator.java",0,0.428571428571429,3,6,9
"wicket-util/src/main/java/org/apache/wicket/util/thread/ICode.java",0,1,0,1,1
"wicket-util/src/main/java/org/apache/wicket/util/thread/Lock.java",0,1,0,1,1
"wicket-util/src/main/java/org/apache/wicket/util/thread/Task.java",0,0.985815602836879,2,1,3
"wicket-util/src/main/java/org/apache/wicket/util/time/AbstractTime.java",0,1,0,1,1
"wicket-util/src/main/java/org/apache/wicket/util/time/AbstractTimeValue.java",0,1,0,1,1
"wicket-util/src/main/java/org/apache/wicket/util/time/Duration.java",0,0.990942028985507,2,1,3
"wicket-util/src/main/java/org/apache/wicket/util/time/ITimeFrameSource.java",0,1,0,1,1
"wicket-util/src/main/java/org/apache/wicket/util/time/Time.java",0,0.834130781499203,0,2,2
"wicket-util/src/main/java/org/apache/wicket/util/time/TimeFrame.java",0,0.99609375,1,1,2
"wicket-util/src/main/java/org/apache/wicket/util/time/TimeMap.java",0,0.944444444444444,2,1,3
"wicket-util/src/main/java/org/apache/wicket/util/time/TimeOfDay.java",0,0.992822966507177,1,1,2
"wicket-util/src/main/java/org/apache/wicket/util/upload/Closeable.java",0,1,0,1,1
"wicket-util/src/main/java/org/apache/wicket/util/upload/DiskFileItem.java",0,0.520261437908497,5,3,8
"wicket-util/src/main/java/org/apache/wicket/util/upload/DiskFileItemFactory.java",0,0.681372549019608,2,4,6
"wicket-util/src/main/java/org/apache/wicket/util/upload/FileItem.java",0,0.567441860465116,3,4,7
"wicket-util/src/main/java/org/apache/wicket/util/upload/FileItemFactory.java",0,0.574468085106383,1,3,4
"wicket-util/src/main/java/org/apache/wicket/util/upload/FileItemHeaders.java",0,0.972972972972973,1,1,2
"wicket-util/src/main/java/org/apache/wicket/util/upload/FileItemHeadersImpl.java",0,0.852631578947368,0,2,2
"wicket-util/src/main/java/org/apache/wicket/util/upload/FileItemHeadersSupport.java",0,1,0,1,1
"wicket-util/src/main/java/org/apache/wicket/util/upload/FileItemIterator.java",0,1,0,1,1
"wicket-util/src/main/java/org/apache/wicket/util/upload/FileItemStream.java",0,1,0,1,1
"wicket-util/src/main/java/org/apache/wicket/util/upload/FileUpload.java",0,0.552631578947368,2,4,6
"wicket-util/src/main/java/org/apache/wicket/util/upload/FileUploadBase.java",0,0.675179569034318,5,2,7
"wicket-util/src/main/java/org/apache/wicket/util/upload/FileUploadException.java",0,0.464285714285714,4,4,8
"wicket-util/src/main/java/org/apache/wicket/util/upload/LimitedInputStream.java",0,0.988372093023256,1,1,2
"wicket-util/src/main/java/org/apache/wicket/util/upload/MultipartFormInputStream.java",0,0.43485342019544,4,4,8
"wicket-util/src/main/java/org/apache/wicket/util/upload/ParameterParser.java",0,0.649171270718232,3,4,7
"wicket-util/src/main/java/org/apache/wicket/util/upload/ProgressListener.java",0,1,0,1,1
"wicket-util/src/main/java/org/apache/wicket/util/upload/RequestContext.java",0,0.53125,2,4,6
"wicket-util/src/main/java/org/apache/wicket/util/upload/ServletFileUpload.java",0,0.457516339869281,2,5,7
"wicket-util/src/main/java/org/apache/wicket/util/upload/ServletRequestContext.java",0,0.715596330275229,4,3,7
"wicket-util/src/main/java/org/apache/wicket/util/value/AttributeMap.java",0,0.979591836734694,1,1,2
"wicket-util/src/main/java/org/apache/wicket/util/value/CopyOnWriteValueMap.java",0,0.903296703296703,1,2,3
"wicket-util/src/main/java/org/apache/wicket/util/value/IValueMap.java",0,0.997701149425287,1,1,2
"wicket-util/src/main/java/org/apache/wicket/util/value/IntValue.java",0,1,0,1,1
"wicket-util/src/main/java/org/apache/wicket/util/value/LongValue.java",0,0.792452830188679,0,3,3
"wicket-util/src/main/java/org/apache/wicket/util/value/ValueMap.java",0,0.986143187066975,1,1,2
"wicket-util/src/main/java/org/apache/wicket/util/visit/ClassVisitFilter.java",0,0.6,0,2,2
"wicket-util/src/main/java/org/apache/wicket/util/visit/IVisit.java",0,0.6,0,2,2
"wicket-util/src/main/java/org/apache/wicket/util/visit/IVisitFilter.java",0,0.677966101694915,0,2,2
"wicket-util/src/main/java/org/apache/wicket/util/visit/IVisitor.java",0,0.552631578947368,0,2,2
"wicket-util/src/main/java/org/apache/wicket/util/visit/Visit.java",0,0.742268041237113,0,2,2
"wicket-util/src/main/java/org/apache/wicket/util/visit/Visits.java",0,0.746376811594203,2,2,4
"wicket-util/src/main/java/org/apache/wicket/util/watch/IModifiable.java",0,0.361111111111111,1,5,6
"wicket-util/src/main/java/org/apache/wicket/util/watch/IModificationWatcher.java",0,1,0,1,1
"wicket-util/src/main/java/org/apache/wicket/util/watch/ModificationWatcher.java",0,0.454545454545455,2,6,8
"wicket-util/src/main/java/org/apache/wicket/util/xml/CustomEntityResolver.java",0,0.759776536312849,0,2,2
"wicket-util/src/test/java/org/apache/wicket/util/LongEncoderTest.java",0,1,0,1,1
"wicket-util/src/test/java/org/apache/wicket/util/collections/MicroMapTest.java",0,0.833333333333333,2,3,5
"wicket-util/src/test/java/org/apache/wicket/util/collections/MiniMapTest.java",0,0.857142857142857,2,2,4
"wicket-util/src/test/java/org/apache/wicket/util/collections/MostRecentlyUsedMapTest.java",0,1,0,1,1
"wicket-util/src/test/java/org/apache/wicket/util/collections/ReverseListIteratorTest.java",0,1,0,1,1
"wicket-util/src/test/java/org/apache/wicket/util/convert/converters/ConvertersTest.java",0,0.388372093023256,4,5,9
"wicket-util/src/test/java/org/apache/wicket/util/crypt/Base64Test.java",0,0.445255474452555,3,4,7
"wicket-util/src/test/java/org/apache/wicket/util/file/FilesTest.java",0,0.905063291139241,0,2,2
"wicket-util/src/test/java/org/apache/wicket/util/file/WebXmlFileTest.java",0,0.907563025210084,1,2,3
"wicket-util/src/test/java/org/apache/wicket/util/io/FullyBufferedReaderTest.java",0,0.647058823529412,0,2,2
"wicket-util/src/test/java/org/apache/wicket/util/io/LastModifiedTest.java",0,0.768421052631579,0,2,2
"wicket-util/src/test/java/org/apache/wicket/util/io/XmlReaderTest.java",0,0.7,1,4,5
"wicket-util/src/test/java/org/apache/wicket/util/lang/ArgsTest.java",0,1,0,1,1
"wicket-util/src/test/java/org/apache/wicket/util/lang/BytesTest.java",0,0.73780487804878,2,3,5
"wicket-util/src/test/java/org/apache/wicket/util/lang/ObjectsTest.java",0,0.9,0,2,2
"wicket-util/src/test/java/org/apache/wicket/util/lang/PrimitivesTest.java",0,0.690265486725664,4,3,7
"wicket-util/src/test/java/org/apache/wicket/util/license/AbstractLicenseHeaderHandler.java",0,0.648148148148148,2,5,7
"wicket-util/src/test/java/org/apache/wicket/util/license/ApacheLicenceHeaderTest.java",0,1,0,1,1
"wicket-util/src/test/java/org/apache/wicket/util/license/ApacheLicenseHeaderTestCase.java",0,0.612903225806452,6,3,9
"wicket-util/src/test/java/org/apache/wicket/util/license/CssLicenseHeaderHandler.java",0,0.792207792207792,2,3,5
"wicket-util/src/test/java/org/apache/wicket/util/license/HtmlLicenseHeaderHandler.java",0,0.794871794871795,1,2,3
"wicket-util/src/test/java/org/apache/wicket/util/license/ILicenseHeaderHandler.java",0,0.803571428571429,1,3,4
"wicket-util/src/test/java/org/apache/wicket/util/license/JavaLicenseHeaderHandler.java",0,0.813559322033898,4,2,6
"wicket-util/src/test/java/org/apache/wicket/util/license/JavaScriptLicenseHeaderHandler.java",0,0.80327868852459,2,2,4
"wicket-util/src/test/java/org/apache/wicket/util/license/PropertiesLicenseHeaderHandler.java",0,0.792207792207792,2,3,5
"wicket-util/src/test/java/org/apache/wicket/util/license/VelocityLicenseHeaderHandler.java",0,0.792207792207792,2,3,5
"wicket-util/src/test/java/org/apache/wicket/util/license/XmlLicenseHeaderHandler.java",0,0.734848484848485,2,4,6
"wicket-util/src/test/java/org/apache/wicket/util/license/XmlPrologHeaderHandler.java",0,1,0,1,1
"wicket-util/src/test/java/org/apache/wicket/util/markup/xhtml/WellFormedXmlTestCase.java",0,0.981707317073171,1,1,2
"wicket-util/src/test/java/org/apache/wicket/util/parse/metapattern/MetaPatternTest.java",0,0.715976331360947,3,3,6
"wicket-util/src/test/java/org/apache/wicket/util/size/BytesTest.java",0,0.4765625,2,4,6
"wicket-util/src/test/java/org/apache/wicket/util/string/AppendingStringBufferTest.java",0,0.428571428571429,2,5,7
"wicket-util/src/test/java/org/apache/wicket/util/string/PrependingStringBufferTest.java",0,0.446808510638298,2,4,6
"wicket-util/src/test/java/org/apache/wicket/util/string/StringListTest.java",0,0.856269113149847,4,2,6
"wicket-util/src/test/java/org/apache/wicket/util/string/StringsTest.java",0,0.876288659793814,1,2,3
"wicket-util/src/test/java/org/apache/wicket/util/string/interpolator/VariableInterpolatorTest.java",0,0.588235294117647,1,4,5
"wicket-util/src/test/java/org/apache/wicket/util/time/DurationTest.java",0,0.381818181818182,3,4,7
"wicket-util/src/test/java/org/apache/wicket/util/time/TimeFrameTest.java",0,0.818181818181818,0,3,3
"wicket-util/src/test/java/org/apache/wicket/util/time/TimeMapTest.java",0,0.368421052631579,1,5,6
"wicket-util/src/test/java/org/apache/wicket/util/time/TimeOfDayTest.java",0,0.441860465116279,1,4,5
"wicket-util/src/test/java/org/apache/wicket/util/time/TimeTest.java",0,0.321428571428571,2,5,7
"wicket-util/src/test/java/org/apache/wicket/util/value/LongValueTest.java",0,1,0,1,1
"wicket-util/src/test/java/org/apache/wicket/util/value/ValueMapTest.java",0,0.544401544401544,4,4,8
"wicket-velocity/src/main/java/org/apache/wicket/velocity/Initializer.java",0,0.775641025641026,3,2,5
"wicket-velocity/src/main/java/org/apache/wicket/velocity/VelocityContributor.java",0,0.82051282051282,2,3,5
"wicket-velocity/src/main/java/org/apache/wicket/velocity/VelocityJavaScriptContributor.java",0,0.7375,1,3,4
"wicket-velocity/src/main/java/org/apache/wicket/velocity/markup/html/VelocityPanel.java",0,0.526153846153846,2,3,5
"wicket-velocity/src/test/java/org/apache/wicket/contrib/markup/html/velocity/VelocityPage.java",0,0.869565217391304,4,1,5
"wicket-velocity/src/test/java/org/apache/wicket/contrib/markup/html/velocity/VelocityPanelTest.java",0,0.901960784313726,1,2,3
"wicket-velocity/src/test/java/org/apache/wicket/contrib/markup/html/velocity/VelocityWithMarkupParsingPage.java",0,0.592105263157895,4,3,7
"wicket-velocity/src/test/java/org/apache/wicket/contrib/velocity/VelocityJavaScriptContributorTest.java",0,0.825,1,3,4
"wicket-velocity/src/test/java/org/apache/wicket/contrib/velocity/VelocityJavaScriptPage.java",0,0.761904761904762,2,3,5
"wicket-velocity/src/test/java/org/apache/wicket/util/license/ApacheLicenceHeaderTest.java",0,0.764705882352941,1,2,3
